Player,Pos,Age,Tm,G,GS,MP,FG,FGA,FG%,3P,3PA,3P%,2P,2PA,2P%,eFG%,FT,FTA,FT%,ORB,DRB,TRB,AST,STL,BLK,TOV,PF,PTS
Alaa Abdelnaby,PF,26,TOT,54,0,506,118,231,0.511,0,2,0.0,118,229,0.515,0.511,20,35,0.5710000000000001,37,77,114,13,15,12,45,104,256
Mahmoud Abdul-Rauf,PG,25,DEN,73,43,2082,472,1005,0.47,83,215,0.386,389,790,0.49200000000000005,0.511,138,156,0.885,32,105,137,263,77,9,119,126,1165
Michael Adams,PG,32,CHH,29,0,443,67,148,0.45299999999999996,29,81,0.358,38,67,0.5670000000000001,0.551,25,30,0.833,6,23,29,95,23,1,26,41,188
Rafael Addison,SF,30,DET,79,16,1776,279,586,0.47600000000000003,24,83,0.289,255,503,0.507,0.49700000000000005,74,99,0.747,67,175,242,109,53,25,76,236,656
Danny Ainge,SG,35,PHO,74,1,1374,194,422,0.46,78,214,0.364,116,208,0.5579999999999999,0.552,105,130,0.8079999999999999,25,84,109,210,46,7,79,155,571
Victor Alexander,C,25,GSW,50,29,1237,230,447,0.515,6,25,0.24,224,422,0.531,0.521,36,60,0.6,87,204,291,60,28,29,76,145,502
Derrick Alston,C,22,PHI,64,1,1032,120,258,0.465,0,4,0.0,120,254,0.47200000000000003,0.465,59,120,0.49200000000000005,98,121,219,33,39,35,53,107,299
Greg Anderson,PF,30,ATL,51,0,622,57,104,0.5479999999999999,0,0,0.0,57,104,0.5479999999999999,0.5479999999999999,34,71,0.479,62,126,188,17,23,32,32,103,148
Kenny Anderson,PG,24,NJN,72,70,2689,411,1031,0.39899999999999997,97,294,0.33,314,737,0.426,0.446,348,414,0.841,73,177,250,680,103,14,225,184,1267
Nick Anderson,SG,27,ORL,76,76,2588,439,923,0.47600000000000003,179,431,0.415,260,492,0.528,0.573,143,203,0.7040000000000001,85,250,335,314,125,22,141,124,1200
Willie Anderson,SG,28,SAS,38,11,556,76,162,0.469,3,19,0.158,73,143,0.51,0.478,30,41,0.732,15,40,55,52,26,10,38,71,185
Greg Anthony,PG,27,NYK,61,2,943,128,293,0.43700000000000006,56,155,0.361,72,138,0.522,0.532,60,76,0.789,7,57,64,160,50,7,57,99,372
B.J. Armstrong,PG,27,CHI,82,82,2577,418,894,0.46799999999999997,108,253,0.42700000000000005,310,641,0.484,0.528,206,233,0.884,25,161,186,244,84,8,103,159,1150
Darrell Armstrong,PG,26,ORL,3,0,8,3,8,0.375,2,6,0.33299999999999996,1,2,0.5,0.5,2,2,1.0,1,0,1,3,1,0,1,3,10
Vincent Askew,SG,28,SEA,71,1,1721,248,504,0.49200000000000005,31,94,0.33,217,410,0.529,0.523,176,238,0.7390000000000001,65,116,181,176,49,13,85,191,703
Keith Askins,SF,27,MIA,50,5,854,81,207,0.391,21,78,0.26899999999999996,60,129,0.465,0.442,46,57,0.807,86,112,198,39,35,17,25,109,229
Stacey Augmon,SG,26,ATL,76,76,2362,397,876,0.45299999999999996,7,26,0.26899999999999996,390,850,0.45899999999999996,0.457,252,346,0.728,157,211,368,197,100,47,152,163,1053
Anthony Avent,PF,25,ORL,71,3,1066,105,244,0.43,0,0,0.0,105,244,0.43,0.43,48,75,0.64,97,196,293,41,28,50,53,170,258
Vin Baker,PF,23,MIL,82,82,3361,594,1229,0.483,7,24,0.292,587,1205,0.48700000000000004,0.486,256,432,0.593,289,557,846,296,86,116,221,277,1451
Charles Barkley*,PF,31,PHO,68,66,2382,554,1141,0.486,74,219,0.33799999999999997,480,922,0.521,0.518,379,507,0.748,203,553,756,276,110,45,150,201,1561
Dana Barros,PG,27,PHI,82,82,3318,571,1165,0.49,197,425,0.46399999999999997,374,740,0.505,0.575,347,386,0.899,27,247,274,619,149,4,242,159,1686
Jon Barry,SG,25,MIL,52,0,602,57,134,0.425,16,48,0.33299999999999996,41,86,0.47700000000000004,0.485,61,80,0.763,15,34,49,85,30,4,41,54,191
John Battle,SG,32,CLE,28,0,280,43,114,0.377,11,31,0.355,32,83,0.386,0.425,19,26,0.731,3,8,11,37,8,1,17,28,116
Sergei Bazarevich,PG,29,ATL,10,0,74,11,22,0.5,1,6,0.16699999999999998,10,16,0.625,0.523,7,9,0.778,1,6,7,14,1,1,7,10,30
Benoit Benjamin,C,30,NJN,61,57,1598,271,531,0.51,0,0,0.0,271,531,0.51,0.51,133,175,0.76,94,346,440,38,23,64,125,151,675
Elmer Bennett,PG,24,CLE,4,0,18,6,11,0.545,0,2,0.0,6,9,0.667,0.545,3,4,0.75,0,1,1,3,4,0,3,3,15
Tony Bennett,PG,25,CHH,3,0,46,6,13,0.462,2,9,0.222,4,4,1.0,0.5379999999999999,0,0,0.0,0,2,2,4,0,0,3,6,14
David Benoit,SF,26,UTA,71,67,1841,285,587,0.486,38,115,0.33,247,472,0.523,0.518,132,157,0.841,96,272,368,58,45,47,75,183,740
James Blackwell,PG,26,TOT,13,0,80,8,13,0.615,0,0,0.0,8,13,0.615,0.615,2,3,0.667,2,9,11,11,4,0,5,8,18
Mookie Blaylock,PG,27,ATL,80,80,3069,509,1198,0.425,199,555,0.359,310,643,0.48200000000000004,0.508,156,214,0.7290000000000001,117,276,393,616,200,26,242,164,1373
Corie Blount,PF,26,CHI,68,9,889,100,210,0.47600000000000003,0,2,0.0,100,208,0.48100000000000004,0.47600000000000003,38,67,0.5670000000000001,107,133,240,60,26,33,59,146,238
Muggsy Bogues,PG,30,CHH,78,78,2629,348,730,0.47700000000000004,6,30,0.2,342,700,0.489,0.48100000000000004,160,180,0.889,51,206,257,675,103,0,132,151,862
Manute Bol,C,32,GSW,5,2,81,6,10,0.6,3,5,0.6,3,5,0.6,0.75,0,0,0.0,1,11,12,0,0,9,1,10,15
Walter Bond,SG,25,TOT,23,0,290,39,84,0.46399999999999997,15,41,0.366,24,43,0.5579999999999999,0.5539999999999999,14,20,0.7,8,24,32,24,6,4,17,47,107
Anthony Bonner,PF,26,NYK,58,23,1126,88,193,0.456,1,5,0.2,87,188,0.46299999999999997,0.45899999999999996,44,67,0.657,113,149,262,80,48,23,79,159,221
Anthony Bowie,SG,31,ORL,77,4,1261,177,369,0.48,12,40,0.3,165,329,0.502,0.496,61,73,0.836,54,85,139,159,47,21,86,138,427
Sam Bowie,C,33,LAL,67,10,1225,118,267,0.442,2,11,0.182,116,256,0.45299999999999996,0.446,68,89,0.764,72,216,288,118,21,80,91,182,306
Shawn Bradley,C,22,PHI,82,59,2365,315,693,0.455,0,3,0.0,315,690,0.457,0.455,148,232,0.638,243,416,659,53,54,274,142,338,778
Terrell Brandon,PG,24,CLE,67,41,1961,341,762,0.44799999999999995,48,121,0.397,293,641,0.457,0.479,159,186,0.855,35,151,186,363,107,14,144,118,889
Tim Breaux,SF,24,HOU,42,2,340,45,121,0.37200000000000005,6,25,0.24,39,96,0.406,0.397,32,49,0.653,16,18,34,15,11,4,16,25,128
Scott Brooks,PG,29,TOT,59,0,808,126,275,0.45799999999999996,25,69,0.36200000000000004,101,206,0.49,0.504,64,79,0.81,14,52,66,116,34,4,47,56,341
Chucky Brown,SF,26,HOU,41,14,814,105,174,0.603,1,3,0.33299999999999996,104,171,0.608,0.606,38,62,0.613,64,125,189,30,11,14,29,105,249
Dee Brown,SG,26,BOS,79,69,2792,437,977,0.447,126,327,0.385,311,650,0.478,0.512,236,277,0.852,63,186,249,301,110,49,146,181,1236
Mike Brown,C,31,MIN,27,0,213,10,40,0.25,0,1,0.0,10,39,0.256,0.25,15,27,0.556,9,36,45,10,7,0,16,35,35
P.J. Brown,C,25,NJN,80,63,2466,254,570,0.446,4,24,0.16699999999999998,250,546,0.45799999999999996,0.449,139,207,0.6709999999999999,178,309,487,135,69,135,80,262,651
Randy Brown,PG,26,SAC,67,2,1086,124,287,0.43200000000000005,14,47,0.298,110,240,0.45799999999999996,0.456,55,82,0.6709999999999999,24,84,108,133,99,19,78,153,317
Mark Bryant,PF,29,POR,49,0,658,101,192,0.526,1,2,0.5,100,190,0.526,0.529,41,63,0.6509999999999999,55,106,161,28,19,16,39,109,244
Jud Buechler,SF,26,CHI,57,0,605,90,183,0.49200000000000005,15,48,0.313,75,135,0.556,0.5329999999999999,22,39,0.564,36,62,98,50,24,12,30,64,217
Scott Burrell,SF,24,CHH,65,62,2014,277,593,0.467,96,235,0.409,181,358,0.506,0.5479999999999999,100,144,0.6940000000000001,96,272,368,161,75,40,85,187,750
Willie Burton,SF,26,PHI,53,31,1564,243,606,0.401,106,275,0.385,137,331,0.414,0.488,220,267,0.8240000000000001,49,115,164,96,32,19,122,167,812
Mitchell Butler,SG,24,WSB,76,5,1554,214,508,0.42100000000000004,46,141,0.326,168,367,0.45799999999999996,0.467,123,185,0.665,43,127,170,91,61,10,106,155,597
Michael Cage,C,33,CLE,82,21,2040,177,340,0.521,0,2,0.0,177,338,0.524,0.521,53,88,0.602,203,361,564,56,61,67,56,149,407
Adrian Caldwell,PF,28,HOU,7,0,30,1,4,0.25,0,0,0.0,1,4,0.25,0.25,3,6,0.5,1,9,10,0,1,0,1,6,5
Elden Campbell,PF,26,LAL,73,59,2076,360,785,0.45899999999999996,0,1,0.0,360,784,0.45899999999999996,0.45899999999999996,193,290,0.6659999999999999,168,277,445,92,69,132,98,246,913
Tony Campbell,SF,32,CLE,78,0,1128,161,392,0.41100000000000003,15,42,0.35700000000000004,146,350,0.41700000000000004,0.43,132,159,0.83,60,93,153,69,32,8,65,122,469
Antoine Carr,C,33,UTA,78,4,1677,290,546,0.531,1,4,0.25,289,542,0.5329999999999999,0.532,165,201,0.821,81,184,265,67,24,68,87,253,746
Bill Cartwright,C,37,SEA,29,19,430,27,69,0.391,0,0,0.0,27,69,0.391,0.391,15,24,0.625,25,62,87,10,6,3,18,70,69
Sam Cassell,PG,25,HOU,82,1,1882,253,593,0.42700000000000005,63,191,0.33,190,402,0.473,0.48,214,254,0.843,38,173,211,405,94,14,167,209,783
Duane Causwell,C,26,SAC,58,24,820,76,147,0.517,0,1,0.0,76,146,0.521,0.517,57,98,0.5820000000000001,57,117,174,15,14,80,33,146,209
Cedric Ceballos,SF,25,LAL,58,54,2029,497,977,0.509,58,146,0.397,439,831,0.528,0.5379999999999999,209,292,0.716,169,295,464,105,60,19,143,131,1261
Tom Chambers,PF,35,UTA,81,4,1240,195,427,0.457,4,24,0.16699999999999998,191,403,0.474,0.461,109,135,0.807,66,147,213,73,25,30,52,173,503
Rex Chapman,SG,27,WSB,45,29,1468,254,639,0.397,86,274,0.314,168,365,0.46,0.465,137,159,0.862,23,90,113,128,67,15,62,85,731
Calbert Cheaney,SG,23,WSB,78,71,2651,512,1129,0.45299999999999996,96,283,0.33899999999999997,416,846,0.49200000000000005,0.496,173,213,0.812,105,216,321,177,80,21,151,215,1293
Pete Chilcutt,PF,26,HOU,68,17,1347,146,328,0.445,35,86,0.40700000000000003,111,242,0.45899999999999996,0.498,31,42,0.738,106,211,317,66,25,43,61,117,358
Chris Childs,PG,27,NJN,53,11,1021,106,279,0.38,41,125,0.32799999999999996,65,154,0.42200000000000004,0.45299999999999996,55,73,0.753,14,55,69,219,42,3,76,116,308
Doug Christie,SG,24,NYK,12,0,79,5,22,0.22699999999999998,1,7,0.14300000000000002,4,15,0.267,0.25,4,5,0.8,3,10,13,8,2,1,13,18,15
Derrick Coleman,PF,27,NJN,56,54,2103,371,875,0.424,28,120,0.233,343,755,0.45399999999999996,0.44,376,490,0.767,167,424,591,187,35,94,172,162,1146
Bimbo Coles,PG,26,MIA,68,65,2207,261,607,0.43,16,76,0.21100000000000002,245,531,0.461,0.44299999999999995,141,174,0.81,46,145,191,416,99,13,156,185,679
Steve Colter,PG,32,CLE,57,7,752,67,169,0.396,8,35,0.22899999999999998,59,134,0.44,0.42,54,71,0.7609999999999999,13,46,59,101,30,6,36,53,196
Marty Conlon,C,27,MIL,82,3,2064,344,647,0.532,8,29,0.276,336,618,0.544,0.5379999999999999,119,194,0.613,160,266,426,110,42,18,123,218,815
Lester Conner,SG,35,LAL,2,0,5,0,0,0.0,0,0,0.0,0,0,0.0,0.0,2,2,1.0,0,0,0,0,1,0,0,3,2
Tyrone Corbin,SF,32,ATL,81,4,1389,205,464,0.442,14,56,0.25,191,408,0.46799999999999997,0.457,78,114,0.684,98,164,262,67,55,16,74,161,502
John Crotty,PG,25,UTA,80,0,1019,93,231,0.40299999999999997,11,36,0.306,82,195,0.42100000000000004,0.426,98,121,0.81,27,70,97,205,39,6,70,105,295
Corey Crowder,SF,25,SAS,7,0,29,2,10,0.2,0,4,0.0,2,6,0.33299999999999996,0.2,2,6,0.33299999999999996,1,2,3,1,1,0,2,1,6
Terry Cummings,PF,33,SAS,76,20,1273,224,464,0.483,0,0,0.0,224,464,0.483,0.483,72,123,0.585,138,240,378,59,36,19,95,188,520
Bill Curley,PF,22,DET,53,1,595,58,134,0.433,0,0,0.0,58,134,0.433,0.433,27,36,0.75,54,70,124,25,21,21,25,128,143
Dell Curry,SG,30,CHH,69,0,1718,343,778,0.441,154,361,0.42700000000000005,189,417,0.45299999999999996,0.54,95,111,0.856,41,127,168,113,55,18,98,144,935
Lloyd Daniels,SG,27,TOT,30,14,604,80,209,0.38299999999999995,26,100,0.26,54,109,0.495,0.445,22,27,0.815,29,34,63,40,22,10,31,48,208
Yinka Dare,C,22,NJN,1,0,3,0,1,0.0,0,0,0.0,0,1,0.0,0.0,0,0,0.0,0,1,1,0,0,0,1,2,0
Antonio Davis,PF,26,IND,44,1,1030,109,245,0.445,0,0,0.0,109,245,0.445,0.445,117,174,0.672,105,175,280,25,19,29,64,134,335
Dale Davis,PF,25,IND,74,70,2346,324,576,0.563,0,1,0.0,324,575,0.563,0.563,138,259,0.5329999999999999,259,437,696,58,72,116,124,222,786
Hubert Davis,SG,24,NYK,82,4,1697,296,617,0.48,131,288,0.455,165,329,0.502,0.586,97,120,0.8079999999999999,30,80,110,150,35,11,87,146,820
Terry Davis,PF,27,DAL,46,2,580,49,113,0.434,0,2,0.0,49,111,0.441,0.434,42,66,0.636,63,93,156,10,6,3,30,76,140
Johnny Dawkins,PG,31,DET,50,9,1170,125,270,0.46299999999999997,25,73,0.342,100,197,0.508,0.509,50,55,0.909,28,85,113,205,52,1,86,74,325
Tony Dawson,SF,27,BOS,2,0,13,3,8,0.375,1,3,0.33299999999999996,2,5,0.4,0.43799999999999994,1,1,1.0,0,3,3,1,0,0,2,4,8
Todd Day,SG,25,MIL,82,81,2717,445,1049,0.424,163,418,0.39,282,631,0.447,0.502,257,341,0.754,95,227,322,134,104,63,157,283,1310
Terry Dehere,PG,23,LAC,80,28,1774,279,685,0.40700000000000003,48,163,0.294,231,522,0.44299999999999995,0.442,229,292,0.784,35,117,152,225,45,7,157,200,835
Vinny Del Negro,SG,28,SAS,75,71,2360,372,766,0.486,66,162,0.40700000000000003,306,604,0.507,0.529,128,162,0.79,28,164,192,226,61,14,56,179,938
Bison Dele,C,25,DEN,63,10,1261,196,333,0.589,0,0,0.0,196,333,0.589,0.589,106,162,0.654,98,200,298,53,38,43,114,210,498
Vlade Divac*,C,26,LAL,80,80,2807,485,957,0.507,10,53,0.18899999999999997,475,904,0.525,0.512,297,382,0.777,261,568,829,329,109,174,205,305,1277
James Donaldson,C,37,UTA,43,40,613,44,74,0.595,0,0,0.0,44,74,0.595,0.595,22,31,0.71,19,88,107,14,6,28,22,66,110
Sherman Douglas,PG,28,BOS,65,43,2048,365,769,0.475,20,82,0.244,345,687,0.502,0.488,204,296,0.6890000000000001,48,122,170,446,80,2,162,152,954
Greg Dreiling,C,32,CLE,58,3,483,42,102,0.41200000000000003,0,0,0.0,42,102,0.41200000000000003,0.41200000000000003,26,41,0.634,32,84,116,22,6,22,25,108,110
Clyde Drexler*,SG,32,TOT,76,75,2728,571,1238,0.461,147,408,0.36,424,830,0.511,0.521,364,442,0.8240000000000001,152,328,480,362,136,45,186,206,1653
Kevin Duckworth,C,30,WSB,40,22,818,118,267,0.442,2,10,0.2,116,257,0.451,0.446,45,70,0.643,65,130,195,20,21,24,59,110,283
Chris Dudley,C,29,POR,82,82,2245,181,446,0.406,0,1,0.0,181,445,0.40700000000000003,0.406,85,183,0.46399999999999997,325,439,764,34,43,126,81,286,447
Joe Dumars*,SG,31,DET,67,67,2544,417,970,0.43,103,338,0.305,314,632,0.49700000000000005,0.483,277,344,0.805,47,111,158,368,72,7,219,153,1214
Richard Dumas,SF,25,PHO,15,1,167,37,73,0.507,0,1,0.0,37,72,0.514,0.507,8,16,0.5,18,11,29,7,10,2,9,22,82
Tony Dumas,SG,22,DAL,58,0,613,96,250,0.384,22,73,0.301,74,177,0.418,0.428,50,77,0.649,32,30,62,57,13,4,50,78,264
Pat Durham,SF,27,MIN,59,2,852,117,237,0.494,5,26,0.192,112,211,0.531,0.504,63,96,0.6559999999999999,37,57,94,53,36,32,45,114,302
Ledell Eackles,SG,28,MIA,54,6,898,143,326,0.439,18,41,0.439,125,285,0.439,0.466,91,126,0.722,33,62,95,72,19,2,53,88,395
Acie Earl,C,24,BOS,30,3,208,26,68,0.382,0,0,0.0,26,68,0.382,0.382,14,29,0.483,19,26,45,2,6,8,14,39,66
Blue Edwards,SF,29,TOT,67,7,1112,181,393,0.461,22,75,0.293,159,318,0.5,0.489,75,90,0.833,50,80,130,77,43,16,81,143,459
Doug Edwards,PF,24,ATL,38,0,212,22,48,0.45799999999999996,0,1,0.0,22,47,0.46799999999999997,0.45799999999999996,23,32,0.7190000000000001,19,29,48,13,5,4,22,30,67
James Edwards,C,39,POR,28,0,266,32,83,0.386,0,0,0.0,32,83,0.386,0.386,11,17,0.647,10,33,43,8,5,8,14,44,75
Kevin Edwards,SG,29,NJN,14,14,466,69,154,0.44799999999999995,18,45,0.4,51,109,0.46799999999999997,0.506,40,42,0.9520000000000001,10,27,37,27,19,5,35,42,196
Craig Ehlo,SG,33,ATL,49,0,1166,191,422,0.45299999999999996,51,134,0.381,140,288,0.486,0.513,44,71,0.62,55,92,147,113,46,6,73,86,477
Howard Eisley,PG,22,TOT,49,4,552,40,122,0.32799999999999996,9,37,0.243,31,85,0.365,0.365,31,40,0.775,12,36,48,95,18,6,50,81,120
Mario Elie,SF,31,HOU,81,13,1896,243,487,0.499,80,201,0.39799999999999996,163,286,0.57,0.581,144,171,0.8420000000000001,50,146,196,189,65,12,104,158,710
Sean Elliott,SF,26,SAS,81,81,2858,502,1072,0.46799999999999997,136,333,0.408,366,739,0.495,0.532,326,404,0.807,63,224,287,206,78,38,151,216,1466
Dale Ellis,SF,34,DEN,81,3,1996,351,774,0.45299999999999996,106,263,0.40299999999999997,245,511,0.479,0.522,110,127,0.866,56,166,222,57,37,9,81,142,918
Harold Ellis,SF,24,LAC,69,7,656,91,189,0.48100000000000004,1,13,0.077,90,176,0.511,0.484,69,117,0.59,56,32,88,40,67,12,49,102,252
LaPhonso Ellis,PF,24,DEN,6,0,58,9,25,0.36,0,0,0.0,9,25,0.36,0.36,6,6,1.0,7,10,17,4,1,5,5,12,24
Pervis Ellison,C,27,BOS,55,11,1083,152,300,0.507,0,2,0.0,152,298,0.51,0.507,71,99,0.7170000000000001,124,185,309,34,22,54,76,179,375
Jo Jo English,SG,24,CHI,8,0,127,15,39,0.385,3,12,0.25,12,27,0.444,0.423,10,13,0.769,1,2,3,7,7,1,6,19,43
Patrick Ewing*,C,32,NYK,79,79,2920,730,1452,0.503,6,21,0.28600000000000003,724,1431,0.506,0.505,420,560,0.75,157,710,867,212,68,159,256,272,1886
Duane Ferrell,SF,29,IND,56,1,607,83,173,0.48,1,6,0.16699999999999998,82,167,0.491,0.483,64,85,0.753,50,38,88,31,26,6,43,79,231
Danny Ferry,PF,28,CLE,82,6,1290,223,500,0.446,94,233,0.40299999999999997,129,267,0.483,0.54,74,84,0.8809999999999999,30,113,143,96,27,22,59,131,614
Matt Fish,C,25,LAC,26,8,370,49,103,0.47600000000000003,0,1,0.0,49,102,0.48,0.47600000000000003,25,37,0.6759999999999999,32,52,84,17,16,7,28,70,123
Vern Fleming,PG,32,IND,55,1,686,93,188,0.495,0,7,0.0,93,181,0.514,0.495,65,90,0.722,20,68,88,109,27,1,43,80,251
Sleepy Floyd,SG,34,NJN,48,1,831,71,212,0.335,25,88,0.284,46,124,0.371,0.39399999999999996,30,43,0.698,8,46,54,126,13,6,51,73,197
Alphonso Ford,SG,23,PHI,5,0,98,9,39,0.231,0,9,0.0,9,30,0.3,0.231,1,2,0.5,8,12,20,9,1,0,8,5,19
Greg Foster,PF,26,TOT,78,3,1144,150,318,0.47200000000000003,7,23,0.304,143,295,0.485,0.483,78,111,0.703,85,174,259,39,15,28,71,183,385
Rick Fox,SF,25,BOS,53,7,1039,169,351,0.48100000000000004,31,75,0.413,138,276,0.5,0.526,95,123,0.772,61,94,155,139,52,19,78,154,464
Corey Gaines,SG,29,PHI,11,8,280,24,51,0.47100000000000003,2,15,0.133,22,36,0.611,0.49,5,11,0.455,1,17,18,33,8,1,14,23,55
Kevin Gamble,SF,29,MIA,77,0,1223,220,450,0.489,39,98,0.39799999999999996,181,352,0.514,0.532,87,111,0.784,29,93,122,119,52,10,49,130,566
Winston Garland,PG,30,MIN,73,58,1931,170,410,0.415,19,75,0.253,151,335,0.451,0.43799999999999994,89,112,0.795,48,120,168,318,71,13,105,184,448
Chris Gatling,PF,27,GSW,58,22,1470,324,512,0.633,0,1,0.0,324,511,0.634,0.633,148,250,0.5920000000000001,144,299,443,51,39,52,117,184,796
Kenny Gattison,PF,30,CHH,21,0,409,47,100,0.47,0,1,0.0,47,99,0.475,0.47,31,51,0.608,21,54,75,17,7,15,22,64,125
Matt Geiger,C,25,MIA,74,43,1712,260,485,0.536,4,10,0.4,256,475,0.539,0.54,93,143,0.65,146,267,413,55,41,51,113,245,617
Tate George,SG,26,MIL,3,0,8,1,3,0.33299999999999996,0,1,0.0,1,2,0.5,0.33299999999999996,2,2,1.0,1,0,1,0,0,0,2,1,4
Kendall Gill,SG,26,SEA,73,58,2125,392,858,0.457,63,171,0.368,329,687,0.479,0.494,155,209,0.742,99,191,290,192,117,28,138,186,1002
Armen Gilliam,PF,30,NJN,82,30,2472,455,905,0.503,0,2,0.0,455,903,0.504,0.503,302,392,0.77,192,421,613,99,67,89,152,171,1212
Greg Graham,SG,24,PHI,50,7,775,95,223,0.426,6,28,0.214,89,195,0.456,0.439,55,73,0.753,19,43,62,66,29,6,48,76,251
Ron Grandison,PF,30,NYK,2,0,8,1,4,0.25,0,0,0.0,1,4,0.25,0.25,0,0,0.0,3,2,5,2,0,0,0,2,2
Brian Grant,PF,22,SAC,80,59,2289,413,809,0.511,1,4,0.25,412,805,0.512,0.511,231,363,0.636,207,391,598,99,49,116,163,276,1058
Gary Grant,PG,29,LAC,33,2,470,78,166,0.47,4,16,0.25,74,150,0.493,0.48200000000000004,45,55,0.818,8,27,35,93,29,3,44,66,205
Greg Grant,PG,28,DEN,14,0,151,10,33,0.303,2,7,0.28600000000000003,8,26,0.308,0.33299999999999996,9,12,0.75,2,7,9,43,6,2,14,20,31
Harvey Grant,PF,29,POR,75,14,1771,286,621,0.461,8,26,0.308,278,595,0.467,0.467,103,146,0.705,103,181,284,82,56,53,62,163,683
Horace Grant,PF,29,ORL,74,74,2693,401,707,0.5670000000000001,0,8,0.0,401,699,0.574,0.5670000000000001,146,211,0.6920000000000001,223,492,715,173,76,88,85,203,948
Jeff Grayer,SG,29,PHI,47,25,1098,163,381,0.428,5,15,0.33299999999999996,158,366,0.43200000000000005,0.434,58,83,0.6990000000000001,58,91,149,74,27,4,56,80,389
A.C. Green,SF,31,PHO,82,52,2687,311,617,0.504,43,127,0.33899999999999997,268,490,0.547,0.539,251,343,0.732,194,475,669,127,55,31,114,146,916
Tom Gugliotta,PF-SF,25,TOT,77,63,2568,371,837,0.44299999999999995,60,186,0.32299999999999995,311,651,0.478,0.479,174,252,0.69,165,407,572,279,132,62,189,203,976
Andrés Guibert,PF,26,MIN,17,0,167,16,47,0.34,0,4,0.0,16,43,0.37200000000000005,0.34,13,19,0.684,16,29,45,10,8,1,12,29,45
Jack Haley,PF,31,SAS,31,0,117,26,61,0.426,0,1,0.0,26,60,0.433,0.426,21,32,0.6559999999999999,8,19,27,2,3,5,13,31,73
Geert Hammink,C,25,ORL,1,0,7,1,3,0.33299999999999996,0,0,0.0,1,3,0.33299999999999996,0.33299999999999996,2,2,1.0,0,2,2,1,0,0,0,1,4
Tom Hammonds,PF,27,DEN,70,5,956,139,260,0.535,0,1,0.0,139,259,0.537,0.535,132,177,0.746,55,167,222,36,11,14,56,132,410
Darrin Hancock,SF,23,CHH,46,7,424,68,121,0.562,1,3,0.33299999999999996,67,118,0.568,0.5660000000000001,16,39,0.41,14,39,53,30,19,4,30,48,153
Anfernee Hardaway,PG,23,ORL,77,77,2901,585,1142,0.512,87,249,0.349,498,893,0.5579999999999999,0.55,356,463,0.769,139,197,336,551,130,26,258,158,1613
Tim Hardaway,PG,28,GSW,62,62,2321,430,1007,0.42700000000000005,168,444,0.37799999999999995,262,563,0.465,0.51,219,288,0.76,46,144,190,578,88,12,214,155,1247
Jerome Harmon,SG,25,PHI,10,0,158,21,53,0.396,1,1,1.0,20,52,0.385,0.406,3,6,0.5,9,14,23,12,9,0,7,12,46
Derek Harper,PG,33,NYK,80,80,2716,337,756,0.446,106,292,0.363,231,464,0.498,0.516,139,192,0.7240000000000001,31,163,194,458,79,10,151,219,919
Ron Harper,SG,31,CHI,77,53,1536,209,491,0.426,31,110,0.282,178,381,0.467,0.457,81,131,0.618,51,129,180,157,97,27,100,132,530
Lucious Harris,SG,24,DAL,79,31,1695,280,610,0.45899999999999996,55,142,0.387,225,468,0.48100000000000004,0.504,136,170,0.8,85,135,220,132,58,14,77,105,751
Tony Harris,SG,27,BOS,3,0,18,3,8,0.375,0,1,0.0,3,7,0.429,0.375,8,9,0.889,0,0,0,0,0,0,1,2,14
Antonio Harvey,PF,24,LAL,59,8,572,77,176,0.43799999999999994,1,1,1.0,76,175,0.434,0.44,24,45,0.5329999999999999,39,63,102,23,15,41,25,87,179
Hersey Hawkins,SG,28,CHH,82,82,2731,390,809,0.48200000000000004,131,298,0.44,259,511,0.507,0.563,261,301,0.867,60,254,314,262,122,18,150,178,1172
Steve Henson,PG,26,POR,37,0,380,37,86,0.43,23,52,0.442,14,34,0.41200000000000003,0.564,22,25,0.88,3,23,26,85,9,0,30,52,119
Carl Herrera,PF,28,HOU,61,26,1331,171,327,0.523,0,2,0.0,171,325,0.526,0.523,73,117,0.624,98,180,278,44,40,38,71,136,415
Rod Higgins,SF,35,GSW,5,2,46,3,12,0.25,1,6,0.16699999999999998,2,6,0.33299999999999996,0.292,3,4,0.75,4,3,7,3,1,1,1,7,10
Sean Higgins,SF,26,NJN,57,7,735,105,273,0.385,23,78,0.295,82,195,0.42100000000000004,0.42700000000000005,35,40,0.875,25,52,77,29,10,9,35,93,268
Grant Hill*,SF,22,DET,70,69,2678,508,1064,0.47700000000000004,4,27,0.14800000000000002,504,1037,0.486,0.479,374,511,0.732,125,320,445,353,124,62,202,203,1394
Tyrone Hill,C,26,CLE,70,67,2397,350,694,0.504,0,1,0.0,350,693,0.505,0.504,263,397,0.662,269,496,765,55,55,41,151,245,963
Donald Hodge,C,25,DAL,54,0,633,83,204,0.40700000000000003,4,14,0.28600000000000003,79,190,0.41600000000000004,0.41700000000000004,39,51,0.765,40,82,122,41,10,14,39,107,209
Jeff Hornacek,SG,31,UTA,81,81,2696,482,937,0.514,89,219,0.406,393,718,0.547,0.562,284,322,0.882,53,157,210,347,129,17,145,181,1337
Robert Horry,PF,24,HOU,64,61,2074,240,537,0.447,86,227,0.379,154,310,0.49700000000000005,0.527,86,113,0.7609999999999999,81,243,324,216,94,76,122,161,652
Allan Houston,SG,23,DET,76,39,1996,398,859,0.46299999999999997,158,373,0.424,240,486,0.494,0.555,147,171,0.86,29,138,167,164,61,14,113,182,1101
Byron Houston,PF,25,SEA,39,0,258,49,107,0.45799999999999996,6,22,0.273,43,85,0.506,0.486,28,38,0.737,20,35,55,6,13,5,20,50,132
Tom Hovasse,SF,28,ATL,2,0,4,0,1,0.0,0,1,0.0,0,0,0.0,0.0,0,0,0.0,0,0,0,0,1,0,0,1,0
Juwan Howard,PF,21,WSB,65,52,2348,455,931,0.489,0,7,0.0,455,924,0.49200000000000005,0.489,194,292,0.664,184,361,545,165,52,15,166,236,1104
Jay Humphries,SG-PG,32,TOT,18,0,201,8,34,0.235,2,4,0.5,6,30,0.2,0.265,2,4,0.5,4,9,13,19,9,0,17,35,20
Lindsey Hunter,PG,24,DET,42,26,944,119,318,0.374,36,108,0.33299999999999996,83,210,0.395,0.431,40,55,0.727,24,51,75,159,51,7,79,94,314
Bobby Hurley,PG,23,SAC,68,6,1105,103,284,0.363,21,76,0.276,82,208,0.39399999999999996,0.4,58,76,0.763,14,56,70,226,29,0,110,79,285
Jaren Jackson,SG,27,PHI,21,1,257,25,68,0.368,4,15,0.267,21,53,0.396,0.397,16,24,0.667,18,24,42,19,9,5,17,33,70
Jim Jackson,SG,24,DAL,51,51,1982,484,1026,0.47200000000000003,35,110,0.318,449,916,0.49,0.489,306,380,0.805,120,140,260,191,28,12,160,92,1309
Mark Jackson,PG,29,IND,82,67,2402,239,566,0.42200000000000004,27,87,0.31,212,479,0.44299999999999995,0.446,119,153,0.778,73,233,306,616,105,16,210,148,624
Keith Jennings,PG,26,GSW,80,24,1722,190,425,0.447,75,204,0.368,115,221,0.52,0.535,134,153,0.8759999999999999,26,122,148,373,95,2,120,133,589
Avery Johnson,PG,29,SAS,82,82,3011,448,863,0.519,3,22,0.136,445,841,0.529,0.521,202,295,0.685,49,159,208,670,114,13,207,154,1101
Ervin Johnson,C,27,SEA,64,30,907,85,192,0.44299999999999995,0,1,0.0,85,191,0.445,0.44299999999999995,29,46,0.63,101,188,289,16,17,67,54,163,199
Kevin Johnson,PG,28,PHO,47,35,1352,246,523,0.47,4,26,0.154,242,497,0.48700000000000004,0.474,234,289,0.81,32,83,115,360,47,18,105,88,730
Larry Johnson,PF,25,CHH,81,81,3234,585,1219,0.48,81,210,0.386,504,1009,0.5,0.513,274,354,0.774,190,395,585,369,78,28,207,174,1525
Askia Jones,SG,23,MIN,11,0,139,15,44,0.341,2,12,0.16699999999999998,13,32,0.406,0.364,13,16,0.813,6,5,11,16,6,0,9,19,45
Charles Jones,PF,37,HOU,3,0,36,1,3,0.33299999999999996,0,0,0.0,1,3,0.33299999999999996,0.33299999999999996,1,2,0.5,2,5,7,0,0,1,0,8,3
Eddie Jones,SG,23,LAL,64,58,1981,342,744,0.46,91,246,0.37,251,498,0.504,0.521,122,169,0.722,79,170,249,128,131,41,75,175,897
Popeye Jones,PF,24,DAL,80,80,2385,372,839,0.44299999999999995,1,12,0.083,371,827,0.449,0.444,80,124,0.645,329,515,844,163,35,27,124,267,825
Michael Jordan*,SG,31,CHI,17,17,668,166,404,0.41100000000000003,16,32,0.5,150,372,0.40299999999999997,0.431,109,136,0.8009999999999999,25,92,117,90,30,13,35,47,457
Adam Keefe,SF,24,UTA,75,0,1270,172,298,0.5770000000000001,0,0,0.0,172,298,0.5770000000000001,0.5770000000000001,117,173,0.6759999999999999,135,192,327,30,36,25,62,141,461
Shawn Kemp,PF,25,SEA,82,79,2679,545,997,0.547,2,7,0.28600000000000003,543,990,0.5479999999999999,0.5479999999999999,438,585,0.7490000000000001,318,575,893,149,102,122,259,337,1530
Steve Kerr,PG,29,CHI,82,0,1839,261,495,0.527,89,170,0.524,172,325,0.529,0.617,63,81,0.778,20,99,119,151,44,3,48,114,674
Jerome Kersey,SF,32,POR,63,0,1143,203,489,0.415,7,27,0.259,196,462,0.424,0.42200000000000004,95,124,0.7659999999999999,93,163,256,82,52,35,64,173,508
Randolph Keys,SF,28,LAL,6,0,83,9,26,0.34600000000000003,0,9,0.0,9,17,0.529,0.34600000000000003,2,2,1.0,6,11,17,2,1,2,2,16,20
Jason Kidd*,PG,21,DAL,79,79,2668,330,857,0.385,70,257,0.272,260,600,0.433,0.426,192,275,0.698,152,278,430,607,151,24,250,146,922
Rich King,C,25,SEA,2,0,6,0,2,0.0,0,0,0.0,0,2,0.0,0.0,0,2,0.0,0,0,0,0,0,0,0,1,0
Stacey King,PF,28,MIN,50,10,792,99,212,0.467,0,1,0.0,99,211,0.469,0.467,68,102,0.667,54,111,165,26,24,20,64,126,266
Greg Kite,C,33,TOT,11,0,77,3,17,0.17600000000000002,0,0,0.0,3,17,0.17600000000000002,0.17600000000000002,2,10,0.2,12,10,22,1,0,0,6,15,8
Joe Kleine,C,33,PHO,75,42,968,119,265,0.449,0,2,0.0,119,263,0.452,0.449,42,49,0.857,82,177,259,39,14,18,35,174,280
Negele Knight,PG,27,TOT,47,17,708,85,214,0.397,11,28,0.39299999999999996,74,186,0.39799999999999996,0.423,18,25,0.72,21,40,61,127,21,5,49,70,199
Jon Koncak,C,31,ATL,62,20,943,77,187,0.41200000000000003,12,36,0.33299999999999996,65,151,0.43,0.444,13,24,0.542,23,161,184,52,36,46,20,137,179
Larry Krystkowiak,PF,30,CHI,19,14,287,28,72,0.389,0,0,0.0,28,72,0.389,0.389,27,30,0.9,19,40,59,26,9,2,25,34,83
Toni Kukoč,SF,26,CHI,81,55,2584,487,967,0.504,62,198,0.313,425,769,0.5529999999999999,0.536,235,314,0.748,155,285,440,372,102,16,165,163,1271
Christian Laettner,C,25,MIN,81,80,2770,450,920,0.489,13,40,0.325,437,880,0.49700000000000005,0.496,409,500,0.818,164,449,613,234,101,87,225,302,1322
Andrew Lang,C,28,ATL,82,63,2340,320,677,0.473,2,3,0.667,318,674,0.47200000000000003,0.474,152,188,0.809,154,302,456,72,45,144,108,271,794
Antonio Lang,SF,22,PHO,12,0,53,4,10,0.4,0,0,0.0,4,10,0.4,0.4,3,4,0.75,3,1,4,1,0,2,5,11,11
Eric Leckner,C,28,DET,57,11,623,87,165,0.527,0,2,0.0,87,163,0.534,0.527,51,72,0.708,47,127,174,14,15,15,39,122,225
Doug Lee,SG,30,SAC,22,0,75,9,25,0.36,7,18,0.389,2,7,0.28600000000000003,0.5,18,21,0.857,0,5,5,5,6,3,5,18,43
Tim Legler,SG,28,GSW,24,0,371,60,115,0.522,26,50,0.52,34,65,0.523,0.635,30,34,0.882,12,28,40,27,12,1,20,33,176
Jim Les,PG,31,ATL,24,0,188,11,38,0.289,5,23,0.217,6,15,0.4,0.355,23,27,0.852,6,20,26,44,4,0,21,28,50
Cliff Levingston,PF,34,DEN,57,0,469,55,130,0.423,0,1,0.0,55,129,0.426,0.423,19,45,0.42200000000000004,49,75,124,27,13,20,21,91,129
Alton Lister,C,36,MIL,60,32,776,66,134,0.493,0,1,0.0,66,133,0.496,0.493,35,70,0.5,67,169,236,12,16,57,38,146,167
Brad Lohaus,PF,30,MIA,61,1,730,97,231,0.42,63,155,0.406,34,76,0.447,0.556,10,15,0.667,28,74,102,43,20,25,29,85,267
Grant Long,PF,28,TOT,81,79,2641,342,716,0.478,11,31,0.355,331,685,0.483,0.485,244,325,0.7509999999999999,191,415,606,131,109,34,155,243,939
Luc Longley,C,26,CHI,55,0,1001,135,302,0.447,0,2,0.0,135,300,0.45,0.447,88,107,0.8220000000000001,82,181,263,73,24,45,86,177,358
Ryan Lorthridge,SG,22,GSW,37,2,672,106,223,0.475,3,14,0.214,103,209,0.493,0.48200000000000004,57,88,0.648,24,47,71,101,28,1,57,42,272
George Lynch,SF,24,LAL,56,15,953,138,295,0.46799999999999997,3,21,0.14300000000000002,135,274,0.493,0.473,62,86,0.721,75,109,184,62,51,10,73,86,341
Don MacLean,PF,25,WSB,39,20,1052,158,361,0.43799999999999994,10,40,0.25,148,321,0.461,0.452,104,136,0.765,46,119,165,51,15,3,44,97,430
Mark Macon,SG,25,DET,55,6,721,101,265,0.381,20,62,0.32299999999999995,81,203,0.39899999999999997,0.419,54,68,0.794,29,47,76,63,67,1,41,97,276
Gerald Madkins,SG,25,CLE,7,0,28,2,6,0.33299999999999996,1,2,0.5,1,4,0.25,0.41700000000000004,3,4,0.75,0,0,0,1,2,0,3,2,8
Rick Mahorn,PF,36,NJN,58,7,630,79,151,0.523,1,3,0.33299999999999996,78,148,0.527,0.526,39,49,0.7959999999999999,45,117,162,26,11,12,34,93,198
Dan Majerle,SF,29,PHO,82,46,3091,438,1031,0.425,199,548,0.363,239,483,0.495,0.521,206,282,0.73,104,271,375,340,96,38,105,155,1281
Jeff Malone,SG,33,PHI,19,19,660,144,284,0.507,11,28,0.39299999999999996,133,256,0.52,0.526,51,59,0.8640000000000001,11,44,55,29,15,0,29,35,350
Karl Malone*,PF,31,UTA,82,82,3126,830,1548,0.536,11,41,0.268,819,1507,0.5429999999999999,0.54,516,695,0.742,156,715,871,285,129,85,236,269,2187
Moses Malone*,C,39,SAS,17,0,149,13,35,0.371,1,2,0.5,12,33,0.364,0.386,22,32,0.688,20,26,46,6,2,3,11,15,49
Danny Manning,PF,28,PHO,46,19,1510,340,622,0.547,6,21,0.28600000000000003,334,601,0.556,0.551,136,202,0.6729999999999999,97,179,276,154,41,57,121,176,822
Šarūnas Marčiulionis*,SG,30,SEA,66,4,1194,216,457,0.473,35,87,0.402,181,370,0.489,0.511,145,198,0.732,17,51,68,110,72,3,98,126,612
Donyell Marshall,SF,21,TOT,72,31,2086,345,876,0.39399999999999996,69,243,0.284,276,633,0.436,0.433,147,222,0.662,137,268,405,105,45,88,115,157,906
Bob Martin,C,25,LAC,1,0,14,1,5,0.2,0,0,0.0,1,5,0.2,0.2,0,0,0.0,2,0,2,1,0,1,0,2,2
Darrick Martin,PG,23,MIN,34,9,803,95,233,0.408,7,38,0.184,88,195,0.451,0.423,57,65,0.877,14,50,64,133,34,0,62,88,254
Jamal Mashburn,SF,22,DAL,80,80,2980,683,1566,0.436,113,344,0.32799999999999996,570,1222,0.466,0.47200000000000003,447,605,0.7390000000000001,116,215,331,298,82,8,235,190,1926
Anthony Mason,PF,28,NYK,77,11,2496,287,507,0.5660000000000001,0,1,0.0,287,506,0.5670000000000001,0.5660000000000001,191,298,0.6409999999999999,182,468,650,240,69,21,123,253,765
Tony Massenburg,C,27,LAC,80,50,2127,282,601,0.469,0,3,0.0,282,598,0.47200000000000003,0.469,177,235,0.753,160,295,455,67,48,58,118,253,741
Vernon Maxwell,SG,29,HOU,64,54,2038,306,777,0.39399999999999996,143,441,0.324,163,336,0.485,0.486,99,144,0.688,18,146,164,274,75,13,137,157,854
Lee Mayberry,PG,24,MIL,82,50,1744,172,408,0.42200000000000004,72,177,0.40700000000000003,100,231,0.433,0.51,58,83,0.6990000000000001,21,61,82,276,51,4,106,123,474
George McCloud,SF,27,DAL,42,3,802,144,328,0.439,34,89,0.382,110,239,0.46,0.491,80,96,0.833,82,65,147,53,23,9,40,71,402
Xavier McDaniel,SF,31,BOS,68,15,1430,246,546,0.451,6,21,0.28600000000000003,240,525,0.457,0.456,89,125,0.7120000000000001,94,206,300,108,30,20,89,146,587
Jim McIlvaine,C,22,WSB,55,0,534,34,71,0.479,0,0,0.0,34,71,0.479,0.479,28,41,0.6829999999999999,40,65,105,10,10,60,19,95,96
Derrick McKey,SF,28,IND,81,81,2805,411,833,0.493,32,89,0.36,379,744,0.509,0.513,221,297,0.7440000000000001,125,269,394,276,125,49,168,260,1075
Aaron McKie,SG,22,POR,45,20,827,116,261,0.444,11,28,0.39299999999999996,105,233,0.451,0.466,50,73,0.685,35,94,129,89,36,16,39,97,293
Nate McMillan,PG,30,SEA,80,18,2070,166,397,0.418,53,155,0.342,113,242,0.467,0.485,34,58,0.586,65,237,302,421,165,53,126,275,419
Darnell Mee,SG,23,DEN,2,0,8,1,5,0.2,1,3,0.33299999999999996,0,2,0.0,0.3,0,0,0.0,0,1,1,2,1,0,0,0,3
Anthony Miller,PF,23,LAL,46,1,527,70,132,0.53,2,5,0.4,68,127,0.535,0.5379999999999999,47,76,0.618,67,85,152,35,20,7,38,77,189
Oliver Miller,PF,24,DET,64,22,1558,232,418,0.555,3,13,0.231,229,405,0.565,0.5589999999999999,78,124,0.629,162,313,475,93,60,116,115,217,545
Reggie Miller*,SG,29,IND,81,81,2665,505,1092,0.462,195,470,0.415,310,622,0.498,0.552,383,427,0.897,30,180,210,242,98,16,151,157,1588
Chris Mills,SF,25,CLE,80,79,2814,359,855,0.42,94,240,0.392,265,615,0.431,0.475,174,213,0.8170000000000001,99,267,366,154,59,35,120,242,986
Terry Mills,PF,27,DET,72,69,2514,417,933,0.447,109,285,0.382,308,648,0.475,0.505,175,219,0.799,124,434,558,160,68,33,144,253,1118
Harold Miner,PG,23,MIA,45,16,871,123,305,0.40299999999999997,14,49,0.28600000000000003,109,256,0.426,0.426,69,95,0.726,38,79,117,69,15,6,77,85,329
Greg Minor,SG,23,BOS,63,8,945,155,301,0.515,2,12,0.16699999999999998,153,289,0.529,0.518,65,78,0.833,49,88,137,66,32,16,44,89,377
Sam Mitchell,SF,31,IND,81,12,1377,201,413,0.48700000000000004,1,10,0.1,200,403,0.496,0.488,126,174,0.7240000000000001,95,148,243,61,43,20,54,206,529
Eric Mobley,C,24,MIL,46,26,587,78,132,0.591,2,2,1.0,76,130,0.585,0.598,22,45,0.489,55,98,153,21,8,27,24,63,180
Eric Montross,C,23,BOS,78,75,2315,307,575,0.534,0,1,0.0,307,574,0.535,0.534,167,263,0.635,196,370,566,36,29,61,112,299,781
Chris Morris,SF,29,NJN,71,49,2131,351,856,0.41,106,317,0.33399999999999996,245,539,0.455,0.47200000000000003,142,195,0.728,181,221,402,147,86,51,117,155,950
Dwayne Morton,PG,23,GSW,41,6,395,50,129,0.38799999999999996,9,25,0.36,41,104,0.39399999999999996,0.42200000000000004,58,85,0.682,21,37,58,18,11,15,27,45,167
Alonzo Mourning*,C,24,CHH,77,77,2941,571,1101,0.519,11,34,0.324,560,1067,0.525,0.524,490,644,0.7609999999999999,200,561,761,111,49,225,241,275,1643
Chris Mullin*,SF,31,GSW,25,23,890,170,348,0.489,42,93,0.452,128,255,0.502,0.5489999999999999,94,107,0.879,25,90,115,125,38,19,93,53,476
Eric Murdock,PG,26,MIL,75,32,2158,338,814,0.415,90,240,0.375,248,574,0.43200000000000005,0.47100000000000003,211,267,0.79,48,166,214,482,113,12,194,139,977
Gheorghe Mureșan,C,23,WSB,73,58,1720,303,541,0.56,0,0,0.0,303,541,0.56,0.56,124,175,0.7090000000000001,179,309,488,38,48,127,115,259,730
Lamond Murray,SF,21,LAC,81,61,2556,439,1093,0.402,65,218,0.298,374,875,0.42700000000000005,0.431,199,264,0.754,132,222,354,133,72,55,163,180,1142
Tracy Murray,SF,23,TOT,54,3,516,95,233,0.408,35,86,0.40700000000000003,60,147,0.408,0.483,33,42,0.7859999999999999,20,39,59,19,14,4,35,73,258
Dikembe Mutombo*,C,28,DEN,82,82,3100,349,628,0.556,0,0,0.0,349,628,0.556,0.556,248,379,0.654,319,710,1029,113,40,321,192,284,946
Pete Myers,SG,31,CHI,71,14,1270,119,287,0.415,10,39,0.256,109,248,0.44,0.43200000000000005,70,114,0.614,57,82,139,148,58,15,88,125,318
Ivano Newbill,SF,24,DET,34,0,331,16,45,0.35600000000000004,0,0,0.0,16,45,0.35600000000000004,0.35600000000000004,8,22,0.364,40,41,81,17,12,11,12,60,40
Johnny Newman,SF,31,MIL,82,11,1896,226,488,0.46299999999999997,45,128,0.35200000000000004,181,360,0.503,0.509,137,171,0.8009999999999999,72,101,173,91,69,13,86,234,634
Ken Norman,SF,30,ATL,74,27,1879,388,856,0.45299999999999996,98,285,0.344,290,571,0.508,0.511,64,140,0.457,103,259,362,94,34,20,96,154,938
Julius Nwosu,C,23,SAS,23,0,84,9,28,0.321,0,0,0.0,9,28,0.321,0.321,13,17,0.765,11,13,24,3,0,3,9,20,31
Shaquille O'Neal*,C,22,ORL,79,79,2923,930,1594,0.583,0,5,0.0,930,1589,0.585,0.583,455,854,0.5329999999999999,328,573,901,214,73,192,204,258,2315
Charles Oakley,PF,31,NYK,50,49,1567,192,393,0.489,3,12,0.25,189,381,0.496,0.49200000000000005,119,150,0.7929999999999999,155,290,445,126,60,7,103,179,506
Hakeem Olajuwon*,C,32,HOU,72,72,2853,798,1545,0.517,3,16,0.188,795,1529,0.52,0.517,406,537,0.7559999999999999,172,603,775,255,133,242,237,250,2005
Brian Oliver,SG,26,WSB,6,0,42,4,9,0.444,0,0,0.0,4,9,0.444,0.444,6,8,0.75,0,4,4,4,0,0,3,8,14
Bo Outlaw,PF,23,LAC,81,31,1655,170,325,0.523,0,5,0.0,170,320,0.531,0.523,82,186,0.441,121,192,313,84,90,151,78,227,422
Doug Overton,PG,25,WSB,82,20,1704,207,498,0.41600000000000004,53,125,0.424,154,373,0.413,0.469,109,125,0.872,26,117,143,246,53,2,104,126,576
Billy Owens,SG,25,MIA,70,60,2296,403,820,0.491,2,22,0.091,401,798,0.503,0.493,194,313,0.62,203,299,502,246,80,30,204,205,1002
Robert Pack,PG,25,DEN,42,32,1144,170,395,0.43,30,72,0.41700000000000004,140,323,0.433,0.46799999999999997,137,175,0.7829999999999999,19,94,113,290,61,6,134,101,507
Robert Parish*,C,41,CHH,81,4,1352,159,372,0.42700000000000005,0,0,0.0,159,372,0.42700000000000005,0.42700000000000005,71,101,0.703,93,257,350,44,27,36,66,132,389
Gary Payton*,PG,26,SEA,82,82,3015,685,1345,0.509,70,232,0.302,615,1113,0.5529999999999999,0.535,249,348,0.716,108,173,281,583,204,13,201,206,1689
Anthony Peeler,SG,25,LAL,73,24,1559,285,659,0.43200000000000005,84,216,0.389,201,443,0.45399999999999996,0.496,102,128,0.797,62,106,168,122,52,13,82,143,756
Mike Peplowski,C,24,DET,6,0,21,5,5,1.0,0,0,0.0,5,5,1.0,1.0,1,2,0.5,1,2,3,1,1,0,2,10,11
Will Perdue,C,29,CHI,78,78,1592,254,459,0.5529999999999999,0,1,0.0,254,458,0.555,0.5529999999999999,113,194,0.5820000000000001,211,311,522,90,26,56,116,220,621
Sam Perkins,C,33,SEA,82,37,2356,346,742,0.466,136,343,0.397,210,399,0.526,0.5579999999999999,215,269,0.799,96,302,398,135,72,45,77,186,1043
Elliot Perry,PG,25,PHO,82,51,1977,306,588,0.52,25,60,0.41700000000000004,281,528,0.532,0.542,158,195,0.81,51,100,151,394,156,4,163,142,795
Tim Perry,PF,29,PHI,42,1,446,27,78,0.34600000000000003,0,14,0.0,27,64,0.42200000000000004,0.34600000000000003,22,40,0.55,38,51,89,12,10,15,21,51,76
Chuck Person,SF,30,SAS,81,1,2033,317,750,0.423,172,445,0.387,145,305,0.475,0.537,66,102,0.647,49,209,258,106,45,12,102,198,872
Wesley Person,SG,23,PHO,78,56,1800,309,638,0.484,116,266,0.436,193,372,0.519,0.575,80,101,0.792,67,134,201,105,48,24,79,149,814
Derrick Phelps,PG,22,SAC,3,0,5,0,1,0.0,0,0,0.0,0,1,0.0,0.0,0,2,0.0,0,0,0,1,0,0,0,3,0
Bobby Phills,SG,25,CLE,80,79,2500,338,816,0.414,19,55,0.345,319,761,0.419,0.426,183,235,0.779,90,175,265,180,115,25,113,206,878
Eric Piatkowski,SG,24,LAC,81,11,1208,201,456,0.441,74,198,0.374,127,258,0.49200000000000005,0.522,90,115,0.7829999999999999,63,70,133,77,37,15,63,150,566
Ricky Pierce,PG,35,GSW,27,6,673,111,254,0.43700000000000006,23,70,0.32899999999999996,88,184,0.478,0.48200000000000004,93,106,0.877,12,52,64,40,22,2,24,38,338
Ed Pinckney,PF,31,MIL,62,17,835,48,97,0.495,0,0,0.0,48,97,0.495,0.495,44,62,0.71,65,146,211,21,34,17,26,64,140
Scottie Pippen*,SF,29,CHI,79,79,3014,634,1320,0.48,109,316,0.345,525,1004,0.523,0.522,315,440,0.716,175,464,639,409,232,89,271,238,1692
Olden Polynice,C,30,SAC,81,81,2534,376,691,0.544,1,1,1.0,375,690,0.5429999999999999,0.545,124,194,0.639,277,448,725,62,48,52,113,238,877
Terry Porter,PG,31,POR,35,9,770,105,267,0.39299999999999996,44,114,0.386,61,153,0.39899999999999997,0.47600000000000003,58,82,0.7070000000000001,18,63,81,133,30,2,58,60,312
Mark Price,PG,30,CLE,48,34,1375,253,612,0.413,103,253,0.40700000000000003,150,359,0.418,0.498,148,162,0.914,25,87,112,335,35,4,142,50,757
Kevin Pritchard,PG,27,TOT,19,0,194,13,32,0.406,2,8,0.25,11,24,0.45799999999999996,0.43799999999999994,16,21,0.762,0,12,12,34,2,1,12,22,44
Kurt Rambis,PF,36,LAL,26,1,195,18,35,0.514,0,0,0.0,18,35,0.514,0.514,8,12,0.667,10,24,34,16,3,9,8,35,44
Mark Randall,PF,27,DEN,8,0,39,3,10,0.3,0,1,0.0,3,9,0.33299999999999996,0.3,0,0,0.0,4,8,12,1,0,0,1,5,6
Dino Rađa*,PF,27,BOS,66,48,2147,450,919,0.49,0,1,0.0,450,918,0.49,0.49,233,307,0.759,149,424,573,111,60,86,159,232,1133
Eldridge Recasner,SG,27,DEN,3,0,13,1,6,0.16699999999999998,0,1,0.0,1,5,0.2,0.16699999999999998,4,4,1.0,0,2,2,1,3,0,2,0,6
Khalid Reeves,PG,22,MIA,67,17,1462,206,465,0.44299999999999995,67,171,0.392,139,294,0.473,0.515,140,196,0.7140000000000001,52,134,186,288,77,10,132,139,619
J.R. Reid,PF,26,SAS,81,37,1566,201,396,0.508,1,2,0.5,200,394,0.508,0.509,160,233,0.687,120,273,393,55,60,32,113,230,563
Glen Rice,SF,27,MIA,82,82,3014,667,1403,0.475,185,451,0.41,482,952,0.506,0.541,312,365,0.855,99,279,378,192,112,14,153,203,1831
Pooh Richardson,PG,28,LAC,80,77,2864,353,897,0.39399999999999996,87,244,0.35700000000000004,266,653,0.40700000000000003,0.442,81,125,0.648,38,223,261,632,129,12,171,218,874
Mitch Richmond*,SG,29,SAC,82,82,3172,668,1497,0.446,156,424,0.368,512,1073,0.47700000000000004,0.498,375,445,0.843,69,288,357,311,91,29,234,227,1867
Isaiah Rider,SG,23,MIN,75,67,2645,558,1249,0.447,139,396,0.35100000000000003,419,853,0.491,0.502,277,339,0.8170000000000001,90,159,249,245,69,23,232,194,1532
Eric Riley,C,24,LAC,40,4,434,65,145,0.44799999999999995,0,1,0.0,65,144,0.451,0.44799999999999995,47,64,0.7340000000000001,45,67,112,11,17,35,31,78,177
Doc Rivers,PG,33,TOT,63,0,989,108,302,0.358,45,127,0.354,63,175,0.36,0.43200000000000005,60,82,0.732,15,94,109,162,65,21,60,150,321
Fred Roberts,SF,34,CLE,21,0,223,28,72,0.389,4,11,0.364,24,61,0.39299999999999996,0.41700000000000004,20,26,0.769,13,21,34,8,6,3,7,26,80
Clifford Robinson,SF,28,POR,75,73,2725,597,1320,0.452,142,383,0.371,455,937,0.486,0.506,265,382,0.6940000000000001,152,271,423,198,79,82,158,240,1601
David Robinson*,C,29,SAS,81,81,3074,788,1487,0.53,6,20,0.3,782,1467,0.5329999999999999,0.532,656,847,0.774,234,643,877,236,134,262,233,230,2238
Glenn Robinson,SF,22,MIL,80,76,2958,636,1410,0.451,86,268,0.321,550,1142,0.48200000000000004,0.48200000000000004,397,499,0.7959999999999999,169,344,513,197,115,22,313,234,1755
James Robinson,PG,24,POR,71,25,1539,255,624,0.409,76,223,0.341,179,401,0.446,0.47,65,110,0.591,42,90,132,180,48,13,127,142,651
Dennis Rodman*,PF,33,SAS,49,26,1568,137,240,0.5710000000000001,0,2,0.0,137,238,0.5760000000000001,0.5710000000000001,75,111,0.6759999999999999,274,549,823,97,31,23,98,159,349
Carlos Rogers,C,23,GSW,49,18,1017,180,340,0.529,2,14,0.14300000000000002,178,326,0.546,0.532,76,146,0.521,108,170,278,37,22,52,84,124,438
Rodney Rogers,PF,23,DEN,80,77,2142,375,769,0.488,50,148,0.33799999999999997,325,621,0.523,0.52,179,275,0.6509999999999999,132,253,385,161,95,46,173,281,979
Tree Rollins,C,39,ORL,51,3,478,20,42,0.47600000000000003,0,0,0.0,20,42,0.47600000000000003,0.47600000000000003,21,31,0.677,31,64,95,9,7,36,23,63,61
Sean Rooks,C,25,MIN,80,70,2405,289,615,0.47,0,5,0.0,289,610,0.474,0.47,290,381,0.7609999999999999,165,321,486,97,29,71,142,208,868
Jalen Rose,SF,22,DEN,81,37,1798,227,500,0.45399999999999996,36,114,0.316,191,386,0.495,0.49,173,234,0.7390000000000001,57,160,217,389,65,22,160,206,663
Donald Royal,SF,28,ORL,70,68,1841,206,434,0.475,0,4,0.0,206,430,0.479,0.475,223,299,0.746,83,196,279,198,45,16,125,156,635
Clifford Rozier,C,22,GSW,66,34,1494,189,390,0.485,2,7,0.28600000000000003,187,383,0.488,0.48700000000000004,68,152,0.447,200,286,486,45,35,39,89,196,448
Trevor Ruffin,PG,24,PHO,49,1,319,84,197,0.426,38,99,0.384,46,98,0.469,0.523,27,38,0.711,8,15,23,48,14,2,47,52,233
Bryon Russell,SF,24,UTA,63,15,860,104,238,0.43700000000000006,13,44,0.295,91,194,0.469,0.46399999999999997,62,93,0.667,44,97,141,34,48,11,42,101,283
John Salley,C,30,MIA,75,50,1955,197,395,0.499,0,0,0.0,197,395,0.499,0.499,153,207,0.7390000000000001,110,226,336,123,47,85,97,279,547
Danny Schayes,C,35,PHO,69,27,823,126,248,0.508,1,1,1.0,125,247,0.506,0.51,50,69,0.725,57,151,208,89,20,37,64,170,303
Steve Scheffler,C,27,SEA,18,0,102,12,23,0.522,0,0,0.0,12,23,0.522,0.522,15,18,0.833,8,15,23,4,2,2,3,9,39
Dwayne Schintzius,C,26,NJN,43,11,318,41,108,0.38,0,0,0.0,41,108,0.38,0.38,6,11,0.545,29,52,81,15,3,17,17,45,88
Detlef Schrempf,SF,32,SEA,82,82,2886,521,997,0.523,93,181,0.514,428,816,0.525,0.569,437,521,0.8390000000000001,135,373,508,310,93,35,176,252,1572
Byron Scott,PG,33,IND,80,1,1528,265,583,0.455,79,203,0.389,186,380,0.489,0.522,193,227,0.85,18,133,151,108,61,13,119,123,802
Dennis Scott,SF,26,ORL,62,10,1499,283,645,0.439,150,352,0.426,133,293,0.45399999999999996,0.555,86,114,0.754,25,121,146,131,45,14,57,119,802
Malik Sealy,SG,24,LAC,60,41,1604,291,669,0.435,22,73,0.301,269,596,0.451,0.451,174,223,0.78,77,137,214,107,72,25,83,173,778
Rony Seikaly,C,29,GSW,36,35,1035,162,314,0.516,0,0,0.0,162,314,0.516,0.516,111,160,0.6940000000000001,77,189,266,45,20,37,104,122,435
Charles Shackleford,PF,28,MIN,21,2,239,39,65,0.6,0,0,0.0,39,65,0.6,0.6,16,20,0.8,16,51,67,8,8,6,8,47,94
Brian Shaw,PG,28,ORL,78,9,1836,192,494,0.389,48,184,0.261,144,310,0.465,0.43700000000000006,70,95,0.737,52,189,241,406,73,18,184,184,502
Lionel Simmons,SF,26,SAC,58,3,1064,131,312,0.42,6,16,0.375,125,296,0.42200000000000004,0.429,59,84,0.7020000000000001,61,135,196,89,28,23,70,118,327
Dickey Simpkins,PF,22,CHI,59,5,586,78,184,0.424,0,0,0.0,78,184,0.424,0.424,50,72,0.6940000000000001,60,91,151,37,10,7,45,72,206
Scott Skiles,PG,30,WSB,62,62,2077,265,583,0.455,96,228,0.42100000000000004,169,355,0.47600000000000003,0.537,179,202,0.8859999999999999,26,133,159,452,70,6,172,135,805
Reggie Slater,PF,24,DEN,25,0,236,40,81,0.494,0,0,0.0,40,81,0.494,0.494,40,55,0.727,21,36,57,12,7,3,26,47,120
Charles Smith,SF,29,NYK,76,58,2150,352,747,0.47100000000000003,7,31,0.226,345,716,0.48200000000000004,0.47600000000000003,255,322,0.792,144,180,324,120,49,95,147,286,966
Chris Smith,SG,24,MIN,64,17,1073,116,264,0.439,47,108,0.435,69,156,0.442,0.528,41,63,0.6509999999999999,14,59,73,146,32,22,50,119,320
Doug Smith,PF,25,DAL,63,0,826,131,314,0.41700000000000004,1,12,0.083,130,302,0.43,0.419,57,75,0.76,43,101,144,44,29,26,37,132,320
Kenny Smith,PG,29,HOU,81,81,2030,287,593,0.484,142,331,0.429,145,262,0.5529999999999999,0.604,126,148,0.851,27,128,155,323,71,10,123,109,842
Michael Smith,PF,29,LAC,29,0,319,63,134,0.47,1,8,0.125,62,126,0.49200000000000005,0.474,26,30,0.867,13,43,56,20,6,2,18,41,153
Michael Smith,PF,22,SAC,82,0,1736,220,406,0.542,0,2,0.0,220,404,0.545,0.542,127,262,0.485,174,312,486,67,61,49,106,235,567
Steve Smith,SG,25,TOT,80,61,2665,428,1005,0.426,137,416,0.32899999999999996,291,589,0.494,0.494,312,371,0.841,104,172,276,274,62,33,155,225,1305
Tony Smith,SG,26,LAL,61,4,1024,132,309,0.42700000000000005,32,91,0.35200000000000004,100,218,0.45899999999999996,0.479,44,63,0.698,43,64,107,102,46,7,50,111,340
Rik Smits,C,28,IND,78,78,2381,558,1060,0.526,0,2,0.0,558,1058,0.527,0.526,284,377,0.753,192,409,601,111,40,79,189,278,1400
Elmore Spencer,C,25,LAC,19,8,368,52,118,0.441,0,1,0.0,52,117,0.444,0.441,28,50,0.56,11,54,65,25,14,23,48,62,132
Felton Spencer,C,27,UTA,34,34,905,105,215,0.488,0,0,0.0,105,215,0.488,0.488,107,135,0.7929999999999999,90,170,260,17,12,32,68,131,317
Latrell Sprewell,SG,24,GSW,69,69,2771,490,1171,0.418,90,326,0.276,400,845,0.473,0.457,350,448,0.7809999999999999,58,198,256,279,112,46,230,108,1420
John Starks,SG,29,NYK,80,78,2725,419,1062,0.395,217,611,0.355,202,451,0.44799999999999995,0.49700000000000005,168,228,0.737,34,185,219,411,92,4,160,257,1223
Larry Stewart,SF,26,WSB,40,0,346,41,89,0.461,0,2,0.0,41,87,0.47100000000000003,0.461,20,30,0.667,28,39,67,18,16,9,16,52,102
Bryant Stith,SG,24,DEN,81,51,2329,312,661,0.47200000000000003,20,68,0.294,292,593,0.49200000000000005,0.48700000000000004,267,324,0.8240000000000001,95,173,268,153,91,18,110,142,911
John Stockton*,PG,32,UTA,82,82,2867,429,791,0.542,102,227,0.449,327,564,0.58,0.607,246,306,0.804,57,194,251,1011,194,22,267,215,1206
Mark Strickland,PF,24,IND,4,0,9,1,3,0.33299999999999996,0,0,0.0,1,3,0.33299999999999996,0.33299999999999996,1,2,0.5,2,2,4,0,0,1,1,0,3
Rod Strickland,PG,28,POR,64,61,2267,441,946,0.466,46,123,0.374,395,823,0.48,0.49,283,380,0.745,73,244,317,562,123,9,209,118,1211
Derek Strong,PF,26,BOS,70,24,1344,149,329,0.45299999999999996,2,7,0.28600000000000003,147,322,0.457,0.456,141,172,0.82,136,239,375,44,24,13,79,143,441
Greg Sutton,PG,27,CHH,53,4,690,94,230,0.409,43,115,0.374,51,115,0.44299999999999995,0.502,32,45,0.711,8,48,56,91,33,2,51,114,263
Aaron Swinson,SF,24,PHO,9,0,51,10,18,0.556,0,0,0.0,10,18,0.556,0.556,4,5,0.8,3,5,8,3,1,0,5,8,24
Žan Tabak,C,24,HOU,37,0,182,24,53,0.45299999999999996,0,1,0.0,24,52,0.462,0.45299999999999996,27,44,0.614,23,34,57,4,2,7,18,37,75
Roy Tarpley,C,30,DAL,55,1,1354,292,610,0.479,5,18,0.278,287,592,0.485,0.483,102,122,0.836,142,307,449,58,45,55,109,155,691
Brooks Thompson,PG,24,ORL,38,2,246,45,114,0.395,18,58,0.31,27,56,0.48200000000000004,0.474,8,12,0.667,7,16,23,43,10,2,27,46,116
LaSalle Thompson,C,33,IND,38,3,453,49,118,0.415,0,0,0.0,49,118,0.415,0.415,14,16,0.875,28,61,89,18,18,10,33,76,112
Otis Thorpe,PF,32,TOT,70,35,2096,385,681,0.565,0,7,0.0,385,674,0.5710000000000001,0.565,167,281,0.594,202,356,558,112,41,28,132,224,937
Sedale Threatt,PG,33,LAL,59,2,1384,217,437,0.49700000000000005,36,95,0.379,181,342,0.529,0.5379999999999999,88,111,0.7929999999999999,21,103,124,248,54,12,70,139,558
Wayman Tisdale,PF,30,PHO,65,13,1276,278,574,0.484,0,0,0.0,278,574,0.484,0.484,94,122,0.77,83,164,247,45,29,27,64,190,650
Tom Tolbert,PF,29,CHH,10,0,57,6,18,0.33299999999999996,0,4,0.0,6,14,0.429,0.33299999999999996,2,2,1.0,7,10,17,2,0,0,3,9,14
Keith Tower,C,24,ORL,3,0,7,0,2,0.0,0,0,0.0,0,2,0.0,0.0,1,2,0.5,1,2,3,0,0,0,1,1,1
Anthony Tucker,SF,25,WSB,62,13,982,96,210,0.457,0,1,0.0,96,209,0.45899999999999996,0.457,51,83,0.614,44,126,170,68,46,11,56,129,243
Henry Turner,PF,28,SAC,30,0,149,23,57,0.40399999999999997,2,5,0.4,21,52,0.40399999999999997,0.42100000000000004,20,35,0.5710000000000001,17,11,28,7,8,1,12,20,68
Jeff Turner,PF,32,ORL,49,5,576,73,178,0.41,27,75,0.36,46,103,0.447,0.486,26,29,0.897,23,74,97,38,12,3,22,102,199
B.J. Tyler,PG,23,PHI,55,8,809,72,189,0.381,16,51,0.314,56,138,0.406,0.423,35,50,0.7,13,49,62,174,36,2,97,58,195
Nick Van Exel,PG,23,LAL,80,80,2944,465,1107,0.42,183,511,0.358,282,596,0.473,0.503,235,300,0.7829999999999999,27,196,223,660,97,6,220,157,1348
Loy Vaught,PF,26,LAC,80,79,2966,609,1185,0.514,7,33,0.212,602,1152,0.523,0.517,176,248,0.71,261,511,772,139,104,29,166,243,1401
Fred Vinson,SG,24,ATL,5,0,27,1,7,0.14300000000000002,1,6,0.16699999999999998,0,1,0.0,0.214,1,1,1.0,0,0,0,1,0,0,2,4,4
Kenny Walker,SF,30,WSB,24,0,266,18,42,0.429,0,0,0.0,18,42,0.429,0.429,21,28,0.75,19,28,47,7,5,5,15,42,57
Rex Walters,SG,24,NJN,80,30,1435,206,469,0.439,71,196,0.36200000000000004,135,273,0.495,0.515,40,52,0.769,18,75,93,121,37,16,71,135,523
Charlie Ward,PG,24,NYK,10,0,44,4,19,0.21100000000000002,1,10,0.1,3,9,0.33299999999999996,0.237,7,10,0.7,1,5,6,4,2,0,8,7,16
Jamie Watson,SF,22,UTA,60,1,673,76,152,0.5,5,19,0.263,71,133,0.534,0.516,38,56,0.679,16,58,74,59,35,11,51,86,195
Clarence Weatherspoon,SF,24,PHI,76,76,2991,543,1238,0.439,4,21,0.19,539,1217,0.44299999999999995,0.44,283,377,0.7509999999999999,144,382,526,215,115,67,191,195,1373
Spud Webb,PG,31,SAC,76,76,2458,302,689,0.43799999999999994,48,145,0.331,254,544,0.467,0.473,226,242,0.934,29,145,174,468,75,8,185,148,878
Chris Webber,PF,21,WSB,54,52,2067,464,938,0.495,40,145,0.276,424,793,0.535,0.516,117,233,0.502,200,318,518,256,83,85,167,186,1085
Bill Wennington,C,31,CHI,73,1,956,156,317,0.49200000000000005,0,4,0.0,156,313,0.498,0.49200000000000005,51,63,0.81,64,126,190,40,22,17,39,198,363
David Wesley,PG,24,BOS,51,36,1380,128,313,0.409,51,119,0.429,77,194,0.397,0.49,71,94,0.755,31,86,117,266,82,9,87,144,378
Doug West,SG,27,MIN,71,65,2328,351,762,0.461,11,61,0.18,340,701,0.485,0.46799999999999997,206,246,0.8370000000000001,60,167,227,185,65,24,126,250,919
Mark West,C,34,DET,67,58,1543,217,390,0.556,0,0,0.0,217,390,0.556,0.556,66,138,0.478,160,248,408,18,27,102,85,247,500
Ennis Whatley,PG,32,ATL,27,2,292,24,53,0.45299999999999996,2,8,0.25,22,45,0.489,0.47200000000000003,20,32,0.625,9,21,30,54,19,0,19,37,70
Chris Whitney,PG,23,SAS,25,0,179,14,47,0.298,3,19,0.158,11,28,0.39299999999999996,0.33,11,11,1.0,4,9,13,28,4,0,18,34,42
Morlon Wiley,PG,28,TOT,43,2,424,50,117,0.42700000000000005,30,79,0.38,20,38,0.526,0.556,7,10,0.7,6,37,43,75,22,2,23,44,137
Dominique Wilkins*,SF,35,BOS,77,64,2423,496,1169,0.424,112,289,0.38799999999999996,384,880,0.436,0.47200000000000003,266,340,0.782,157,244,401,166,61,14,173,130,1370
Aaron Williams,PF,23,MIL,15,0,72,8,24,0.33299999999999996,0,1,0.0,8,23,0.348,0.33299999999999996,8,12,0.667,5,14,19,0,2,6,7,14,24
Buck Williams,PF,34,POR,82,82,2422,309,604,0.512,1,2,0.5,308,602,0.512,0.512,138,205,0.6729999999999999,251,418,669,78,67,69,119,254,757
Herb Williams,C,36,NYK,56,3,743,82,180,0.456,0,0,0.0,82,180,0.456,0.456,23,37,0.622,23,109,132,27,13,45,40,108,187
Hot Rod Williams,PF,32,CLE,74,73,2641,366,810,0.452,1,5,0.2,365,805,0.45299999999999996,0.452,196,286,0.685,173,334,507,192,83,101,149,211,929
Jayson Williams,PF,26,NJN,75,6,982,149,323,0.461,0,5,0.0,149,318,0.469,0.461,65,122,0.5329999999999999,179,246,425,35,26,33,59,160,363
John Williams,SF,28,IND,34,0,402,41,115,0.35700000000000004,4,12,0.33299999999999996,37,103,0.359,0.374,14,25,0.56,23,39,62,27,10,2,35,48,100
Lorenzo Williams,C,25,DAL,82,81,2383,145,304,0.47700000000000004,0,0,0.0,145,304,0.47700000000000004,0.47700000000000004,38,101,0.376,291,399,690,124,52,148,105,306,328
Micheal Williams,PG,28,MIN,1,1,28,1,4,0.25,0,0,0.0,1,4,0.25,0.25,4,5,0.8,0,1,1,3,2,0,3,3,6
Monty Williams,SF,23,NYK,41,23,503,60,133,0.451,0,8,0.0,60,125,0.48,0.451,17,38,0.447,42,56,98,49,20,4,41,87,137
Reggie Williams,SF,30,DEN,74,70,2198,388,846,0.45899999999999996,85,266,0.32,303,580,0.522,0.509,132,174,0.759,94,235,329,231,114,67,124,264,993
Scott Williams,PF,26,PHI,77,43,1781,206,434,0.475,0,7,0.0,206,427,0.48200000000000004,0.475,79,107,0.738,173,312,485,59,71,40,84,237,491
Walt Williams,SF,24,SAC,77,77,2739,445,998,0.446,103,296,0.348,342,702,0.48700000000000004,0.49700000000000005,266,364,0.731,100,245,345,316,123,63,243,265,1259
Kevin Willis,PF,32,TOT,67,63,2390,473,1015,0.466,3,15,0.2,470,1000,0.47,0.467,205,297,0.69,227,505,732,86,60,36,162,215,1154
Trevor Wilson,PF,26,SAC,15,0,147,18,40,0.45,0,0,0.0,18,40,0.45,0.45,11,14,0.7859999999999999,10,16,26,12,4,2,6,12,47
David Wingate,SG,31,CHH,52,9,515,50,122,0.41,4,22,0.182,46,100,0.46,0.426,18,24,0.75,11,49,60,56,19,6,27,60,122
Dontonio Wingfield,SF,20,SEA,20,0,81,18,51,0.353,2,12,0.16699999999999998,16,39,0.41,0.373,8,10,0.8,11,19,30,3,5,3,8,15,46
Joe Wolf,PF,30,CHH,63,6,583,38,81,0.469,2,6,0.33299999999999996,36,75,0.48,0.48100000000000004,12,16,0.75,34,95,129,37,9,6,22,101,90
David Wood,PF,30,GSW,78,13,1336,153,326,0.469,31,91,0.341,122,235,0.519,0.517,91,117,0.778,83,158,241,65,28,13,53,217,428
Randy Woods,PG,24,LAC,62,3,495,37,117,0.316,22,74,0.297,15,43,0.349,0.41,28,38,0.737,10,34,44,134,41,0,55,87,124
Haywoode Workman,PG,29,IND,69,14,1028,101,269,0.375,35,98,0.35700000000000004,66,171,0.386,0.441,55,74,0.743,21,90,111,194,59,5,73,115,292
Sharone Wright,C,22,PHI,79,49,2044,361,776,0.465,0,8,0.0,361,768,0.47,0.465,182,282,0.645,191,281,472,48,37,104,151,246,904
Danny Young,PG,32,MIL,7,0,77,9,17,0.529,5,12,0.41700000000000004,4,5,0.8,0.6759999999999999,1,1,1.0,1,4,5,12,4,0,4,8,24
