Player,Pos,Age,Tm,G,GS,MP,FG,FGA,FG%,3P,3PA,3P%,2P,2PA,2P%,eFG%,FT,FTA,FT%,ORB,DRB,TRB,AST,STL,BLK,TOV,PF,PTS
Alaa Abdelnaby,PF,22,POR,43,0,290,55,116,0.474,0,0,0.0,55,116,0.474,0.474,25,44,0.568,27,62,89,12,4,12,22,39,135
Mahmoud Abdul-Rauf,PG,21,DEN,67,19,1505,417,1009,0.413,24,100,0.24,393,909,0.43200000000000005,0.425,84,98,0.857,34,87,121,206,55,4,110,149,942
Mark Acres,C,28,ORL,68,0,1313,109,214,0.509,1,3,0.33299999999999996,108,211,0.512,0.512,66,101,0.653,140,219,359,25,25,25,42,218,285
Michael Adams,PG,28,DEN,66,66,2346,560,1421,0.39399999999999996,167,564,0.29600000000000004,393,857,0.45899999999999996,0.45299999999999996,465,529,0.879,58,198,256,693,147,6,240,162,1752
Mark Aguirre,SF,31,DET,78,13,2006,420,909,0.462,24,78,0.308,396,831,0.47700000000000004,0.475,240,317,0.757,134,240,374,139,47,20,128,209,1104
Danny Ainge,SG,31,POR,80,0,1710,337,714,0.47200000000000003,102,251,0.406,235,463,0.508,0.5429999999999999,114,138,0.826,45,160,205,285,63,13,100,195,890
Mark Alarie,PF,27,WSB,42,1,587,99,225,0.44,5,21,0.23800000000000002,94,204,0.461,0.451,41,48,0.8540000000000001,41,76,117,45,15,8,40,88,244
Steve Alford,PG,26,DAL,34,0,236,59,117,0.504,7,23,0.304,52,94,0.5529999999999999,0.534,26,31,0.8390000000000001,10,14,24,22,8,1,16,11,151
Greg Anderson,PF,26,TOT,68,2,924,116,270,0.43,0,1,0.0,116,269,0.431,0.43,60,115,0.522,97,221,318,16,35,45,84,140,292
Nick Anderson,SG,23,ORL,70,42,1971,400,857,0.467,17,58,0.293,383,799,0.479,0.47700000000000004,173,259,0.6679999999999999,92,294,386,106,74,44,113,145,990
Ron Anderson,SF,32,PHI,82,13,2340,512,1055,0.485,9,43,0.209,503,1012,0.49700000000000005,0.49,165,198,0.833,103,264,367,115,65,13,100,163,1198
Willie Anderson,SG,24,SAS,75,75,2592,453,991,0.457,7,35,0.2,446,956,0.467,0.461,170,213,0.7979999999999999,68,283,351,358,79,46,167,226,1083
Michael Ansley,SF,23,ORL,67,1,877,144,263,0.5479999999999999,0,0,0.0,144,263,0.5479999999999999,0.5479999999999999,91,127,0.7170000000000001,122,131,253,25,27,7,32,125,379
B.J. Armstrong,PG,23,CHI,82,0,1731,304,632,0.48100000000000004,15,30,0.5,289,602,0.48,0.493,97,111,0.8740000000000001,25,124,149,301,70,4,107,118,720
Vincent Askew,SG,24,GSW,7,0,85,12,25,0.48,0,0,0.0,12,25,0.48,0.48,9,11,0.818,7,4,11,13,2,0,6,21,33
Keith Askins,SF,23,MIA,39,1,266,34,81,0.42,6,25,0.24,28,56,0.5,0.457,12,25,0.48,30,38,68,19,16,13,11,46,86
Miloš Babić,PF,22,CLE,12,0,52,6,19,0.316,0,0,0.0,6,19,0.316,0.316,7,12,0.583,6,3,9,4,1,1,5,7,19
Thurl Bailey,PF,29,UTA,82,22,2486,399,872,0.45799999999999996,0,3,0.0,399,869,0.45899999999999996,0.45799999999999996,219,271,0.8079999999999999,101,306,407,124,53,91,130,160,1017
Cedric Ball,PF,22,LAC,7,0,26,3,8,0.375,0,0,0.0,3,8,0.375,0.375,2,2,1.0,5,6,11,0,0,2,2,5,8
Ken Bannister,PF,30,LAC,47,3,339,43,81,0.531,0,1,0.0,43,80,0.5379999999999999,0.531,25,65,0.385,34,62,96,9,5,7,25,73,111
Charles Barkley*,SF,27,PHI,67,67,2498,665,1167,0.57,44,155,0.284,621,1012,0.614,0.589,475,658,0.722,258,422,680,284,110,33,210,173,1849
Dana Barros,PG,23,SEA,66,0,750,154,311,0.495,32,81,0.395,122,230,0.53,0.547,78,85,0.9179999999999999,17,54,71,111,23,1,54,40,418
John Battle,SG,28,ATL,79,2,1863,397,862,0.461,14,49,0.28600000000000003,383,813,0.47100000000000003,0.469,270,316,0.8540000000000001,34,125,159,217,45,6,113,145,1078
Kenny Battle,SG,26,TOT,56,8,945,133,282,0.47200000000000003,3,24,0.125,130,258,0.504,0.47700000000000004,70,93,0.753,83,93,176,62,60,18,53,108,339
William Bedford,C,27,DET,60,4,562,106,242,0.43799999999999994,5,13,0.385,101,229,0.441,0.44799999999999995,55,78,0.705,55,76,131,32,2,36,32,76,272
Benoit Benjamin,C,26,TOT,70,65,2236,386,778,0.496,0,0,0.0,386,778,0.496,0.496,210,295,0.7120000000000001,157,566,723,119,54,145,235,184,982
Winston Bennett,SF,25,CLE,27,13,334,40,107,0.374,0,0,0.0,40,107,0.374,0.374,35,47,0.745,30,34,64,28,8,2,20,50,115
Larry Bird*,SF,34,BOS,60,60,2277,462,1017,0.45399999999999996,77,198,0.389,385,819,0.47,0.49200000000000005,163,183,0.8909999999999999,53,456,509,431,108,58,187,118,1164
Rolando Blackman,SG,31,DAL,80,80,2965,634,1316,0.48200000000000004,40,114,0.35100000000000003,594,1202,0.494,0.49700000000000005,282,326,0.865,63,193,256,301,69,19,159,153,1590
Lance Blanks,SG,24,DET,38,0,214,26,61,0.426,2,16,0.125,24,45,0.5329999999999999,0.44299999999999995,10,14,0.7140000000000001,4,16,20,26,9,2,18,35,64
Mookie Blaylock,PG,23,NJN,72,70,2585,432,1039,0.41600000000000004,14,91,0.154,418,948,0.441,0.423,139,176,0.79,67,182,249,441,169,40,207,180,1017
Muggsy Bogues,PG,26,CHH,81,46,2299,241,524,0.46,0,12,0.0,241,512,0.47100000000000003,0.46,86,108,0.7959999999999999,58,158,216,669,137,3,120,160,568
Manute Bol,C,28,PHI,82,6,1522,65,164,0.396,1,14,0.071,64,150,0.42700000000000005,0.39899999999999997,24,41,0.585,66,284,350,20,16,247,63,184,155
Anthony Bonner,PF,22,SAC,34,6,750,103,230,0.44799999999999995,0,0,0.0,103,230,0.44799999999999995,0.44799999999999995,44,76,0.579,59,102,161,49,39,5,41,62,250
Sam Bowie,C,29,NJN,62,51,1916,314,723,0.434,4,22,0.182,310,701,0.442,0.43700000000000006,169,231,0.732,176,304,480,147,43,90,141,175,801
Randy Breuer,C,30,MIN,73,44,1505,197,435,0.45299999999999996,0,0,0.0,197,435,0.45299999999999996,0.45299999999999996,35,79,0.44299999999999995,114,231,345,73,35,80,69,132,429
Frank Brickowski,PF,31,MIL,75,73,1912,372,706,0.527,0,2,0.0,372,704,0.528,0.527,198,248,0.7979999999999999,129,297,426,131,86,43,160,255,942
Scott Brooks,PG,25,MIN,80,0,980,159,370,0.43,45,135,0.33299999999999996,114,235,0.485,0.491,61,72,0.847,28,44,72,204,53,5,51,122,424
Chucky Brown,SF,22,CLE,74,51,1485,263,502,0.524,0,4,0.0,263,498,0.528,0.524,101,144,0.701,78,135,213,80,26,24,94,130,627
Dee Brown,PG,22,BOS,82,5,1945,284,612,0.46399999999999997,7,34,0.20600000000000002,277,578,0.479,0.47,137,157,0.873,41,141,182,344,83,14,137,161,712
Mike Brown,C,27,UTA,82,2,1391,129,284,0.45399999999999996,0,0,0.0,129,284,0.45399999999999996,0.45399999999999996,132,178,0.742,109,228,337,49,29,24,82,166,390
Tony Brown,SG-SF,30,TOT,30,0,294,30,80,0.375,3,12,0.25,27,68,0.397,0.39399999999999996,20,23,0.87,24,19,43,16,4,0,16,47,83
Mark Bryant,PF,25,POR,53,0,781,99,203,0.488,0,1,0.0,99,202,0.49,0.488,74,101,0.733,65,125,190,27,15,12,33,120,272
Jud Buechler,SF,22,NJN,74,10,859,94,226,0.41600000000000004,1,4,0.25,93,222,0.419,0.418,43,66,0.652,61,80,141,51,33,15,26,79,232
Matt Bullard,PF,23,HOU,18,0,63,14,31,0.452,0,3,0.0,14,28,0.5,0.452,11,17,0.647,6,8,14,2,3,0,3,10,39
Willie Burton,SF,22,MIA,76,26,1928,341,773,0.441,4,30,0.133,337,743,0.45399999999999996,0.444,229,293,0.782,111,151,262,107,72,24,144,275,915
Greg Butler,C,24,LAC,9,0,37,5,19,0.263,0,0,0.0,5,19,0.263,0.263,4,6,0.667,8,8,16,1,0,0,4,9,14
Michael Cage,C,29,SEA,82,55,2141,226,445,0.508,0,3,0.0,226,442,0.511,0.508,70,112,0.625,177,381,558,89,85,58,83,194,522
Adrian Caldwell,PF,24,HOU,42,0,343,35,83,0.42200000000000004,0,1,0.0,35,82,0.42700000000000005,0.42200000000000004,7,17,0.41200000000000003,43,57,100,8,19,10,30,35,77
Rick Calloway,SG,24,SAC,64,0,678,75,192,0.391,0,2,0.0,75,190,0.395,0.391,55,79,0.696,25,53,78,61,22,7,51,98,205
Elden Campbell,PF,22,LAL,52,0,380,56,123,0.455,0,0,0.0,56,123,0.455,0.455,32,49,0.653,40,56,96,10,11,38,16,71,144
Tony Campbell,SG,28,MIN,77,71,2893,652,1502,0.434,16,61,0.262,636,1441,0.441,0.439,358,446,0.8029999999999999,161,185,346,214,121,48,190,204,1678
Antoine Carr,PF,29,SAC,77,48,2527,628,1228,0.511,0,3,0.0,628,1225,0.513,0.511,295,389,0.758,163,257,420,191,45,101,171,315,1551
Joe Barry Carroll,C,32,PHO,11,0,96,13,36,0.361,0,0,0.0,13,36,0.361,0.361,11,12,0.917,3,21,24,11,1,8,12,18,37
Bill Cartwright,C,33,CHI,79,79,2273,318,649,0.49,0,0,0.0,318,649,0.49,0.49,124,178,0.6970000000000001,167,319,486,126,32,15,113,167,760
Terry Catledge,PF,27,ORL,51,38,1459,292,632,0.462,0,5,0.0,292,627,0.466,0.462,161,258,0.624,168,187,355,58,34,9,107,113,745
Duane Causwell,C,22,SAC,76,55,1719,210,413,0.508,0,0,0.0,210,413,0.508,0.508,105,165,0.636,141,250,391,69,49,148,96,225,525
Cedric Ceballos,SF,21,PHO,63,0,730,204,419,0.48700000000000004,1,6,0.16699999999999998,203,413,0.49200000000000005,0.488,110,166,0.6629999999999999,77,73,150,35,22,5,69,70,519
Tom Chambers,PF,31,PHO,76,75,2475,556,1271,0.43700000000000006,20,73,0.27399999999999997,536,1198,0.447,0.445,379,459,0.826,104,386,490,194,65,52,177,235,1511
Rex Chapman,PG,23,CHH,70,68,2100,410,922,0.445,48,148,0.324,362,774,0.46799999999999997,0.47100000000000003,234,282,0.83,45,146,191,250,73,16,131,167,1102
Maurice Cheeks*,PG,34,NYK,76,64,2147,241,483,0.499,5,20,0.25,236,463,0.51,0.504,105,129,0.8140000000000001,22,151,173,435,128,10,108,138,592
Derrick Chievous,SF,23,CLE,18,0,110,17,46,0.37,0,0,0.0,17,46,0.37,0.37,9,16,0.563,11,7,18,2,3,1,6,16,43
Richard Coffey,SF,25,MIN,52,1,320,28,75,0.373,0,1,0.0,28,74,0.37799999999999995,0.373,12,22,0.545,42,37,79,3,6,4,5,45,68
Derrick Coleman,PF,23,NJN,74,68,2602,514,1100,0.467,13,38,0.342,501,1062,0.47200000000000003,0.473,323,442,0.731,269,490,759,163,71,99,217,217,1364
Bimbo Coles,PG,22,MIA,82,9,1355,162,393,0.41200000000000003,6,34,0.17600000000000002,156,359,0.435,0.42,71,95,0.747,56,97,153,232,65,12,98,149,401
Steve Colter,PG,28,SAC,19,0,251,23,56,0.41100000000000003,5,14,0.35700000000000004,18,42,0.429,0.455,7,10,0.7,5,21,26,37,11,1,11,27,58
Lester Conner,PG,31,TOT,74,4,1008,96,207,0.46399999999999997,0,5,0.0,96,202,0.475,0.46399999999999997,68,94,0.723,21,91,112,165,85,2,58,75,260
Anthony Cook,PF,23,DEN,58,25,1121,118,283,0.41700000000000004,0,3,0.0,118,280,0.42100000000000004,0.41700000000000004,71,129,0.55,134,192,326,26,35,72,50,100,307
Wayne Cooper,C,34,POR,67,1,746,57,145,0.39299999999999996,0,1,0.0,57,144,0.396,0.39299999999999996,33,42,0.7859999999999999,54,134,188,22,7,61,22,120,147
Tyrone Corbin,SF,28,MIN,82,82,3196,587,1311,0.44799999999999995,2,10,0.2,585,1301,0.45,0.449,296,371,0.7979999999999999,185,404,589,347,162,53,209,257,1472
Dave Corzine,C,34,SEA,28,0,147,17,38,0.447,0,0,0.0,17,38,0.447,0.447,13,22,0.591,10,23,33,4,5,5,2,18,47
Pat Cummings,PF,34,UTA,4,0,26,4,6,0.667,0,0,0.0,4,6,0.667,0.667,7,10,0.7,3,2,5,0,0,0,2,8,15
Terry Cummings,PF,29,SAS,67,62,2195,503,1039,0.484,7,33,0.212,496,1006,0.493,0.48700000000000004,164,240,0.6829999999999999,194,327,521,157,61,30,131,225,1177
Earl Cureton,PF,33,CHH,9,1,159,8,24,0.33299999999999996,0,1,0.0,8,23,0.348,0.33299999999999996,1,3,0.33299999999999996,6,30,36,3,0,3,6,16,17
Dell Curry,SG,26,CHH,76,14,1515,337,715,0.47100000000000003,32,86,0.37200000000000005,305,629,0.485,0.494,96,114,0.8420000000000001,47,152,199,166,75,25,80,125,802
Quintin Dailey,SG,30,SEA,30,0,299,73,155,0.47100000000000003,0,1,0.0,73,154,0.474,0.47100000000000003,38,62,0.613,11,21,32,16,7,1,19,25,184
Adrian Dantley*,SF,34,MIL,10,0,126,19,50,0.38,1,3,0.33299999999999996,18,47,0.38299999999999995,0.39,18,26,0.6920000000000001,8,5,13,9,5,0,6,8,57
Brad Daugherty,C,25,CLE,76,76,2946,605,1155,0.524,0,3,0.0,605,1152,0.525,0.524,435,579,0.7509999999999999,177,653,830,253,74,46,211,191,1645
Brad Davis,PG,35,DAL,80,6,1426,159,373,0.426,22,85,0.259,137,288,0.47600000000000003,0.456,91,118,0.7709999999999999,13,105,118,230,45,17,77,212,431
Terry Davis,PF,23,MIA,55,17,996,115,236,0.48700000000000004,1,2,0.5,114,234,0.48700000000000004,0.489,69,124,0.556,107,159,266,39,18,28,36,129,300
Walter Davis,SG,36,TOT,71,14,1483,403,862,0.46799999999999997,11,36,0.306,392,826,0.475,0.474,107,117,0.915,71,110,181,125,80,3,88,150,924
Johnny Dawkins,PG,27,PHI,4,4,124,26,41,0.634,1,4,0.25,25,37,0.6759999999999999,0.6459999999999999,10,11,0.909,0,16,16,28,3,0,8,4,63
Tony Dawson,SF,23,SAC,4,0,17,4,7,0.5710000000000001,1,1,1.0,3,6,0.5,0.643,0,0,0.0,2,0,2,0,0,0,1,0,9
Byron Dinkins,PG,23,TOT,12,0,149,14,34,0.41200000000000003,0,0,0.0,14,34,0.41200000000000003,0.41200000000000003,8,9,0.889,0,12,12,19,2,0,13,15,36
Vlade Divac*,C,22,LAL,82,81,2310,360,637,0.565,5,14,0.35700000000000004,355,623,0.57,0.569,196,279,0.703,205,461,666,92,106,127,146,247,921
James Donaldson,C,33,DAL,82,82,2800,327,615,0.532,0,0,0.0,327,615,0.532,0.532,165,229,0.721,201,526,727,69,34,93,146,181,819
Sherman Douglas,PG,24,MIA,73,73,2562,532,1055,0.504,4,31,0.129,528,1024,0.516,0.506,284,414,0.6859999999999999,78,131,209,624,121,5,270,178,1352
Greg Dreiling,C,28,IND,73,42,1031,98,194,0.505,0,2,0.0,98,192,0.51,0.505,63,105,0.6,66,189,255,51,24,29,57,178,259
Larry Drew,PG,32,LAL,48,2,496,54,125,0.43200000000000005,14,33,0.424,40,92,0.435,0.488,17,22,0.773,5,29,34,118,15,1,49,40,139
Clyde Drexler*,SG,28,POR,82,82,2852,645,1338,0.48200000000000004,61,191,0.319,584,1147,0.509,0.505,416,524,0.794,212,334,546,493,144,60,232,226,1767
Kevin Duckworth,C,26,POR,81,81,2511,521,1084,0.48100000000000004,0,2,0.0,521,1082,0.48200000000000004,0.48100000000000004,240,311,0.772,177,354,531,89,33,34,186,251,1282
Chris Dudley,C,25,NJN,61,25,1560,170,417,0.408,0,0,0.0,170,417,0.408,0.408,94,176,0.534,229,282,511,37,39,153,80,217,434
Joe Dumars*,SG,27,DET,80,80,3046,622,1292,0.48100000000000004,14,45,0.311,608,1247,0.488,0.48700000000000004,371,417,0.89,62,125,187,443,89,7,189,135,1629
T.R. Dunn,SG,35,DEN,17,3,217,21,47,0.447,1,4,0.25,20,43,0.465,0.457,9,10,0.9,20,22,42,24,12,1,7,30,52
Ledell Eackles,SG,24,WSB,67,17,1616,345,762,0.45299999999999996,14,59,0.237,331,703,0.47100000000000003,0.462,164,222,0.7390000000000001,47,81,128,136,47,10,115,121,868
Mark Eaton,C,34,UTA,80,80,2580,169,292,0.579,0,0,0.0,169,292,0.579,0.579,71,112,0.634,182,485,667,51,39,188,99,298,409
Blue Edwards,SF,25,UTA,62,56,1611,244,464,0.526,6,24,0.25,238,440,0.541,0.532,82,117,0.701,51,150,201,108,57,29,105,203,576
James Edwards,C,35,DET,72,70,1903,383,792,0.484,1,2,0.5,382,790,0.484,0.484,215,295,0.7290000000000001,91,186,277,65,12,30,126,249,982
Kevin Edwards,SG,25,MIA,79,16,2000,380,927,0.41,24,84,0.28600000000000003,356,843,0.42200000000000004,0.423,171,213,0.8029999999999999,80,125,205,240,129,46,163,151,955
Craig Ehlo,SG,29,CLE,82,68,2766,344,773,0.445,49,149,0.32899999999999996,295,624,0.473,0.47700000000000004,95,140,0.679,142,246,388,376,121,34,160,209,832
Mario Elie,SF-SG,27,TOT,33,0,644,79,159,0.49700000000000005,4,10,0.4,75,149,0.503,0.509,75,89,0.843,46,64,110,45,19,10,30,85,237
Sean Elliott,SF,22,SAS,82,82,3044,478,976,0.49,20,64,0.313,458,912,0.502,0.5,325,402,0.8079999999999999,142,314,456,238,69,33,147,190,1301
Dale Ellis,SG,30,TOT,51,24,1424,340,718,0.474,57,157,0.363,283,561,0.504,0.513,120,166,0.723,66,107,173,95,49,8,81,112,857
Pervis Ellison,C,23,WSB,76,30,1942,326,636,0.513,0,6,0.0,326,630,0.517,0.513,139,214,0.65,224,361,585,102,49,157,146,268,791
A.J. English,SG,23,WSB,70,12,1443,251,572,0.439,3,31,0.09699999999999999,248,541,0.45799999999999996,0.441,111,157,0.7070000000000001,66,81,147,177,25,15,114,127,616
Alex English*,SF,37,DAL,79,26,1748,322,734,0.439,0,1,0.0,322,733,0.439,0.439,119,140,0.85,108,146,254,105,40,25,101,141,763
Patrick Ewing*,C,28,NYK,81,81,3104,845,1645,0.514,0,6,0.0,845,1639,0.516,0.514,464,623,0.745,194,711,905,244,80,258,291,287,2154
Jim Farmer,SG,26,TOT,27,1,456,101,223,0.45299999999999996,5,23,0.217,96,200,0.48,0.46399999999999997,48,65,0.738,29,39,68,38,13,2,38,58,255
Dave Feitl,C,28,HOU,52,2,372,52,140,0.371,0,3,0.0,52,137,0.38,0.371,33,44,0.75,29,71,100,8,3,12,25,52,137
Duane Ferrell,SF,25,ATL,78,2,1165,174,356,0.489,2,3,0.667,172,353,0.48700000000000004,0.49200000000000005,125,156,0.8009999999999999,97,82,179,55,33,27,78,151,475
Danny Ferry,PF,24,CLE,81,2,1661,275,643,0.428,23,77,0.299,252,566,0.445,0.446,124,152,0.816,99,187,286,142,43,25,120,230,697
Vern Fleming,PG,28,IND,69,45,1929,356,671,0.531,4,18,0.222,352,653,0.539,0.534,161,221,0.7290000000000001,83,131,214,369,76,13,137,116,877
Sleepy Floyd,PG,30,HOU,82,4,1850,386,939,0.41100000000000003,48,176,0.273,338,763,0.44299999999999995,0.43700000000000006,185,246,0.752,52,107,159,317,95,17,140,122,1005
Greg Foster,PF,22,WSB,54,3,606,97,211,0.46,0,5,0.0,97,206,0.47100000000000003,0.46,42,61,0.6890000000000001,52,99,151,37,12,22,45,112,236
Anthony Frederick,SF,26,SAC,35,3,475,67,168,0.39899999999999997,0,0,0.0,67,168,0.39899999999999997,0.39899999999999997,43,60,0.7170000000000001,36,48,84,44,22,13,40,50,177
Corey Gaines,SG,25,DEN,10,2,226,28,70,0.4,5,21,0.23800000000000002,23,49,0.469,0.436,22,26,0.846,4,10,14,91,10,2,23,25,83
Kevin Gamble,SF,25,BOS,82,76,2706,548,933,0.5870000000000001,0,7,0.0,548,926,0.5920000000000001,0.5870000000000001,185,227,0.815,85,182,267,256,100,34,148,237,1281
Winston Garland,PG,26,LAC,69,26,1702,221,519,0.426,4,26,0.154,217,493,0.44,0.43,118,157,0.752,46,152,198,317,97,10,116,189,564
Tom Garrick,SG,24,LAC,67,0,949,100,236,0.424,0,22,0.0,100,214,0.467,0.424,60,79,0.759,40,87,127,223,62,2,66,101,260
Kenny Gattison,PF,26,CHH,72,6,1552,243,457,0.532,0,2,0.0,243,455,0.534,0.532,164,248,0.6609999999999999,136,243,379,44,48,67,102,211,650
Tate George,PG,22,NJN,56,11,594,80,193,0.415,0,2,0.0,80,191,0.419,0.415,32,40,0.8,19,28,47,104,25,5,42,58,192
Derrick Gervin,PF,27,NJN,56,4,743,164,394,0.41600000000000004,7,28,0.25,157,366,0.429,0.425,90,114,0.789,40,70,110,30,19,19,45,88,425
Kendall Gill,SG,22,CHH,82,36,1944,376,836,0.45,2,14,0.14300000000000002,374,822,0.455,0.451,152,182,0.835,105,158,263,303,104,39,163,186,906
Armen Gilliam,PF,26,TOT,75,75,2644,487,1001,0.48700000000000004,0,2,0.0,487,999,0.48700000000000004,0.48700000000000004,268,329,0.815,220,378,598,105,69,53,174,185,1242
Gerald Glass,SF,23,MIN,51,3,606,149,340,0.43799999999999994,2,17,0.11800000000000001,147,323,0.455,0.441,52,76,0.684,54,48,102,42,28,9,41,76,352
Mike Gminski,C,31,TOT,80,79,2196,357,808,0.442,2,14,0.14300000000000002,355,794,0.447,0.44299999999999995,128,158,0.81,186,396,582,93,40,56,85,99,844
Dan Godfread,C,23,MIN,10,0,20,5,12,0.41700000000000004,0,1,0.0,5,11,0.455,0.41700000000000004,3,4,0.75,0,2,2,0,1,4,0,5,13
Jim Grandholm,PF,30,DAL,26,0,168,30,58,0.517,9,17,0.529,21,41,0.512,0.595,10,21,0.47600000000000003,20,30,50,8,2,8,11,33,79
Gary Grant,PG,25,LAC,68,65,2105,265,587,0.451,9,39,0.231,256,548,0.467,0.45899999999999996,51,74,0.6890000000000001,69,140,209,587,103,12,210,192,590
Greg Grant,PG,24,NYK,22,0,107,10,27,0.37,1,3,0.33299999999999996,9,24,0.375,0.389,5,6,0.833,1,9,10,20,9,0,10,12,26
Harvey Grant,PF,25,WSB,77,76,2842,609,1224,0.498,2,15,0.133,607,1209,0.502,0.498,185,249,0.743,179,378,557,204,91,61,125,232,1405
Horace Grant,PF,25,CHI,78,76,2641,401,733,0.547,1,6,0.16699999999999998,400,727,0.55,0.5479999999999999,197,277,0.711,266,393,659,178,95,69,92,203,1000
Stuart Gray,C,27,NYK,8,0,37,4,12,0.33299999999999996,0,0,0.0,4,12,0.33299999999999996,0.33299999999999996,3,3,1.0,2,8,10,0,0,1,2,6,11
Jeff Grayer,SG,25,MIL,82,7,1422,210,485,0.433,0,3,0.0,210,482,0.436,0.433,101,147,0.687,111,135,246,123,48,9,86,98,521
A.C. Green,PF,27,LAL,82,21,2164,258,542,0.47600000000000003,11,55,0.2,247,487,0.507,0.486,223,302,0.738,201,315,516,71,59,23,99,117,750
Rickey Green,PG,36,PHI,79,75,2248,334,722,0.46299999999999997,8,36,0.222,326,686,0.475,0.46799999999999997,117,141,0.83,33,104,137,413,57,6,108,130,793
Sidney Green,PF,30,SAS,66,7,1099,177,384,0.461,0,3,0.0,177,381,0.465,0.461,89,105,0.848,98,215,313,52,32,13,89,172,443
Dave Greenwood,PF,33,SAS,63,11,1018,85,169,0.503,0,2,0.0,85,167,0.509,0.503,69,94,0.7340000000000001,61,160,221,52,29,25,71,172,239
Darrell Griffith,SG,32,UTA,75,2,1005,174,445,0.391,48,138,0.348,126,307,0.41,0.445,34,45,0.7559999999999999,17,73,90,37,42,7,48,100,430
Scott Haffner,PG,24,CHH,7,0,50,8,21,0.381,0,2,0.0,8,19,0.42100000000000004,0.381,1,2,0.5,2,2,4,9,3,1,4,4,17
Jack Haley,PF,27,NJN,78,18,1178,161,343,0.469,0,0,0.0,161,343,0.469,0.469,112,181,0.619,140,216,356,31,20,21,63,199,434
Tom Hammonds,PF,23,WSB,70,7,1023,155,336,0.461,0,4,0.0,155,332,0.467,0.461,57,79,0.722,58,148,206,43,15,7,54,108,367
Bob Hansen,SG,30,SAC,36,24,811,96,256,0.375,19,69,0.275,77,187,0.41200000000000003,0.41200000000000003,18,36,0.5,33,63,96,90,20,5,34,72,229
Tim Hardaway,PG,24,GSW,82,82,3215,739,1551,0.47600000000000003,97,252,0.385,642,1299,0.494,0.508,306,381,0.8029999999999999,87,245,332,793,214,12,270,228,1881
Derek Harper,PG,29,DAL,77,77,2879,572,1226,0.467,89,246,0.36200000000000004,483,980,0.493,0.503,286,391,0.731,59,174,233,548,147,14,177,222,1519
Ron Harper,SG,27,LAC,39,34,1383,285,729,0.391,48,148,0.324,237,581,0.408,0.424,145,217,0.6679999999999999,58,130,188,209,66,35,129,111,763
Tony Harris,SG,23,PHI,6,0,41,4,16,0.25,0,2,0.0,4,14,0.28600000000000003,0.25,2,4,0.5,0,1,1,0,1,0,3,5,10
Scott Hastings,PF,30,DET,27,0,113,16,28,0.5710000000000001,3,4,0.75,13,24,0.542,0.625,13,13,1.0,14,14,28,7,0,0,7,23,48
Hersey Hawkins,SG,24,PHI,80,80,3110,590,1251,0.47200000000000003,108,270,0.4,482,981,0.491,0.515,479,550,0.871,48,262,310,299,178,39,213,182,1767
Gerald Henderson,PG,35,DET,23,10,392,50,117,0.42700000000000005,7,21,0.33299999999999996,43,96,0.44799999999999995,0.457,16,21,0.762,8,29,37,62,12,2,28,43,123
Steve Henson,PG,22,MIL,68,0,690,79,189,0.418,18,54,0.33299999999999996,61,135,0.452,0.466,38,42,0.905,14,37,51,131,32,0,43,83,214
Mike Higgins,SF,23,SAC,7,0,61,6,10,0.6,0,0,0.0,6,10,0.6,0.6,4,7,0.5710000000000001,4,1,5,2,0,2,4,16,16
Rod Higgins,SF,31,GSW,82,9,2024,259,559,0.46299999999999997,73,220,0.332,186,339,0.5489999999999999,0.529,185,226,0.8190000000000001,109,245,354,113,52,37,65,198,776
Sean Higgins,SF,22,SAS,50,0,464,97,212,0.45799999999999996,3,19,0.158,94,193,0.48700000000000004,0.465,28,33,0.848,18,45,63,35,8,1,49,53,225
Tyrone Hill,PF,22,GSW,74,22,1192,147,299,0.49200000000000005,0,0,0.0,147,299,0.49200000000000005,0.49200000000000005,96,152,0.632,157,226,383,19,33,30,72,264,390
Roy Hinson,PF,29,NJN,9,0,91,20,39,0.513,0,0,0.0,20,39,0.513,0.513,1,3,0.33299999999999996,6,13,19,4,0,3,6,14,41
Craig Hodges,SG,30,CHI,73,0,843,146,344,0.424,44,115,0.38299999999999995,102,229,0.445,0.488,26,27,0.963,10,32,42,97,34,2,35,74,362
Dave Hoppen,C,26,TOT,30,0,155,24,44,0.545,0,2,0.0,24,42,0.5710000000000001,0.545,16,22,0.727,18,21,39,3,3,1,13,29,64
Dennis Hopson,SF,25,CHI,61,0,728,104,244,0.426,1,5,0.2,103,239,0.431,0.428,55,83,0.6629999999999999,49,60,109,65,25,14,59,79,264
Jeff Hornacek,SG,27,PHO,80,77,2733,544,1051,0.518,61,146,0.418,483,905,0.534,0.547,201,224,0.897,74,247,321,409,111,16,130,185,1350
Jay Humphries,PG,28,MIL,80,80,2726,482,960,0.502,60,161,0.373,422,799,0.528,0.5329999999999999,191,239,0.799,57,163,220,538,129,7,151,237,1215
Byron Irvin,SG,24,WSB,33,4,316,60,129,0.465,1,5,0.2,59,124,0.47600000000000003,0.469,50,61,0.82,24,21,45,24,15,2,16,32,171
Mark Jackson,PG,25,NYK,72,21,1595,250,508,0.49200000000000005,13,51,0.255,237,457,0.519,0.505,117,160,0.731,62,135,197,452,60,9,135,81,630
Dave Jamerson,SG,23,HOU,37,0,202,43,113,0.381,5,19,0.263,38,94,0.40399999999999997,0.40299999999999997,22,27,0.815,9,21,30,27,6,1,20,24,113
Henry James,PF,25,CLE,37,4,505,112,254,0.441,24,60,0.4,88,194,0.45399999999999996,0.488,52,72,0.722,26,53,79,32,15,5,37,59,300
Les Jepsen,C,23,GSW,21,0,105,11,36,0.306,0,1,0.0,11,35,0.314,0.306,6,9,0.667,17,20,37,1,1,3,3,16,28
Avery Johnson,PG,25,TOT,68,14,959,130,277,0.469,1,9,0.111,129,268,0.48100000000000004,0.47100000000000003,59,87,0.6779999999999999,22,55,77,230,47,4,74,62,320
Buck Johnson,SF,27,HOU,73,70,2279,416,873,0.47700000000000004,2,15,0.133,414,858,0.483,0.478,157,216,0.727,108,222,330,142,81,47,122,240,991
Eddie Johnson,SG,31,TOT,81,27,2085,543,1122,0.484,39,120,0.325,504,1002,0.503,0.501,229,257,0.8909999999999999,107,164,271,111,58,9,122,181,1354
Kevin Johnson,PG,24,PHO,77,76,2772,591,1145,0.516,9,44,0.205,582,1101,0.529,0.52,519,616,0.843,54,217,271,781,163,11,269,174,1710
Magic Johnson*,PG,31,LAL,79,79,2933,466,976,0.47700000000000004,80,250,0.32,386,726,0.532,0.518,519,573,0.9059999999999999,105,446,551,989,102,17,314,150,1531
Steve Johnson,C,33,GSW,24,8,228,34,63,0.54,0,0,0.0,34,63,0.54,0.54,22,37,0.595,18,39,57,17,4,4,25,50,90
Vinnie Johnson,SG,34,DET,82,28,2390,406,936,0.434,11,34,0.324,395,902,0.43799999999999994,0.44,135,209,0.6459999999999999,110,170,280,271,75,15,118,166,958
Charles Jones,C,33,WSB,62,54,1499,67,124,0.54,0,0,0.0,67,124,0.54,0.54,29,50,0.58,119,240,359,48,51,124,46,199,163
Michael Jordan*,SG,27,CHI,82,82,3034,990,1837,0.539,29,93,0.312,961,1744,0.551,0.547,571,671,0.851,118,374,492,453,223,83,202,229,2580
Shawn Kemp,PF,21,SEA,81,66,2442,462,909,0.508,2,12,0.16699999999999998,460,897,0.513,0.509,288,436,0.6609999999999999,267,412,679,144,77,123,202,319,1214
Steve Kerr,PG,25,CLE,57,4,905,99,223,0.444,28,62,0.452,71,161,0.441,0.507,45,53,0.8490000000000001,5,32,37,131,29,4,40,52,271
Jerome Kersey,SF,28,POR,73,72,2359,424,887,0.478,4,13,0.308,420,874,0.48100000000000004,0.48,232,327,0.7090000000000001,169,312,481,227,101,76,149,251,1084
Alec Kessler,C,24,MIA,78,18,1259,199,468,0.425,0,4,0.0,199,464,0.429,0.425,88,131,0.672,115,221,336,31,17,26,108,189,486
Randolph Keys,SF,24,CHH,44,0,473,59,145,0.40700000000000003,3,14,0.214,56,131,0.42700000000000005,0.41700000000000004,19,33,0.5760000000000001,40,60,100,18,22,15,35,93,140
Bo Kimble,SG,24,LAC,62,22,1004,159,418,0.38,19,65,0.292,140,353,0.397,0.40299999999999997,92,119,0.773,42,77,119,76,30,8,77,158,429
Bernard King*,SF,34,WSB,64,64,2401,713,1511,0.47200000000000003,8,37,0.21600000000000003,705,1474,0.478,0.475,383,485,0.79,114,205,319,292,56,16,255,187,1817
Stacey King,PF,24,CHI,76,6,1198,156,334,0.467,0,2,0.0,156,332,0.47,0.467,107,152,0.7040000000000001,72,136,208,65,24,42,91,134,419
Greg Kite,C,29,ORL,82,82,2225,166,338,0.491,0,0,0.0,166,338,0.491,0.491,63,123,0.512,189,399,588,59,25,81,102,298,395
Joe Kleine,C,29,BOS,72,1,850,102,218,0.46799999999999997,0,2,0.0,102,216,0.47200000000000003,0.46799999999999997,54,69,0.7829999999999999,71,173,244,21,15,14,53,108,258
Negele Knight,PG,23,PHO,64,6,792,131,308,0.425,6,25,0.24,125,283,0.442,0.435,71,118,0.602,20,51,71,191,20,7,76,83,339
Bart Kofoed,SG,26,GSW,5,0,21,0,3,0.0,0,0,0.0,0,3,0.0,0.0,3,6,0.5,2,1,3,4,0,0,2,4,3
Jon Koncak,C,27,ATL,77,61,1931,140,321,0.436,1,8,0.125,139,313,0.444,0.43799999999999994,32,54,0.593,101,274,375,124,74,76,50,265,313
Frank Kornet,PF,24,MIL,32,0,157,23,62,0.371,5,18,0.278,18,44,0.409,0.41100000000000003,7,13,0.5379999999999999,10,14,24,9,5,1,11,28,58
Bill Laimbeer,C,33,DET,82,81,2668,372,778,0.478,37,125,0.29600000000000004,335,653,0.513,0.502,123,147,0.8370000000000001,173,564,737,157,38,56,98,242,904
Jerome Lane,PF,24,DEN,62,25,1383,202,461,0.43799999999999994,1,4,0.25,201,457,0.44,0.439,58,141,0.41100000000000003,280,298,578,123,51,14,105,192,463
Andrew Lang,C,24,PHO,63,18,1152,109,189,0.5770000000000001,0,1,0.0,109,188,0.58,0.5770000000000001,93,130,0.715,113,190,303,27,17,127,45,168,311
Eric Leckner,C,24,TOT,72,2,1122,131,294,0.446,0,0,0.0,131,294,0.446,0.446,62,111,0.5589999999999999,82,213,295,39,14,22,69,192,324
Kurk Lee,PG,23,NJN,48,0,265,19,71,0.268,3,15,0.2,16,56,0.28600000000000003,0.289,25,28,0.893,7,23,30,34,11,2,20,39,66
Tim Legler,SG,24,DEN,10,0,148,25,72,0.34700000000000003,3,12,0.25,22,60,0.36700000000000005,0.368,5,6,0.833,8,10,18,12,2,0,4,20,58
Gary Leonard,C,23,ATL,4,0,9,0,0,0.0,0,0,0.0,0,0,0.0,0.0,2,4,0.5,0,2,2,0,0,1,0,2,2
Jim Les,PG,27,SAC,55,8,1399,119,268,0.444,71,154,0.461,48,114,0.42100000000000004,0.5760000000000001,86,103,0.835,18,93,111,299,57,4,75,141,395
Clifford Lett,PG,25,SAS,7,0,99,14,29,0.483,0,1,0.0,14,28,0.5,0.483,6,9,0.667,1,6,7,7,2,1,8,9,34
Fat Lever,SG,30,DAL,4,0,86,9,23,0.391,0,3,0.0,9,20,0.45,0.391,11,14,0.7859999999999999,3,12,15,12,6,3,10,5,29
Cliff Levingston,PF,30,CHI,78,0,1013,127,282,0.45,1,4,0.25,126,278,0.45299999999999996,0.452,59,91,0.648,99,126,225,56,29,43,50,143,314
Reggie Lewis,SG,25,BOS,79,79,2878,598,1219,0.491,1,13,0.077,597,1206,0.495,0.491,281,340,0.826,119,291,410,201,98,85,147,234,1478
Marcus Liberty,SF,22,DEN,76,18,1171,216,513,0.42100000000000004,17,57,0.298,199,456,0.436,0.43799999999999994,58,92,0.63,117,104,221,64,48,19,71,153,507
Todd Lichti,SG,24,DEN,29,25,860,166,378,0.439,14,47,0.298,152,331,0.45899999999999996,0.45799999999999996,59,69,0.855,49,63,112,72,46,8,33,65,405
Alton Lister,C,32,GSW,77,65,1552,188,393,0.478,0,1,0.0,188,392,0.48,0.478,115,202,0.569,121,362,483,93,20,90,106,282,491
Ian Lockhart,SF,23,PHO,1,0,2,1,1,1.0,0,0,0.0,1,1,1.0,1.0,2,2,1.0,0,0,0,0,0,0,0,0,4
Brad Lohaus,PF,26,MIL,81,3,1219,179,415,0.431,33,119,0.27699999999999997,146,296,0.493,0.47100000000000003,37,54,0.685,59,158,217,75,50,74,60,170,428
Grant Long,PF,24,MIA,80,66,2514,276,561,0.49200000000000005,1,6,0.16699999999999998,275,555,0.495,0.493,181,230,0.787,225,343,568,176,119,43,156,295,734
John Long,SG,34,DET,25,0,256,35,85,0.41200000000000003,2,6,0.33299999999999996,33,79,0.418,0.424,24,25,0.96,9,23,32,18,9,2,14,17,96
Rick Mahorn,C,32,PHI,80,74,2439,261,559,0.467,0,9,0.0,261,550,0.475,0.467,189,240,0.7879999999999999,151,470,621,118,79,56,127,276,711
Dan Majerle,SF,25,PHO,77,7,2281,397,821,0.484,30,86,0.349,367,735,0.499,0.502,227,298,0.762,168,250,418,216,106,40,114,162,1051
Jeff Malone,SG,29,UTA,69,69,2466,525,1034,0.508,1,6,0.16699999999999998,524,1028,0.51,0.508,231,252,0.917,36,170,206,143,50,6,108,128,1282
Karl Malone*,PF,27,UTA,82,82,3302,847,1608,0.527,4,14,0.28600000000000003,843,1594,0.529,0.528,684,888,0.77,236,731,967,270,89,79,244,268,2382
Moses Malone*,C,35,ATL,82,15,1912,280,598,0.46799999999999997,0,7,0.0,280,591,0.474,0.46799999999999997,309,372,0.831,271,396,667,68,30,74,137,134,869
Danny Manning,PF,24,LAC,73,47,2197,470,905,0.519,0,3,0.0,470,902,0.521,0.519,219,306,0.716,169,257,426,196,117,62,188,281,1159
Šarūnas Marčiulionis*,SG,26,GSW,50,10,987,183,365,0.501,1,6,0.16699999999999998,182,359,0.507,0.503,178,246,0.7240000000000001,51,67,118,85,62,4,75,136,545
Jeff Martin,PG,24,LAC,74,26,1334,214,507,0.42200000000000004,27,88,0.307,187,419,0.446,0.449,68,100,0.68,53,78,131,65,37,31,49,104,523
Anthony Mason,PF,24,DEN,3,0,21,2,4,0.5,0,0,0.0,2,4,0.5,0.5,6,8,0.75,3,2,5,0,1,0,0,6,10
Tony Massenburg,PF,23,SAS,35,0,161,27,60,0.45,0,0,0.0,27,60,0.45,0.45,28,45,0.622,23,35,58,4,4,9,13,26,82
Vernon Maxwell,SG,25,HOU,82,79,2870,504,1247,0.40399999999999997,172,510,0.337,332,737,0.45,0.473,217,296,0.733,41,197,238,303,127,15,171,179,1397
Travis Mays,PG,22,SAC,64,55,2145,294,724,0.406,72,197,0.365,222,527,0.42100000000000004,0.456,255,331,0.77,54,124,178,253,81,11,159,169,915
George McCloud,SF,23,IND,74,0,1070,131,351,0.373,43,124,0.34700000000000003,88,227,0.38799999999999996,0.434,38,49,0.7759999999999999,35,83,118,150,40,11,91,141,343
Tim McCormick,C,28,ATL,56,7,689,93,187,0.49700000000000005,0,3,0.0,93,184,0.505,0.49700000000000005,66,90,0.733,56,109,165,32,11,14,45,91,252
Rodney McCray,PF,29,DAL,74,68,2561,336,679,0.495,13,39,0.33299999999999996,323,640,0.505,0.504,159,198,0.8029999999999999,153,407,560,259,70,51,129,203,844
Xavier McDaniel,SF,27,TOT,81,79,2634,590,1186,0.49700000000000005,0,8,0.0,590,1178,0.501,0.49700000000000005,193,267,0.723,173,384,557,187,76,46,184,264,1373
Kevin McHale*,PF,33,BOS,68,10,2067,504,912,0.5529999999999999,15,37,0.405,489,875,0.5589999999999999,0.561,228,275,0.8290000000000001,145,335,480,126,25,146,140,194,1251
Derrick McKey,SF,24,SEA,73,55,2503,438,847,0.517,4,19,0.21100000000000002,434,828,0.524,0.519,235,278,0.845,172,251,423,169,91,56,158,220,1115
Nate McMillan,SG,26,SEA,78,0,1434,132,305,0.433,17,48,0.354,115,257,0.447,0.461,57,93,0.613,71,180,251,371,104,20,122,211,338
Mark McNamara,C,31,ORL,2,0,13,0,1,0.0,0,0,0.0,0,1,0.0,0.0,0,0,0.0,0,4,4,0,0,0,0,1,0
Scott Meents,PF,27,SEA,13,0,53,7,28,0.25,1,1,1.0,6,27,0.222,0.268,2,4,0.5,3,7,10,8,7,4,6,5,17
Reggie Miller*,SG,25,IND,82,82,2972,596,1164,0.512,112,322,0.348,484,842,0.575,0.56,551,600,0.9179999999999999,81,200,281,331,109,13,163,165,1855
Terry Mills,PF,23,TOT,55,2,819,134,288,0.465,0,4,0.0,134,284,0.47200000000000003,0.465,47,66,0.7120000000000001,82,147,229,33,35,29,43,100,315
Sam Mitchell,PF,27,MIN,82,60,3121,445,1010,0.441,0,9,0.0,445,1001,0.445,0.441,307,396,0.775,188,332,520,133,66,57,104,338,1197
Paul Mokeski,C,34,GSW,36,1,257,21,59,0.35600000000000004,3,9,0.33299999999999996,18,50,0.36,0.381,12,15,0.8,20,47,67,9,8,3,7,58,57
Sidney Moncrief*,SG,33,ATL,72,3,1096,117,240,0.488,21,64,0.32799999999999996,96,176,0.545,0.531,82,105,0.7809999999999999,31,97,128,104,50,9,66,112,337
Chris Morris,SF,25,NJN,79,68,2553,409,962,0.425,45,179,0.251,364,783,0.465,0.449,179,244,0.7340000000000001,210,311,521,220,138,96,167,248,1042
John Morton,SF,23,CLE,66,2,1207,120,274,0.43799999999999994,4,12,0.33299999999999996,116,262,0.44299999999999995,0.445,113,139,0.813,41,62,103,243,61,18,107,112,357
Chris Mullin*,SF,27,GSW,82,82,3315,777,1449,0.536,40,133,0.301,737,1316,0.56,0.55,513,580,0.884,141,302,443,329,173,63,245,176,2107
Chris Munk,PF,23,UTA,11,0,29,3,7,0.429,0,0,0.0,3,7,0.429,0.429,7,12,0.583,5,9,14,1,1,2,5,5,13
Tod Murphy,PF,27,MIN,52,19,1063,90,227,0.396,1,17,0.059000000000000004,89,210,0.424,0.39899999999999997,70,105,0.667,92,163,255,60,25,20,32,101,251
Jerrod Mustaf,PF,21,NYK,62,5,825,106,228,0.465,0,1,0.0,106,227,0.467,0.465,56,87,0.644,51,118,169,36,15,14,61,109,268
Pete Myers,SG,27,SAS,8,1,103,10,23,0.435,0,1,0.0,10,22,0.455,0.435,9,11,0.818,2,16,18,14,3,3,14,14,29
Larry Nance,PF,31,CLE,80,78,2927,635,1211,0.524,2,8,0.25,633,1203,0.526,0.525,265,330,0.8029999999999999,201,485,686,237,66,200,131,219,1537
Craig Neal,PG,26,DEN,10,0,125,14,35,0.4,3,9,0.33299999999999996,11,26,0.423,0.44299999999999995,13,22,0.591,2,14,16,37,4,0,19,26,44
Ed Nealy,PF,30,PHO,55,0,573,45,97,0.46399999999999997,5,16,0.313,40,81,0.494,0.49,28,38,0.737,44,107,151,36,24,4,19,46,123
Johnny Newman,SF,27,CHH,81,81,2477,478,1017,0.47,30,84,0.35700000000000004,448,933,0.48,0.485,385,476,0.809,94,160,254,188,100,17,189,278,1371
Ken Norman,SF,26,LAC,70,45,2309,520,1037,0.501,6,32,0.188,514,1005,0.511,0.504,173,275,0.629,177,320,497,159,63,63,139,192,1219
Dan O'Sullivan,C,22,UTA,21,0,85,7,16,0.43799999999999994,0,0,0.0,7,16,0.43799999999999994,0.43799999999999994,7,11,0.636,5,12,17,4,1,1,4,18,21
Charles Oakley,PF,27,NYK,76,74,2739,307,595,0.516,0,2,0.0,307,593,0.518,0.516,239,305,0.784,305,615,920,204,62,17,215,288,853
Alan Ogg,C,23,MIA,31,1,261,24,55,0.436,0,2,0.0,24,53,0.45299999999999996,0.436,6,10,0.6,15,34,49,2,6,27,8,53,54
Hakeem Olajuwon*,C,28,HOU,56,50,2062,487,959,0.508,0,4,0.0,487,955,0.51,0.508,213,277,0.769,219,551,770,131,121,221,174,221,1187
Jawann Oldham,C,33,IND,4,0,19,3,6,0.5,0,0,0.0,3,6,0.5,0.5,0,0,0.0,0,3,3,0,0,0,0,1,6
Brian Oliver,SG,22,PHI,73,4,800,111,272,0.408,5,18,0.278,106,254,0.41700000000000004,0.41700000000000004,52,71,0.732,18,62,80,88,34,4,50,76,279
Gerald Paddio,SF,25,CLE,70,22,1181,212,506,0.419,6,24,0.25,206,482,0.42700000000000005,0.425,74,93,0.7959999999999999,38,80,118,90,20,6,71,71,504
Walter Palmer,C,22,UTA,28,0,85,15,45,0.33299999999999996,0,1,0.0,15,44,0.341,0.33299999999999996,10,15,0.667,6,15,21,6,3,4,6,20,40
Robert Parish*,C,37,BOS,81,81,2441,485,811,0.598,0,1,0.0,485,810,0.599,0.598,237,309,0.767,271,585,856,66,66,103,153,197,1207
John Paxson,PG,30,CHI,82,82,1971,317,578,0.5479999999999999,42,96,0.43799999999999994,275,482,0.5710000000000001,0.585,34,41,0.8290000000000001,15,76,91,297,62,3,69,136,710
Kenny Payne,SF,24,PHI,47,6,444,68,189,0.36,4,18,0.222,64,171,0.374,0.37,26,29,0.897,17,49,66,16,10,6,21,43,166
Gary Payton*,PG,22,SEA,82,82,2244,259,575,0.45,1,13,0.077,258,562,0.45899999999999996,0.451,69,97,0.711,108,135,243,528,165,15,180,249,588
Will Perdue,C,25,CHI,74,3,972,116,235,0.494,0,3,0.0,116,232,0.5,0.494,75,112,0.67,122,214,336,47,23,57,75,147,307
Sam Perkins,PF,29,LAL,73,66,2504,368,744,0.495,18,64,0.281,350,680,0.515,0.507,229,279,0.821,167,371,538,108,64,78,103,247,983
Tim Perry,C,25,PHO,46,2,587,75,144,0.521,0,5,0.0,75,139,0.54,0.521,43,70,0.614,53,73,126,27,23,43,32,60,193
Chuck Person,SF,26,IND,80,79,2566,620,1231,0.504,69,203,0.34,551,1028,0.536,0.532,165,229,0.721,121,296,417,238,56,17,184,221,1474
Jim Petersen,C,28,GSW,62,21,834,114,236,0.483,1,4,0.25,113,232,0.48700000000000004,0.485,50,76,0.6579999999999999,69,131,200,27,13,41,48,153,279
Dražen Petrović*,SG,26,TOT,61,0,1015,243,493,0.493,23,65,0.354,220,428,0.514,0.516,114,137,0.8320000000000001,51,59,110,86,43,1,81,132,623
Ricky Pierce,SG,31,TOT,78,2,2167,561,1156,0.485,46,116,0.397,515,1040,0.495,0.505,430,471,0.9129999999999999,67,124,191,168,60,13,147,170,1598
Ed Pinckney,PF,27,BOS,70,16,1165,131,243,0.539,0,1,0.0,131,242,0.541,0.539,104,116,0.897,155,186,341,45,61,43,45,147,366
Scottie Pippen*,SF,25,CHI,82,82,3014,600,1153,0.52,21,68,0.309,579,1085,0.534,0.529,240,340,0.706,163,432,595,511,193,93,232,270,1461
Olden Polynice,C,26,TOT,79,30,2092,316,564,0.56,0,1,0.0,316,563,0.561,0.56,146,252,0.579,220,333,553,42,43,32,88,192,778
Dave Popson,PF,26,BOS,19,0,64,13,32,0.406,0,0,0.0,13,32,0.406,0.406,9,10,0.9,7,7,14,2,1,2,6,12,35
Terry Porter,PG,27,POR,81,81,2665,486,944,0.515,130,313,0.415,356,631,0.564,0.584,279,339,0.823,52,230,282,649,158,12,189,151,1381
Paul Pressey,SG,32,SAS,70,18,1683,201,426,0.47200000000000003,16,57,0.281,185,369,0.501,0.491,110,133,0.8270000000000001,50,126,176,271,63,32,130,174,528
Mark Price,PG,26,CLE,16,16,571,97,195,0.49700000000000005,18,53,0.34,79,142,0.556,0.544,59,62,0.9520000000000001,8,37,45,166,42,2,56,23,271
Kevin Pritchard,PG,23,GSW,62,1,773,88,229,0.384,5,31,0.161,83,198,0.419,0.395,62,77,0.805,16,49,65,81,30,8,59,104,243
Brian Quinnett,SG,24,NYK,68,5,1011,139,303,0.45899999999999996,15,43,0.349,124,260,0.47700000000000004,0.483,26,36,0.722,65,80,145,53,22,13,52,100,319
Kurt Rambis,PF,32,PHO,62,17,900,83,167,0.49700000000000005,0,2,0.0,83,165,0.503,0.49700000000000005,60,85,0.706,77,189,266,64,25,11,45,107,226
Blair Rasmussen,C,28,DEN,70,69,2325,405,885,0.45799999999999996,2,5,0.4,403,880,0.45799999999999996,0.45899999999999996,63,93,0.677,170,508,678,70,52,132,81,307,875
J.R. Reid,C,22,CHH,80,80,2467,360,773,0.466,0,2,0.0,360,771,0.467,0.466,182,259,0.703,154,348,502,89,87,47,153,286,902
Robert Reid,SF,35,PHI,3,0,37,2,14,0.14300000000000002,0,0,0.0,2,14,0.14300000000000002,0.14300000000000002,0,0,0.0,2,7,9,4,1,3,3,3,4
Jerry Reynolds,SG,28,ORL,80,9,1843,344,793,0.434,10,34,0.294,334,759,0.44,0.44,336,419,0.802,88,211,299,203,95,56,172,123,1034
Glen Rice,SF,23,MIA,77,77,2646,550,1193,0.461,71,184,0.386,479,1009,0.475,0.491,171,209,0.818,85,296,381,189,101,26,166,216,1342
Pooh Richardson,PG,24,MIN,82,82,3154,635,1350,0.47,42,128,0.32799999999999996,593,1222,0.485,0.486,89,165,0.539,82,204,286,734,131,13,174,114,1401
Mitch Richmond*,SG,25,GSW,77,77,3027,703,1424,0.494,40,115,0.348,663,1309,0.506,0.508,394,465,0.847,147,305,452,238,126,34,230,207,1840
Doc Rivers,PG,29,ATL,79,79,2586,444,1020,0.435,88,262,0.336,356,758,0.47,0.478,221,262,0.8440000000000001,47,206,253,340,148,47,125,216,1197
Fred Roberts,PF,30,MIL,82,82,2114,357,670,0.5329999999999999,4,25,0.16,353,645,0.547,0.536,170,209,0.813,107,174,281,135,63,29,135,190,888
Alvin Robertson,SG,28,MIL,81,81,2598,438,904,0.485,23,63,0.365,415,841,0.493,0.49700000000000005,199,263,0.757,191,268,459,444,246,16,212,273,1098
Clifford Robinson,PF,24,POR,82,11,1940,373,806,0.46299999999999997,6,19,0.316,367,787,0.466,0.467,205,314,0.653,123,226,349,151,78,76,133,263,957
David Robinson*,C,25,SAS,82,81,3095,754,1366,0.552,1,7,0.14300000000000002,753,1359,0.5539999999999999,0.552,592,777,0.762,335,728,1063,208,127,320,270,264,2101
Larry Robinson,SG,23,TOT,36,10,425,62,150,0.413,0,1,0.0,62,149,0.41600000000000004,0.413,15,27,0.556,29,22,51,35,16,1,27,49,139
Rumeal Robinson,PG,24,ATL,47,16,674,108,242,0.446,2,11,0.182,106,231,0.45899999999999996,0.45,47,80,0.588,20,51,71,132,32,8,76,65,265
Dennis Rodman*,SF,29,DET,82,77,2747,276,560,0.493,6,30,0.2,270,530,0.509,0.498,111,176,0.631,361,665,1026,85,65,55,94,281,669
Tree Rollins,C,35,DET,37,0,202,14,33,0.424,0,0,0.0,14,33,0.424,0.424,8,14,0.5710000000000001,13,29,42,4,2,20,15,35,36
Delaney Rudd,PG,28,UTA,82,0,874,124,285,0.435,17,61,0.27899999999999997,107,224,0.478,0.465,59,71,0.831,14,52,66,216,36,2,102,92,324
John Salley,PF,26,DET,74,1,1649,179,377,0.475,0,1,0.0,179,376,0.47600000000000003,0.475,186,256,0.727,137,190,327,70,52,112,91,240,544
Ralph Sampson*,C,30,SAC,25,4,348,34,93,0.366,1,5,0.2,33,88,0.375,0.371,5,19,0.263,41,70,111,17,11,17,27,54,74
Jeff Sanders,PF,25,CHH,3,0,43,6,14,0.429,0,0,0.0,6,14,0.429,0.429,1,2,0.5,3,6,9,1,1,1,1,6,13
Mike Sanders,SF,30,IND,80,7,1357,206,494,0.41700000000000004,4,20,0.2,202,474,0.426,0.42100000000000004,47,57,0.825,73,112,185,106,37,26,65,198,463
Danny Schayes,C,31,MIL,82,38,2228,298,597,0.499,0,5,0.0,298,592,0.503,0.499,274,328,0.835,174,361,535,98,55,61,106,264,870
Steve Scheffler,C,23,CHH,39,0,227,20,39,0.513,0,0,0.0,20,39,0.513,0.513,19,21,0.905,21,24,45,9,6,2,4,20,59
Dwayne Schintzius,C,22,SAS,42,7,398,68,155,0.439,0,2,0.0,68,153,0.444,0.439,22,40,0.55,28,93,121,17,2,29,34,64,158
Detlef Schrempf,PF,28,IND,82,3,2632,432,831,0.52,15,40,0.375,417,791,0.527,0.529,441,539,0.818,178,482,660,301,58,22,175,262,1320
Byron Scott,SG,29,LAL,82,82,2630,501,1051,0.47700000000000004,71,219,0.324,430,832,0.517,0.51,118,148,0.797,54,192,246,177,95,21,85,146,1191
Dennis Scott,SG,22,ORL,82,73,2336,503,1183,0.425,125,334,0.374,378,849,0.445,0.478,153,204,0.75,62,173,235,134,62,25,127,203,1284
Rony Seikaly,C,25,MIA,64,59,2171,395,822,0.48100000000000004,2,6,0.33299999999999996,393,816,0.48200000000000004,0.48200000000000004,258,417,0.619,207,502,709,95,51,86,205,213,1050
John Shasky,C,26,DAL,57,0,510,51,116,0.44,0,0,0.0,51,116,0.44,0.44,48,79,0.608,58,76,134,11,14,20,27,75,150
Brian Shaw,PG,24,BOS,79,79,2772,442,942,0.469,3,27,0.111,439,915,0.48,0.47100000000000003,204,249,0.8190000000000001,104,266,370,602,105,34,223,206,1091
Jack Sikma*,C,35,MIL,77,44,1940,295,691,0.42700000000000005,46,135,0.341,249,556,0.44799999999999995,0.46,166,197,0.843,108,333,441,143,65,64,130,218,802
Lionel Simmons,SF,22,SAC,79,79,2978,549,1301,0.42200000000000004,3,11,0.273,546,1290,0.423,0.423,320,435,0.736,193,504,697,315,113,85,230,249,1421
Scott Skiles,PG,26,ORL,79,66,2714,462,1039,0.445,93,228,0.408,369,811,0.455,0.489,340,377,0.902,57,213,270,660,89,4,252,192,1357
Charles Smith,SF,25,LAC,74,74,2703,548,1168,0.469,0,7,0.0,548,1161,0.47200000000000003,0.469,384,484,0.7929999999999999,216,392,608,134,81,145,165,267,1480
Charles Smith,PG,23,BOS,5,0,30,3,7,0.429,0,0,0.0,3,7,0.429,0.429,3,5,0.6,0,2,2,6,1,0,3,7,9
Clinton Smith,SG,27,WSB,5,0,45,2,4,0.5,0,0,0.0,2,4,0.5,0.5,3,6,0.5,2,2,4,4,1,0,1,3,7
Derek Smith,SF,29,BOS,2,0,16,1,4,0.25,0,1,0.0,1,3,0.33299999999999996,0.25,3,4,0.75,0,0,0,5,1,1,1,3,5
Kenny Smith,PG,25,HOU,78,78,2699,522,1003,0.52,49,135,0.363,473,868,0.545,0.545,287,340,0.8440000000000001,36,127,163,554,106,11,237,131,1380
Larry Smith,PF,33,HOU,81,28,1923,128,263,0.48700000000000004,0,0,0.0,128,263,0.48700000000000004,0.48700000000000004,12,50,0.24,302,407,709,88,83,22,93,265,268
Michael Smith,PF,25,BOS,47,3,389,95,200,0.475,6,24,0.25,89,176,0.506,0.49,22,27,0.815,21,35,56,43,6,2,37,27,218
Otis Smith,SF,27,ORL,75,39,1885,407,902,0.451,9,46,0.196,398,856,0.465,0.456,221,301,0.7340000000000001,176,213,389,169,85,35,140,190,1044
Tony Smith,SG,22,LAL,64,1,695,97,220,0.441,0,7,0.0,97,213,0.455,0.441,40,57,0.7020000000000001,24,47,71,135,28,12,69,80,234
Rik Smits,C,24,IND,76,38,1690,342,705,0.485,0,0,0.0,342,705,0.485,0.485,144,189,0.762,116,241,357,84,24,111,86,246,828
Mike Smrek,C,28,TOT,15,0,95,9,27,0.33299999999999996,0,0,0.0,9,27,0.33299999999999996,0.33299999999999996,6,12,0.5,7,19,26,4,3,3,3,27,24
Rory Sparrow,PG,32,SAC,80,74,2375,371,756,0.491,31,78,0.397,340,678,0.501,0.511,58,83,0.6990000000000001,45,141,186,362,83,16,126,189,831
Felton Spencer,C,23,MIN,81,46,2099,195,381,0.512,0,1,0.0,195,380,0.513,0.512,182,252,0.722,272,369,641,25,48,121,77,337,572
John Starks,SG,25,NYK,61,10,1173,180,410,0.439,27,93,0.29,153,317,0.483,0.47200000000000003,79,105,0.752,30,101,131,204,59,17,74,137,466
Everette Stephens,PG,24,MIL,3,0,6,2,3,0.667,0,0,0.0,2,3,0.667,0.667,2,2,1.0,0,0,0,2,0,0,0,0,6
John Stockton*,PG,28,UTA,82,82,3103,496,978,0.507,58,168,0.345,438,810,0.541,0.537,363,434,0.836,46,191,237,1164,234,16,298,233,1413
Rod Strickland,PG,24,SAS,58,56,2076,314,651,0.48200000000000004,11,33,0.33299999999999996,303,618,0.49,0.491,161,211,0.763,57,162,219,463,117,11,156,125,800
Jon Sundvold,SG,29,MIA,24,0,225,43,107,0.402,15,35,0.429,28,72,0.389,0.47200000000000003,11,11,1.0,3,6,9,24,7,0,16,11,112
Roy Tarpley,C,26,DAL,5,5,171,43,79,0.544,0,1,0.0,43,78,0.551,0.544,16,18,0.889,16,39,55,12,6,9,13,20,102
Terry Teagle,SG,30,LAL,82,0,1498,335,757,0.44299999999999995,0,9,0.0,335,748,0.44799999999999995,0.44299999999999995,145,177,0.8190000000000001,82,99,181,82,31,8,83,165,815
Reggie Theus,SG,33,NJN,81,81,2955,583,1247,0.46799999999999997,52,144,0.361,531,1103,0.48100000000000004,0.488,292,343,0.851,69,160,229,378,85,35,252,231,1510
Irving Thomas,PF,25,LAL,26,0,108,17,50,0.34,0,0,0.0,17,50,0.34,0.34,12,21,0.5710000000000001,14,17,31,10,4,1,13,24,46
Isiah Thomas*,PG,29,DET,48,46,1657,289,665,0.435,19,65,0.292,270,600,0.45,0.449,179,229,0.782,35,125,160,446,75,10,185,118,776
Jim Thomas,SG,30,MIN,3,0,14,1,4,0.25,0,0,0.0,1,4,0.25,0.25,0,0,0.0,0,0,0,1,1,0,1,0,2
Billy Thompson,SF,27,MIA,73,46,1481,205,411,0.499,0,4,0.0,205,407,0.504,0.499,89,124,0.718,120,192,312,111,32,48,117,161,499
LaSalle Thompson,C,29,IND,82,77,1946,276,565,0.488,1,5,0.2,275,560,0.491,0.489,72,104,0.6920000000000001,154,409,563,147,63,63,168,265,625
Mychal Thompson,C,36,LAL,72,4,1077,113,228,0.496,0,2,0.0,113,226,0.5,0.496,62,88,0.705,74,154,228,21,23,23,47,112,288
Bob Thornton,PF,28,MIN,12,1,110,4,13,0.308,0,0,0.0,4,13,0.308,0.308,8,10,0.8,1,14,15,1,0,3,9,18,16
Otis Thorpe,PF,28,HOU,82,82,3039,549,988,0.556,3,7,0.429,546,981,0.557,0.557,334,480,0.696,287,559,846,197,73,20,217,278,1435
Sedale Threatt,PG,29,SEA,80,57,2066,433,835,0.519,10,35,0.28600000000000003,423,800,0.529,0.525,137,173,0.792,25,74,99,273,113,8,138,191,1013
Wayman Tisdale,PF,26,SAC,33,31,1116,262,542,0.483,0,1,0.0,262,541,0.484,0.483,136,170,0.8,75,178,253,66,23,28,82,99,660
Tom Tolbert,PF,25,GSW,62,32,1371,183,433,0.423,7,21,0.33299999999999996,176,412,0.42700000000000005,0.431,127,172,0.738,87,188,275,76,35,38,80,195,500
Andy Toolson,SF,25,UTA,47,15,470,50,124,0.40299999999999997,12,32,0.375,38,92,0.413,0.452,25,33,0.758,32,35,67,31,14,2,24,58,137
Kelly Tripucka,SF,31,CHH,77,1,1289,187,412,0.45399999999999996,15,45,0.33299999999999996,172,367,0.469,0.47200000000000003,152,167,0.91,46,130,176,159,33,13,92,130,541
Trent Tucker,SG,31,NYK,65,13,1194,191,434,0.44,64,153,0.418,127,281,0.452,0.514,17,27,0.63,33,72,105,111,44,9,46,120,463
Andre Turner,PG,26,PHI,70,1,1407,168,383,0.439,12,33,0.364,156,350,0.446,0.45399999999999996,64,87,0.736,36,116,152,311,63,0,95,124,412
Jeff Turner,PF,28,ORL,71,43,1683,259,532,0.48700000000000004,6,15,0.4,253,517,0.489,0.49200000000000005,85,112,0.759,108,255,363,97,29,10,126,234,609
Kelvin Upshaw,SG,28,DAL,48,1,514,104,231,0.45,7,29,0.24100000000000002,97,202,0.48,0.465,55,64,0.8590000000000001,20,35,55,86,28,5,39,77,270
Darnell Valentine,PG,31,CLE,65,60,1841,230,496,0.46399999999999997,6,25,0.24,224,471,0.47600000000000003,0.47,143,172,0.831,37,135,172,351,98,12,126,170,609
Kiki Vandeweghe,SF,32,NYK,75,72,2420,458,927,0.494,51,141,0.36200000000000004,407,786,0.518,0.522,259,288,0.899,78,102,180,110,42,10,108,122,1226
Loy Vaught,PF,22,LAC,73,0,1178,175,359,0.48700000000000004,0,2,0.0,175,357,0.49,0.48700000000000004,49,74,0.662,124,225,349,40,20,23,49,135,399
Sam Vincent,PG,27,ORL,49,17,975,152,353,0.431,3,19,0.158,149,334,0.446,0.435,99,120,0.825,17,90,107,197,30,5,91,74,406
Stojko Vranković,C,27,BOS,31,0,166,24,52,0.462,0,0,0.0,24,52,0.462,0.462,10,18,0.556,15,36,51,4,1,29,24,43,58
Milt Wagner,SG,27,MIA,13,1,116,24,57,0.42100000000000004,6,17,0.353,18,40,0.45,0.474,9,11,0.818,0,7,7,15,2,3,12,14,63
Darrell Walker,PG,29,WSB,71,65,2305,230,535,0.43,0,9,0.0,230,526,0.43700000000000006,0.43,93,154,0.604,140,358,498,459,78,33,154,199,553
Kenny Walker,SF,26,NYK,54,8,771,83,191,0.435,0,1,0.0,83,190,0.43700000000000006,0.435,64,82,0.78,63,94,157,13,18,30,30,92,230
Spud Webb,PG,27,ATL,75,64,2197,359,803,0.447,54,168,0.321,305,635,0.48,0.48100000000000004,231,266,0.868,41,133,174,417,118,6,146,180,1003
Bill Wennington,C,27,SAC,77,23,1455,181,415,0.436,1,5,0.2,180,410,0.439,0.43700000000000006,74,94,0.787,101,239,340,69,46,59,51,230,437
Doug West,SG,23,MIN,75,1,824,118,246,0.48,0,1,0.0,118,245,0.48200000000000004,0.48,58,84,0.69,56,80,136,48,35,23,41,115,294
Mark West,C,30,PHO,82,64,1957,247,382,0.647,0,0,0.0,247,382,0.647,0.647,135,206,0.655,171,393,564,37,32,161,86,266,629
Randy White,PF,23,DAL,79,29,1901,265,665,0.39799999999999996,6,37,0.162,259,628,0.41200000000000003,0.40299999999999997,159,225,0.7070000000000001,173,331,504,63,81,44,131,308,695
Morlon Wiley,PG,24,ORL,34,0,350,45,108,0.41700000000000004,6,12,0.5,39,96,0.406,0.444,17,25,0.68,4,13,17,73,24,0,34,37,113
Dominique Wilkins*,SF,31,ATL,81,81,3078,770,1640,0.47,85,249,0.341,685,1391,0.49200000000000005,0.495,476,574,0.8290000000000001,261,471,732,265,123,65,201,156,2101
Eddie Lee Wilkins,C,28,NYK,68,1,668,114,255,0.447,0,1,0.0,114,254,0.449,0.447,51,90,0.5670000000000001,69,111,180,15,17,7,50,91,279
Gerald Wilkins,SG,27,NYK,68,56,2164,380,804,0.473,9,43,0.209,371,761,0.488,0.478,169,206,0.82,78,129,207,275,82,23,161,181,938
Buck Williams,PF,30,POR,80,80,2582,358,595,0.602,0,0,0.0,358,595,0.602,0.602,217,308,0.705,227,524,751,97,47,47,137,247,933
Herb Williams,C,32,DAL,60,36,1832,332,655,0.507,0,4,0.0,332,651,0.51,0.507,83,130,0.638,86,271,357,95,30,88,113,197,747
Hot Rod Williams,C,28,CLE,43,14,1293,199,430,0.46299999999999997,0,1,0.0,199,429,0.46399999999999997,0.46299999999999997,107,164,0.652,111,179,290,100,36,69,63,126,505
Jayson Williams,PF,22,PHI,52,1,508,72,161,0.447,1,2,0.5,71,159,0.447,0.45,37,56,0.6609999999999999,41,70,111,16,9,6,40,92,182
John Williams,SF,24,WSB,33,11,941,164,393,0.41700000000000004,10,41,0.244,154,352,0.43799999999999994,0.43,73,97,0.753,42,135,177,133,39,6,68,63,411
Kenny Williams,PF,21,IND,75,0,527,93,179,0.52,0,3,0.0,93,176,0.528,0.52,34,50,0.68,56,75,131,31,11,31,41,81,220
Micheal Williams,PG,24,IND,73,37,1706,261,523,0.499,1,7,0.14300000000000002,260,516,0.504,0.5,290,330,0.879,49,127,176,348,150,17,150,202,813
Reggie Williams,SF,26,TOT,73,46,1896,384,855,0.449,57,157,0.363,327,698,0.46799999999999997,0.48200000000000004,166,197,0.843,133,173,306,133,113,41,112,253,991
Scott Williams,PF,22,CHI,51,0,337,53,104,0.51,1,2,0.5,52,102,0.51,0.514,20,28,0.7140000000000001,42,56,98,16,12,13,23,51,127
Kevin Willis,PF,28,ATL,80,80,2373,444,881,0.504,4,10,0.4,440,871,0.505,0.506,159,238,0.6679999999999999,259,445,704,99,60,40,153,235,1051
Trevor Wilson,PF,22,ATL,25,0,162,21,70,0.3,0,2,0.0,21,68,0.309,0.3,13,26,0.5,16,24,40,11,5,1,17,13,55
Kennard Winchester,SF,24,HOU,64,1,607,98,245,0.4,8,20,0.4,90,225,0.4,0.41600000000000004,35,45,0.778,34,33,67,25,16,13,30,70,239
David Wingate,SG,27,SAS,25,0,563,53,138,0.384,1,9,0.111,52,129,0.40299999999999997,0.38799999999999996,29,41,0.7070000000000001,24,51,75,46,19,5,42,66,136
Randy Wittman,SF,31,IND,41,0,355,35,79,0.44299999999999995,0,5,0.0,35,74,0.473,0.44299999999999995,4,6,0.667,6,27,33,25,10,4,10,9,74
Joe Wolf,C,26,DEN,74,38,1593,234,519,0.451,2,15,0.133,232,504,0.46,0.45299999999999996,69,83,0.831,136,264,400,107,60,31,95,244,539
David Wood,SF,26,HOU,82,13,1421,148,349,0.424,28,90,0.311,120,259,0.46299999999999997,0.46399999999999997,108,133,0.812,107,139,246,94,58,16,89,236,432
Leon Wood,SG,28,SAC,12,0,222,25,63,0.397,12,38,0.316,13,25,0.52,0.49200000000000005,19,21,0.905,5,14,19,49,5,0,12,10,81
Mike Woodson,SG,32,TOT,15,3,171,26,77,0.33799999999999997,1,7,0.14300000000000002,25,70,0.35700000000000004,0.344,11,13,0.846,3,10,13,15,5,5,12,18,64
Orlando Woolridge,SF,31,DEN,53,50,1823,490,983,0.498,0,4,0.0,490,979,0.501,0.498,350,439,0.797,141,220,361,119,69,23,152,145,1330
Haywoode Workman,PG,25,WSB,73,56,2034,234,515,0.45399999999999996,12,50,0.24,222,465,0.47700000000000004,0.466,101,133,0.759,51,191,242,353,87,7,135,162,581
James Worthy*,SF,29,LAL,78,74,3008,716,1455,0.49200000000000005,26,90,0.289,690,1365,0.505,0.501,212,266,0.797,107,249,356,275,104,35,127,117,1670
Howard Wright,PF,23,TOT,15,0,164,19,47,0.40399999999999997,0,1,0.0,19,46,0.413,0.40399999999999997,16,24,0.667,12,33,45,3,4,5,11,28,54
A.J. Wynder,PG,26,BOS,6,0,39,3,12,0.25,0,1,0.0,3,11,0.273,0.25,6,8,0.75,1,2,3,8,1,0,4,1,12
Danny Young,PG,28,POR,75,1,897,103,271,0.38,36,104,0.34600000000000003,67,167,0.401,0.446,41,45,0.9109999999999999,22,53,75,141,50,7,50,49,283
