Player,Pos,Age,Tm,G,GS,MP,FG,FGA,FG%,3P,3PA,3P%,2P,2PA,2P%,eFG%,FT,FTA,FT%,ORB,DRB,TRB,AST,STL,BLK,TOV,PF,PTS
Mahmoud Abdul-Rauf,PG,28,SAC,31,0,530,103,273,0.377,5,31,0.161,98,242,0.405,0.386,16,16,1.0,6,31,37,58,16,1,19,31,227
Tariq Abdul-Wahad,SG,23,SAC,59,16,959,144,357,0.40299999999999997,4,19,0.21100000000000002,140,338,0.414,0.409,84,125,0.672,44,72,116,51,35,13,65,81,376
Shareef Abdur-Rahim,SF,21,VAN,82,82,2950,653,1347,0.485,21,51,0.41200000000000003,632,1296,0.488,0.493,502,640,0.784,227,354,581,213,89,76,257,201,1829
Cory Alexander,PG,24,TOT,60,22,1298,171,400,0.428,66,176,0.375,105,224,0.469,0.51,80,102,0.784,17,129,146,209,70,11,112,98,488
Ray Allen*,SG,22,MIL,82,82,3287,563,1315,0.428,134,368,0.364,429,947,0.45299999999999996,0.479,342,391,0.875,127,278,405,356,111,12,263,244,1602
Derek Anderson,SF,23,CLE,66,13,1839,239,586,0.408,17,84,0.20199999999999999,222,502,0.442,0.42200000000000004,275,315,0.873,55,132,187,227,86,13,128,136,770
Greg Anderson,C,33,ATL,50,0,398,36,81,0.444,0,5,0.0,36,76,0.474,0.444,16,41,0.39,39,79,118,15,19,10,17,85,88
Kenny Anderson,PG,27,TOT,61,56,1858,268,674,0.39799999999999996,57,160,0.35600000000000004,211,514,0.41100000000000003,0.44,153,194,0.789,39,134,173,345,87,1,143,135,746
Nick Anderson,SF,30,ORL,58,44,1701,343,754,0.455,77,214,0.36,266,540,0.493,0.506,127,199,0.638,98,199,297,119,72,23,85,98,890
Shandon Anderson,SG,24,UTA,82,2,1602,269,500,0.5379999999999999,7,32,0.21899999999999997,262,468,0.56,0.545,136,185,0.735,86,141,227,89,66,18,91,145,681
Chris Anstey,C,23,DAL,41,8,680,92,231,0.39799999999999996,3,16,0.188,89,215,0.414,0.405,53,74,0.716,53,104,157,35,31,27,41,95,240
Greg Anthony,PG,30,SEA,80,0,1021,150,349,0.43,66,159,0.415,84,190,0.442,0.524,53,80,0.6629999999999999,18,93,111,205,64,3,91,97,419
B.J. Armstrong,PG,30,TOT,66,0,831,105,213,0.493,9,35,0.257,96,178,0.539,0.514,42,50,0.84,16,60,76,150,29,0,42,74,261
Darrell Armstrong,PG,29,ORL,48,17,1236,156,380,0.41100000000000003,25,68,0.368,131,312,0.42,0.44299999999999995,105,123,0.8540000000000001,65,94,159,236,58,5,112,96,442
Vincent Askew,SG,31,POR,30,5,443,19,54,0.35200000000000004,0,2,0.0,19,52,0.365,0.35200000000000004,28,39,0.718,21,47,68,38,19,5,35,39,66
Keith Askins,SF,30,MIA,46,12,681,39,122,0.32,21,74,0.284,18,48,0.375,0.406,12,19,0.632,28,73,101,29,27,12,26,107,111
Stacey Augmon,SG,29,POR,71,23,1445,154,372,0.414,1,7,0.14300000000000002,153,365,0.419,0.415,94,156,0.603,104,131,235,88,57,32,81,144,403
Isaac Austin,C,28,TOT,78,50,2266,406,871,0.466,0,8,0.0,406,863,0.47,0.466,243,363,0.669,199,358,557,175,61,56,206,231,1055
Vin Baker,C,26,SEA,82,82,2944,631,1164,0.542,1,7,0.14300000000000002,630,1157,0.545,0.5429999999999999,311,526,0.591,286,370,656,152,91,86,174,278,1574
Charles Barkley*,PF,34,HOU,68,41,2243,361,744,0.485,18,84,0.214,343,660,0.52,0.49700000000000005,296,397,0.746,241,553,794,217,71,28,147,187,1036
Dana Barros,PG,30,BOS,80,15,1686,281,609,0.461,100,246,0.40700000000000003,181,363,0.499,0.544,122,144,0.847,28,125,153,286,83,6,107,124,784
Brent Barry,SG,26,TOT,58,36,1600,213,506,0.42100000000000004,90,229,0.39299999999999996,123,277,0.444,0.51,115,134,0.858,29,142,171,153,64,27,104,118,631
Drew Barry,PG,24,ATL,27,0,256,18,38,0.474,9,21,0.429,9,17,0.529,0.5920000000000001,11,13,0.846,5,30,35,49,10,1,30,28,56
Jon Barry,SG,28,LAL,49,1,374,38,104,0.365,18,61,0.295,20,43,0.465,0.452,27,29,0.9309999999999999,8,29,37,51,24,3,22,33,121
Tony Battie,PF,21,DEN,65,49,1506,234,525,0.446,3,14,0.214,231,511,0.452,0.449,73,104,0.7020000000000001,138,213,351,60,54,69,98,199,544
Corey Beck,PG,26,CHH,59,14,738,73,159,0.45899999999999996,2,4,0.5,71,155,0.45799999999999996,0.465,43,59,0.7290000000000001,27,63,90,98,33,7,70,100,191
Benoit Benjamin,C,33,PHI,14,0,197,22,41,0.537,0,0,0.0,22,41,0.537,0.537,19,30,0.633,18,35,53,3,4,4,12,26,63
Mario Bennett,PF,24,LAL,45,4,354,80,135,0.593,1,2,0.5,79,133,0.594,0.596,16,44,0.364,60,66,126,18,19,11,21,61,177
David Benoit,SF,29,TOT,77,0,1123,152,408,0.373,55,170,0.324,97,238,0.408,0.44,61,74,0.8240000000000001,60,143,203,25,35,20,52,157,420
Travis Best,PG,25,IND,82,0,1547,201,480,0.419,21,70,0.3,180,410,0.439,0.441,112,131,0.855,28,94,122,281,85,5,111,193,535
Chauncey Billups,PG,21,TOT,80,70,2216,280,749,0.374,107,325,0.32899999999999996,173,424,0.408,0.445,226,266,0.85,62,128,190,314,107,4,174,172,893
Mookie Blaylock,PG,30,ATL,70,69,2700,368,938,0.392,90,334,0.26899999999999996,278,604,0.46,0.44,95,134,0.7090000000000001,81,260,341,469,183,21,176,122,921
Corie Blount,PF,29,LAL,70,3,1029,107,187,0.5720000000000001,0,4,0.0,107,183,0.585,0.5720000000000001,39,78,0.5,114,184,298,37,29,25,51,157,253
Muggsy Bogues,PG,33,TOT,61,31,1570,141,323,0.43700000000000006,4,16,0.25,137,307,0.446,0.44299999999999995,61,68,0.897,30,102,132,331,67,3,105,58,347
Etdrick Bohannon,PF,24,IND,5,0,11,0,4,0.0,0,0,0.0,0,4,0.0,0.0,0,0,0.0,2,4,6,1,0,2,3,3,0
Keith Booth,SF,23,CHI,6,0,17,2,6,0.33299999999999996,0,1,0.0,2,5,0.4,0.33299999999999996,6,6,1.0,2,2,4,1,0,0,3,3,10
Bruce Bowen,SF,26,BOS,61,9,1305,122,298,0.409,20,59,0.33899999999999997,102,239,0.42700000000000005,0.44299999999999995,76,122,0.623,79,95,174,81,87,29,52,174,340
Anthony Bowie,SG,34,NYK,27,3,224,32,59,0.542,3,4,0.75,29,55,0.527,0.568,8,9,0.889,9,17,26,11,6,2,7,25,75
Shawn Bradley,C,25,DAL,64,46,1822,300,711,0.42200000000000004,1,3,0.33299999999999996,299,708,0.42200000000000004,0.423,130,180,0.722,164,354,518,60,51,214,96,214,731
Terrell Brandon,PG,27,MIL,50,48,1784,339,731,0.46399999999999997,31,93,0.33299999999999996,308,638,0.483,0.485,132,156,0.846,23,153,176,387,111,17,145,120,841
Tim Breaux,SF,27,MIL,6,0,30,4,11,0.364,1,3,0.33299999999999996,3,8,0.375,0.409,1,2,0.5,0,2,2,2,2,1,1,1,10
Scott Brooks,PG,32,CLE,43,0,312,28,66,0.424,5,11,0.455,23,55,0.418,0.462,18,20,0.9,6,24,30,49,18,3,12,25,79
Chucky Brown,SF,29,ATL,77,8,1202,161,372,0.433,2,8,0.25,159,364,0.43700000000000006,0.435,63,87,0.7240000000000001,57,126,183,55,23,13,51,100,387
Dee Brown,SG,29,TOT,72,12,1719,246,562,0.43799999999999994,108,271,0.39899999999999997,138,291,0.474,0.534,58,71,0.8170000000000001,24,128,152,154,82,23,73,123,658
P.J. Brown,PF,28,MIA,74,74,2362,278,590,0.47100000000000003,0,0,0.0,278,590,0.47100000000000003,0.47100000000000003,151,197,0.7659999999999999,235,400,635,103,66,98,97,264,707
Randy Brown,PG,29,CHI,71,6,1147,116,302,0.384,0,5,0.0,116,297,0.391,0.384,56,78,0.718,34,60,94,151,71,12,63,118,288
Rick Brunson,PG,25,POR,38,10,622,49,141,0.348,22,61,0.361,27,80,0.33799999999999997,0.426,42,62,0.677,14,42,56,100,25,3,52,55,162
Kobe Bryant,SG,19,LAL,79,1,2056,391,913,0.428,75,220,0.341,316,693,0.456,0.469,363,457,0.794,79,163,242,199,74,40,157,180,1220
Mark Bryant,C,32,PHO,70,22,1110,109,225,0.484,0,1,0.0,109,224,0.48700000000000004,0.484,73,95,0.768,92,152,244,46,36,15,58,180,291
Jud Buechler,SF,29,CHI,74,0,608,85,176,0.483,25,65,0.385,60,111,0.541,0.5539999999999999,3,6,0.5,24,53,77,49,22,15,21,47,198
Matt Bullard,SF,30,HOU,67,24,1190,175,389,0.45,96,231,0.41600000000000004,79,158,0.5,0.573,20,27,0.741,25,121,146,60,31,24,39,104,466
Scott Burrell,SF,27,CHI,80,3,1096,159,375,0.424,51,144,0.354,108,231,0.46799999999999997,0.49200000000000005,47,64,0.7340000000000001,80,118,198,65,64,37,50,131,416
Willie Burton,SF,29,SAS,13,0,43,8,21,0.381,3,9,0.33299999999999996,5,12,0.41700000000000004,0.452,8,12,0.667,3,6,9,1,2,2,1,7,27
Mitchell Butler,SG,27,CLE,18,0,206,15,47,0.319,1,6,0.16699999999999998,14,41,0.341,0.33,6,10,0.6,6,16,22,18,8,0,8,26,37
Jason Caffey,PF,24,TOT,80,14,1423,226,466,0.485,0,2,0.0,226,464,0.48700000000000004,0.485,131,200,0.655,160,184,344,67,25,20,105,181,583
Michael Cage,C,36,NJN,79,17,1201,43,84,0.512,0,1,0.0,43,83,0.518,0.512,20,36,0.556,115,193,308,32,45,44,23,105,106
Adrian Caldwell,PF,31,DAL,1,0,3,0,0,0.0,0,0,0.0,0,0,0.0,0.0,0,0,0.0,0,0,0,0,0,0,0,0,0
Marcus Camby,C,23,TOR,63,58,2002,308,747,0.41200000000000003,0,2,0.0,308,745,0.413,0.41200000000000003,149,244,0.611,203,263,466,111,68,230,134,200,765
Elden Campbell,PF,29,LAL,81,28,1784,289,624,0.46299999999999997,1,2,0.5,288,622,0.46299999999999997,0.46399999999999997,237,342,0.693,143,312,455,78,35,102,115,209,816
Antoine Carr,PF,36,UTA,66,8,1086,151,325,0.465,0,0,0.0,151,325,0.465,0.465,76,98,0.7759999999999999,42,89,131,48,11,53,48,195,378
Chris Carr,SG,23,MIN,51,40,1165,190,452,0.42,40,127,0.315,150,325,0.462,0.465,84,99,0.848,43,112,155,85,17,11,69,129,504
Sam Cassell,PG,28,NJN,75,72,2606,510,1156,0.441,15,80,0.188,495,1076,0.46,0.44799999999999995,436,507,0.86,73,155,228,603,121,20,269,262,1471
Kelvin Cato,C,23,POR,74,8,1007,98,229,0.428,0,3,0.0,98,226,0.434,0.428,86,125,0.688,91,161,252,23,29,94,44,164,282
Duane Causwell,C,29,MIA,37,2,363,37,89,0.41600000000000004,0,0,0.0,37,89,0.41600000000000004,0.41600000000000004,15,26,0.5770000000000001,29,70,99,5,7,27,18,73,89
Cedric Ceballos,SF,28,TOT,47,25,990,204,415,0.49200000000000005,21,70,0.3,183,345,0.53,0.517,107,145,0.738,75,146,221,60,33,16,72,88,536
Tom Chambers,PF,38,PHI,1,0,10,2,2,1.0,0,0,0.0,2,2,1.0,1.0,2,2,1.0,0,2,2,0,2,0,1,2,6
Rex Chapman,SG,30,PHO,68,67,2263,408,956,0.42700000000000005,120,311,0.386,288,645,0.447,0.49,146,187,0.7809999999999999,30,143,173,203,71,14,116,102,1082
Calbert Cheaney,SG,26,WAS,82,82,2841,448,981,0.457,15,53,0.28300000000000003,433,928,0.467,0.46399999999999997,139,215,0.647,82,242,324,173,96,36,104,264,1050
Pete Chilcutt,PF,29,VAN,82,0,1420,156,359,0.435,54,130,0.415,102,229,0.445,0.51,39,59,0.6609999999999999,77,229,306,104,53,37,62,158,405
Chris Childs,PG,30,NYK,68,0,1599,149,354,0.42100000000000004,27,87,0.31,122,267,0.457,0.45899999999999996,104,126,0.825,29,133,162,268,56,6,103,179,429
Doug Christie,SG,27,TOR,78,78,2939,458,1071,0.428,100,307,0.326,358,764,0.469,0.474,271,327,0.8290000000000001,94,310,404,282,190,57,228,198,1287
Keith Closs,C,21,LAC,58,1,740,93,207,0.449,0,0,0.0,93,207,0.449,0.449,46,77,0.597,63,105,168,19,12,81,38,73,232
Derrick Coleman,PF,30,PHI,59,58,2135,356,867,0.41100000000000003,26,98,0.265,330,769,0.429,0.426,302,391,0.772,149,438,587,145,46,68,157,144,1040
Bimbo Coles,PG,29,GSW,53,44,1471,166,438,0.379,13,57,0.228,153,381,0.402,0.39399999999999996,78,88,0.8859999999999999,17,106,123,248,51,13,89,135,423
James Collins,SG,24,LAC,23,0,103,21,55,0.382,9,20,0.45,12,35,0.34299999999999997,0.46399999999999997,8,14,0.5710000000000001,7,7,14,3,6,3,8,12,59
Marty Conlon,C,30,MIA,18,0,209,28,62,0.452,0,0,0.0,28,62,0.452,0.452,32,44,0.727,16,30,46,12,9,5,11,27,88
Tyrone Corbin,SF,35,ATL,79,79,2699,328,747,0.439,49,141,0.348,279,606,0.46,0.47200000000000003,101,128,0.789,78,284,362,173,105,7,86,197,806
James Cotton,SG,22,SEA,9,0,33,8,21,0.381,0,4,0.0,8,17,0.47100000000000003,0.381,8,9,0.889,2,4,6,0,1,1,6,3,24
Chris Crawford,PF,22,ATL,40,0,256,46,110,0.418,1,3,0.33299999999999996,45,107,0.42100000000000004,0.423,57,68,0.838,20,21,41,9,12,7,18,27,150
Austin Croshere,PF,22,IND,26,0,243,32,86,0.37200000000000005,4,13,0.308,28,73,0.384,0.395,8,14,0.5710000000000001,10,35,45,8,9,5,13,32,76
John Crotty,PG,28,POR,26,2,379,29,90,0.322,6,20,0.3,23,70,0.32899999999999996,0.35600000000000004,32,34,0.941,4,28,32,63,10,1,42,28,96
Terry Cummings,PF,36,TOT,74,3,1185,200,428,0.467,0,1,0.0,200,427,0.46799999999999997,0.467,67,98,0.684,97,186,283,47,38,10,51,181,467
William Cunningham,C,23,TOT,7,2,39,4,9,0.444,0,0,0.0,4,9,0.444,0.444,0,0,0.0,4,6,10,1,2,0,0,10,8
Bill Curley,PF,25,MIN,11,1,146,16,33,0.485,0,1,0.0,16,32,0.5,0.485,2,3,0.667,11,17,28,4,3,1,3,28,34
Dell Curry,SG,33,CHH,52,1,971,194,434,0.447,61,145,0.42100000000000004,133,289,0.46,0.517,41,52,0.7879999999999999,26,75,101,69,31,4,54,85,490
Michael Curry,SG,29,MIL,82,27,1978,196,418,0.469,4,9,0.444,192,409,0.469,0.474,147,176,0.835,26,72,98,137,56,14,77,218,543
Erick Dampier,C,22,GSW,82,82,2656,352,791,0.445,0,2,0.0,352,789,0.446,0.445,267,399,0.669,272,443,715,94,39,139,175,281,971
Antonio Daniels,SG,22,VAN,74,50,1956,228,548,0.41600000000000004,11,52,0.212,217,496,0.43799999999999994,0.426,112,170,0.659,22,121,143,334,55,10,164,88,579
Lloyd Daniels,SG,30,TOR,6,0,82,12,29,0.414,2,9,0.222,10,20,0.5,0.44799999999999995,8,10,0.8,4,3,7,4,3,2,4,4,34
Yinka Dare,C,25,NJN,10,0,60,4,18,0.222,0,0,0.0,4,18,0.222,0.222,4,8,0.5,10,7,17,1,0,2,2,9,12
Antonio Davis,PF,29,IND,82,12,2191,254,528,0.48100000000000004,0,3,0.0,254,525,0.484,0.48100000000000004,277,398,0.696,192,368,560,61,45,72,103,234,785
Ben Davis,PF,25,NYK,7,0,13,2,10,0.2,0,0,0.0,2,10,0.2,0.2,0,0,0.0,6,0,6,0,1,0,0,3,4
Dale Davis,C,28,IND,78,78,2174,273,498,0.5479999999999999,0,0,0.0,273,498,0.5479999999999999,0.5479999999999999,80,172,0.465,233,378,611,70,51,87,73,209,626
Emanual Davis,PG,29,HOU,45,0,599,63,142,0.444,27,72,0.375,36,70,0.514,0.539,31,37,0.838,10,37,47,59,17,3,52,55,184
Hubert Davis,SG,27,DAL,81,30,2378,350,767,0.456,101,230,0.439,249,537,0.46399999999999997,0.522,97,116,0.836,34,135,169,157,43,5,88,117,898
Mark Davis,SF,24,PHI,71,12,906,109,244,0.447,0,6,0.0,109,238,0.45799999999999996,0.447,64,101,0.634,64,94,158,73,49,18,91,95,282
Terry Davis,PF,30,WAS,74,66,1705,127,256,0.496,0,1,0.0,127,255,0.498,0.496,69,119,0.58,209,271,480,30,41,24,56,193,323
Todd Day,SG,28,MIA,5,0,69,11,31,0.355,2,12,0.16699999999999998,9,19,0.474,0.387,6,9,0.667,4,2,6,7,7,0,3,10,30
Andrew DeClercq,C,24,BOS,81,49,1523,169,340,0.49700000000000005,0,1,0.0,169,339,0.499,0.49700000000000005,101,168,0.601,180,212,392,59,85,49,84,277,439
Terry Dehere,PG,26,SAC,77,18,1410,180,451,0.39899999999999997,50,132,0.379,130,319,0.408,0.455,79,99,0.7979999999999999,21,85,106,196,52,4,96,150,489
Vinny Del Negro,SG,31,SAS,54,38,1721,211,479,0.441,17,39,0.436,194,440,0.441,0.45799999999999996,74,93,0.7959999999999999,13,139,152,183,39,6,53,113,513
Bison Dele,C,28,DET,78,78,2619,531,1040,0.511,1,3,0.33299999999999996,530,1037,0.511,0.511,198,280,0.7070000000000001,223,472,695,94,67,55,181,252,1261
Tony Delk,PG,24,TOT,77,9,1681,314,798,0.39299999999999996,42,157,0.268,272,641,0.424,0.42,111,151,0.735,38,134,172,172,73,12,109,96,781
Vlade Divac*,C,29,CHH,64,41,1805,267,536,0.498,3,14,0.214,264,522,0.506,0.501,130,188,0.691,183,335,518,172,83,94,114,179,667
Sherman Douglas,PG,31,NJN,80,11,1699,255,515,0.495,14,46,0.304,241,469,0.514,0.509,115,172,0.669,52,83,135,319,55,7,110,156,639
Clyde Drexler*,SG,35,HOU,70,70,2473,452,1059,0.42700000000000005,106,334,0.317,346,725,0.47700000000000004,0.47700000000000004,277,346,0.8009999999999999,105,241,346,382,126,42,189,193,1287
Chris Dudley,C,32,NYK,51,22,858,58,143,0.406,0,0,0.0,58,143,0.406,0.406,41,92,0.446,108,167,275,21,13,51,44,139,157
Joe Dumars*,SG,34,DET,72,72,2326,329,791,0.41600000000000004,158,426,0.371,171,365,0.46799999999999997,0.516,127,154,0.825,14,90,104,253,44,2,84,99,943
Tony Dumas,SG,25,CLE,7,0,47,6,12,0.5,2,4,0.5,4,8,0.5,0.583,0,3,0.0,1,4,5,5,0,0,5,5,14
Tim Duncan,PF,21,SAS,82,82,3204,706,1287,0.5489999999999999,0,10,0.0,706,1277,0.5529999999999999,0.5489999999999999,319,482,0.662,274,703,977,224,55,206,279,254,1731
Ledell Eackles,SG,31,WAS,42,0,547,75,175,0.429,16,46,0.348,59,129,0.457,0.474,52,59,0.8809999999999999,25,50,75,16,17,0,29,43,218
Tyus Edney,PG,24,BOS,52,7,623,93,216,0.431,3,10,0.3,90,206,0.43700000000000006,0.43799999999999994,88,111,0.7929999999999999,20,35,55,139,51,1,66,69,277
Blue Edwards,SG,32,VAN,81,20,1968,326,742,0.439,40,120,0.33299999999999996,286,622,0.46,0.466,180,215,0.8370000000000001,61,156,217,201,86,27,134,183,872
Kevin Edwards,SG,32,TOT,39,5,487,57,165,0.345,6,15,0.4,51,150,0.34,0.364,30,35,0.857,20,34,54,39,26,1,30,28,150
Howard Eisley,PG,25,UTA,82,18,1726,229,519,0.441,48,118,0.40700000000000003,181,401,0.451,0.48700000000000004,127,149,0.852,25,141,166,346,54,13,160,182,633
Mario Elie,SF,34,HOU,73,59,1988,206,456,0.452,55,189,0.29100000000000004,151,267,0.5660000000000001,0.512,145,174,0.833,39,117,156,221,81,8,100,115,612
Sean Elliott,SF,29,SAS,36,36,1012,122,303,0.40299999999999997,34,90,0.37799999999999995,88,213,0.413,0.45899999999999996,56,78,0.718,16,108,124,62,24,14,57,92,334
Dale Ellis,SF,37,SEA,79,0,1939,348,700,0.49700000000000005,127,274,0.46399999999999997,221,426,0.519,0.588,111,142,0.782,51,133,184,89,60,5,74,128,934
Harold Ellis,SF,27,DEN,27,3,344,62,111,0.5589999999999999,0,4,0.0,62,107,0.579,0.5589999999999999,40,63,0.635,27,23,50,18,19,4,19,53,164
LaPhonso Ellis,SF,27,DEN,76,71,2575,410,1007,0.40700000000000003,57,201,0.284,353,806,0.43799999999999994,0.435,206,256,0.805,146,398,544,213,65,49,173,226,1083
Pervis Ellison,PF,30,BOS,33,8,447,40,70,0.5710000000000001,0,0,0.0,40,70,0.5710000000000001,0.5710000000000001,20,34,0.588,52,57,109,31,20,31,28,90,100
Brian Evans,SF,24,TOT,72,1,893,123,312,0.39399999999999996,29,87,0.33299999999999996,94,225,0.418,0.441,46,57,0.807,49,88,137,55,29,13,38,101,321
Patrick Ewing*,C,35,NYK,26,26,848,203,403,0.504,0,2,0.0,203,401,0.506,0.504,134,186,0.72,59,206,265,28,16,58,77,74,540
Tony Farmer,C,28,CHH,27,2,169,17,53,0.321,2,9,0.222,15,44,0.341,0.34,31,39,0.795,16,16,32,5,10,4,9,23,67
Jamie Feick,PF,23,MIL,45,2,450,39,90,0.433,4,13,0.308,35,77,0.455,0.456,20,41,0.488,45,79,124,16,25,17,21,67,102
Duane Ferrell,SF,32,GSW,50,5,461,41,111,0.369,0,6,0.0,41,105,0.39,0.369,12,22,0.545,25,22,47,26,21,6,18,50,94
Danny Ferry,PF,31,CLE,69,3,1034,113,286,0.395,33,99,0.33299999999999996,80,187,0.428,0.45299999999999996,32,40,0.8,23,91,114,59,26,17,53,118,291
Michael Finley,SF,24,DAL,82,82,3394,675,1505,0.449,87,244,0.35700000000000004,588,1261,0.466,0.47700000000000004,326,416,0.784,150,288,438,405,132,30,219,163,1763
Derek Fisher,PG,23,LAL,82,36,1760,164,378,0.434,31,81,0.38299999999999995,133,297,0.44799999999999995,0.475,115,152,0.757,38,155,193,333,75,5,119,126,474
Danny Fortson,PF,21,DEN,80,23,1811,276,611,0.452,1,3,0.33299999999999996,275,608,0.452,0.45299999999999996,263,339,0.7759999999999999,182,266,448,76,44,30,157,314,816
Greg Foster,C,29,UTA,78,49,1446,186,418,0.445,2,9,0.222,184,409,0.45,0.447,67,87,0.77,85,188,273,51,15,28,68,187,441
Rick Fox,SF,28,LAL,82,82,2709,363,771,0.47100000000000003,86,265,0.325,277,506,0.547,0.527,171,230,0.743,78,280,358,276,100,48,201,309,983
Adonal Foyle,C,22,GSW,55,1,656,69,170,0.406,0,1,0.0,69,169,0.408,0.406,27,62,0.435,73,111,184,14,13,52,50,94,165
Todd Fuller,C,23,GSW,57,1,613,86,205,0.42,0,4,0.0,86,201,0.428,0.42,55,80,0.688,61,135,196,10,6,16,37,89,227
Lawrence Funderburke,PF,27,SAC,52,1,1094,191,390,0.49,1,7,0.14300000000000002,190,383,0.496,0.491,110,162,0.679,80,154,234,63,19,15,62,56,493
Chris Garner,PG,22,TOR,38,0,293,23,70,0.32899999999999996,4,14,0.28600000000000003,19,56,0.33899999999999997,0.35700000000000004,3,7,0.429,7,17,24,45,21,4,25,50,53
Kevin Garnett,PF,21,MIN,82,82,3222,635,1293,0.491,3,16,0.188,632,1277,0.495,0.49200000000000005,245,332,0.738,222,564,786,348,139,150,192,224,1518
Dean Garrett,C,31,DEN,82,82,2632,242,565,0.428,0,0,0.0,242,565,0.428,0.428,114,176,0.648,227,417,644,90,57,133,84,197,598
Kiwane Garris,SG,23,DEN,28,0,225,22,65,0.33799999999999997,5,14,0.35700000000000004,17,51,0.33299999999999996,0.377,19,25,0.76,3,16,19,28,7,1,15,22,68
Chris Gatling,PF,30,NJN,57,16,1359,248,545,0.455,1,4,0.25,247,541,0.457,0.456,159,265,0.6,118,216,334,53,52,29,99,152,656
Reggie Geary,PG,24,SAS,62,2,685,56,169,0.331,12,40,0.3,44,129,0.341,0.36700000000000005,28,56,0.5,19,48,67,74,37,12,42,95,152
Matt Geiger,C,28,CHH,78,42,1839,358,709,0.505,1,11,0.091,357,698,0.511,0.506,168,236,0.7120000000000001,196,325,521,78,68,87,111,191,885
Kendall Gill,SF,29,NJN,81,81,2733,418,974,0.429,26,101,0.257,392,873,0.449,0.44299999999999995,225,327,0.688,112,279,391,200,156,64,124,268,1087
Armen Gilliam,PF,33,MIL,82,25,2114,327,676,0.484,0,4,0.0,327,672,0.48700000000000004,0.484,267,333,0.802,146,293,439,104,65,37,148,177,921
Anthony Goldwire,PG,26,DEN,82,32,2212,269,636,0.423,63,164,0.384,206,472,0.436,0.47200000000000003,150,186,0.8059999999999999,40,107,147,277,86,7,85,149,751
Greg Graham,SG,27,CLE,6,0,56,7,12,0.583,0,3,0.0,7,9,0.778,0.583,2,2,1.0,0,1,1,6,1,0,10,7,16
Brian Grant,SF,25,POR,61,49,1921,283,557,0.508,0,1,0.0,283,556,0.509,0.508,171,228,0.75,197,358,555,86,44,45,110,184,737
Gary Grant,PG,32,POR,22,2,359,43,93,0.462,7,19,0.368,36,74,0.486,0.5,12,14,0.857,8,40,48,84,17,2,24,30,105
Harvey Grant,SF,32,WAS,65,8,895,75,196,0.38299999999999995,1,6,0.16699999999999998,74,190,0.389,0.385,19,30,0.633,60,108,168,39,23,15,26,94,170
Horace Grant,C,32,ORL,76,76,2803,393,857,0.45899999999999996,0,7,0.0,393,850,0.462,0.45899999999999996,135,199,0.6779999999999999,228,390,618,172,81,79,88,180,921
Ed Gray,SG,22,ATL,30,3,472,77,202,0.381,18,46,0.391,59,156,0.37799999999999995,0.426,55,65,0.846,9,36,45,34,15,11,30,73,227
Jeff Grayer,SG,32,TOT,5,0,34,4,11,0.364,2,6,0.33299999999999996,2,5,0.4,0.455,0,0,0.0,0,4,4,2,2,0,4,7,10
A.C. Green,PF,34,DAL,82,68,2649,242,534,0.45299999999999996,0,4,0.0,242,530,0.457,0.45299999999999996,116,162,0.716,219,449,668,123,78,27,68,157,600
Litterial Green,PG,27,MIL,21,0,124,5,23,0.217,0,2,0.0,5,21,0.23800000000000002,0.217,15,20,0.75,1,6,7,16,4,0,8,11,25
Derek Grimm,SF,23,SAC,9,0,34,4,14,0.28600000000000003,4,12,0.33299999999999996,0,2,0.0,0.429,2,2,1.0,0,4,4,0,3,1,3,6,14
Tom Gugliotta,SF,28,MIN,41,41,1582,319,635,0.502,2,17,0.11800000000000001,317,618,0.513,0.504,183,223,0.821,106,250,356,167,61,22,109,102,823
Jack Haley,C,34,NJN,16,0,51,5,18,0.278,0,1,0.0,5,17,0.294,0.278,12,21,0.5710000000000001,5,10,15,0,0,1,4,9,22
Darvin Ham,SF,24,WAS,71,3,635,55,104,0.529,0,0,0.0,55,104,0.529,0.529,35,74,0.473,72,59,131,16,21,25,37,118,145
Tom Hammonds,PF,30,MIN,57,2,1140,127,246,0.516,0,1,0.0,127,245,0.518,0.516,92,132,0.6970000000000001,100,171,271,36,15,17,48,127,346
Reggie Hanson,SF,29,BOS,8,0,26,3,6,0.5,0,0,0.0,3,6,0.5,0.5,0,0,0.0,3,3,6,1,2,1,3,8,6
Anfernee Hardaway,SG,26,ORL,19,15,625,103,273,0.377,15,50,0.3,88,223,0.395,0.405,90,118,0.763,8,68,76,68,28,15,46,45,311
Tim Hardaway,PG,31,MIA,81,81,3031,558,1296,0.431,155,442,0.35100000000000003,403,854,0.47200000000000003,0.49,257,329,0.7809999999999999,48,251,299,672,136,16,224,200,1528
Derek Harper,SG,36,ORL,66,45,1761,226,542,0.41700000000000004,59,164,0.36,167,378,0.442,0.47100000000000003,55,79,0.696,23,80,103,233,72,10,101,140,566
Ron Harper,PG,34,CHI,82,82,2284,293,665,0.441,16,84,0.19,277,581,0.47700000000000004,0.45299999999999996,162,216,0.75,107,183,290,241,108,48,91,181,764
Othella Harrington,PF,24,HOU,58,3,903,129,266,0.485,0,1,0.0,129,265,0.48700000000000004,0.485,92,122,0.754,73,134,207,24,10,27,47,112,350
Lucious Harris,SG,27,NJN,50,0,671,69,177,0.39,12,39,0.308,57,138,0.413,0.424,41,55,0.745,21,31,52,42,42,5,21,77,191
Hersey Hawkins,SG,31,SEA,82,82,2597,280,636,0.44,125,301,0.415,155,335,0.46299999999999997,0.539,177,204,0.868,71,263,334,221,148,17,102,153,862
Alan Henderson,PF,25,ATL,69,33,2000,365,753,0.485,3,6,0.5,362,747,0.485,0.48700000000000004,253,388,0.652,200,242,442,73,42,36,110,175,986
Cedric Henderson,SF,22,CLE,82,71,2527,348,725,0.48,0,4,0.0,348,721,0.483,0.48,136,190,0.716,71,254,325,168,96,45,165,238,832
Mark Hendrickson,PF,23,SAC,48,1,737,58,149,0.389,0,5,0.0,58,144,0.40299999999999997,0.389,47,57,0.825,33,110,143,41,26,9,31,60,163
Steve Henson,PG,29,DET,23,0,65,13,26,0.5,3,8,0.375,10,18,0.556,0.5579999999999999,7,7,1.0,0,2,2,4,1,0,6,9,36
Carl Herrera,PF,31,SAS,58,1,516,76,175,0.434,0,1,0.0,76,174,0.43700000000000006,0.434,18,44,0.409,24,67,91,22,19,12,38,71,170
Sean Higgins,SF,29,POR,2,0,12,0,5,0.0,0,2,0.0,0,3,0.0,0.0,0,0,0.0,0,0,0,0,2,0,1,3,0
Grant Hill*,SF,25,DET,81,81,3294,615,1361,0.452,3,21,0.14300000000000002,612,1340,0.457,0.45299999999999996,479,647,0.74,93,530,623,551,143,53,285,196,1712
Tyrone Hill,PF,29,MIL,57,56,2064,208,418,0.498,0,1,0.0,208,417,0.499,0.498,155,255,0.608,212,396,608,88,67,30,106,230,571
Fred Hoiberg,SG,25,IND,65,1,874,85,222,0.38299999999999995,32,85,0.376,53,137,0.387,0.455,59,69,0.855,14,109,123,45,40,3,22,101,261
Jerald Honeycutt,PF,23,MIL,38,0,530,90,221,0.40700000000000003,29,77,0.377,61,144,0.424,0.473,36,58,0.621,27,66,93,33,20,6,49,83,245
Jeff Hornacek,SG,34,UTA,80,80,2460,399,828,0.48200000000000004,56,127,0.441,343,701,0.489,0.516,285,322,0.885,65,205,270,349,109,15,132,175,1139
Robert Horry,PF,27,LAL,72,71,2192,200,420,0.47600000000000003,19,93,0.204,181,327,0.5539999999999999,0.499,117,169,0.6920000000000001,186,356,542,163,112,94,99,238,536
Allan Houston,SG,26,NYK,82,82,2848,571,1277,0.447,82,213,0.385,489,1064,0.46,0.479,285,335,0.851,43,231,274,212,63,24,200,207,1509
Juwan Howard,PF,24,WAS,64,64,2559,463,991,0.467,0,2,0.0,463,989,0.46799999999999997,0.467,258,358,0.721,161,288,449,208,82,23,185,225,1184
Stephen Howard,SF,27,SEA,13,0,53,8,21,0.381,0,0,0.0,8,21,0.381,0.381,9,18,0.5,6,6,12,3,3,1,6,13,25
Troy Hudson,PG,21,UTA,8,0,23,6,14,0.429,0,3,0.0,6,11,0.545,0.429,0,0,0.0,1,1,2,4,2,0,1,1,12
Lindsey Hunter,PG,27,DET,71,67,2505,316,826,0.38299999999999995,85,265,0.321,231,561,0.41200000000000003,0.434,145,196,0.74,61,186,247,224,123,10,110,174,862
Bobby Hurley,PG,26,TOT,61,3,875,93,238,0.391,5,22,0.22699999999999998,88,216,0.40700000000000003,0.401,59,76,0.7759999999999999,12,54,66,177,23,0,86,79,250
Zydrunas Ilgauskas,C,22,CLE,82,81,2379,454,876,0.518,1,4,0.25,453,872,0.519,0.519,230,302,0.762,279,444,723,71,52,135,146,288,1139
Allen Iverson*,PG,22,PHI,80,80,3150,649,1407,0.461,70,235,0.298,579,1172,0.494,0.486,390,535,0.7290000000000001,86,210,296,494,176,25,244,200,1758
Bobby Jackson,PG,24,DEN,68,53,2042,310,791,0.392,21,81,0.259,289,710,0.40700000000000003,0.405,149,183,0.8140000000000001,78,224,302,317,105,11,184,160,790
Jaren Jackson,SG,30,SAS,82,45,2226,258,654,0.39399999999999996,112,297,0.377,146,357,0.409,0.48,94,118,0.797,55,155,210,156,60,8,104,222,722
Jim Jackson,SG,27,TOT,79,78,3046,476,1107,0.43,61,191,0.319,415,916,0.45299999999999996,0.45799999999999996,229,282,0.812,130,270,400,381,79,8,263,186,1242
Mark Jackson,PG,32,IND,82,82,2413,249,598,0.41600000000000004,43,137,0.314,206,461,0.447,0.452,137,180,0.7609999999999999,67,255,322,713,84,2,174,132,678
Henry James,PF,32,CLE,28,0,166,24,59,0.40700000000000003,11,25,0.44,13,34,0.382,0.5,21,22,0.955,2,13,15,5,1,1,12,24,80
Anthony Johnson,PG,23,SAC,77,62,2266,226,609,0.371,42,128,0.32799999999999996,184,481,0.38299999999999995,0.406,80,110,0.727,51,120,171,329,64,6,120,188,574
Avery Johnson,PG,32,SAS,75,73,2674,321,671,0.478,2,13,0.154,319,658,0.485,0.48,122,168,0.726,30,120,150,591,84,18,165,140,766
Eddie Johnson,SF,38,HOU,75,1,1490,227,544,0.41700000000000004,66,198,0.33299999999999996,161,346,0.465,0.478,113,136,0.831,50,103,153,88,32,3,62,89,633
Ervin Johnson,C,30,MIL,81,81,2261,253,471,0.537,0,0,0.0,253,471,0.537,0.537,143,238,0.601,242,443,685,59,79,158,117,321,649
Kevin Johnson,PG,31,PHO,50,12,1290,155,347,0.447,4,26,0.154,151,321,0.47,0.452,162,186,0.871,35,129,164,245,27,8,101,57,476
Larry Johnson,SF,28,NYK,70,70,2412,429,884,0.485,15,63,0.23800000000000002,414,821,0.504,0.494,214,283,0.7559999999999999,175,226,401,150,40,13,127,193,1087
Charles Jones,PF,40,HOU,24,0,127,7,10,0.7,0,0,0.0,7,10,0.7,0.7,1,2,0.5,12,12,24,5,1,6,4,22,15
Dontae' Jones,SF,22,BOS,15,0,91,19,57,0.33299999999999996,6,23,0.261,13,34,0.382,0.386,0,0,0.0,3,6,9,5,2,3,11,12,44
Eddie Jones,SG,26,LAL,80,80,2910,486,1005,0.484,143,368,0.389,343,637,0.5379999999999999,0.555,234,306,0.765,85,217,302,246,160,55,146,164,1349
Popeye Jones,PF,27,TOR,14,4,352,52,127,0.409,2,3,0.667,50,124,0.40299999999999997,0.41700000000000004,14,19,0.737,50,52,102,18,10,3,16,39,120
Michael Jordan*,SG,34,CHI,82,82,3181,881,1893,0.465,30,126,0.23800000000000002,851,1767,0.48200000000000004,0.473,565,721,0.784,130,345,475,283,141,45,185,151,2357
Reggie Jordan,SG,30,MIN,57,1,487,54,113,0.478,0,1,0.0,54,112,0.48200000000000004,0.478,41,72,0.569,57,40,97,50,35,9,30,63,149
Adam Keefe,C,27,UTA,80,75,2047,229,424,0.54,0,0,0.0,229,424,0.54,0.54,162,200,0.81,179,259,438,89,52,24,71,172,620
Shawn Kemp,PF,28,CLE,80,80,2769,518,1164,0.445,2,8,0.25,516,1156,0.446,0.446,404,556,0.727,219,526,745,197,108,90,271,310,1442
Tim Kempton,PF,34,TOT,8,0,47,2,9,0.222,0,0,0.0,2,9,0.222,0.222,0,0,0.0,4,2,6,3,1,2,4,10,4
Steve Kerr,PG,32,CHI,50,0,1119,137,302,0.45399999999999996,57,130,0.43799999999999994,80,172,0.465,0.5479999999999999,45,49,0.9179999999999999,14,63,77,96,26,5,27,71,376
Jerome Kersey,SF,35,SEA,37,2,717,97,233,0.41600000000000004,1,10,0.1,96,223,0.43,0.418,39,65,0.6,56,79,135,44,52,14,36,104,234
Jason Kidd*,PG,24,PHO,82,82,3118,357,859,0.41600000000000004,73,233,0.313,284,626,0.45399999999999996,0.45799999999999996,167,209,0.799,108,402,510,745,162,26,261,142,954
Kerry Kittles,SG,23,NJN,77,76,2814,508,1154,0.44,110,263,0.418,398,891,0.447,0.488,202,250,0.8079999999999999,132,230,362,176,132,37,106,152,1328
Joe Kleine,C,36,CHI,46,1,397,39,106,0.368,0,0,0.0,39,106,0.368,0.368,15,18,0.833,27,50,77,30,4,5,28,63,93
Brevin Knight,PG,22,CLE,80,76,2483,261,592,0.441,0,7,0.0,261,585,0.446,0.441,201,251,0.8009999999999999,67,186,253,656,196,18,194,271,723
Travis Knight,C,23,BOS,74,21,1503,193,438,0.441,15,55,0.273,178,383,0.465,0.45799999999999996,81,103,0.7859999999999999,146,219,365,104,54,82,87,253,482
Toni Kukoč,SF,29,CHI,74,52,2235,383,841,0.455,63,174,0.36200000000000004,320,667,0.48,0.493,155,219,0.708,121,206,327,314,76,37,154,149,984
Christian Laettner,PF,28,ATL,74,49,2282,354,730,0.485,6,27,0.222,348,703,0.495,0.489,306,354,0.8640000000000001,142,345,487,190,71,73,183,246,1020
Andrew Lang,C,31,MIL,57,0,692,54,143,0.37799999999999995,0,1,0.0,54,142,0.38,0.37799999999999995,44,57,0.772,56,97,153,16,18,27,33,101,152
Antonio Lang,SF,25,MIA,6,0,29,3,5,0.6,0,0,0.0,3,5,0.6,0.6,6,8,0.75,2,3,5,1,2,0,4,3,12
Rusty LaRue,PG,24,CHI,14,0,140,20,49,0.408,4,16,0.25,16,33,0.485,0.449,5,8,0.625,1,7,8,5,3,1,6,12,49
Priest Lauderdale,C,24,DEN,39,0,345,53,127,0.41700000000000004,0,0,0.0,53,127,0.41700000000000004,0.41700000000000004,38,69,0.551,27,73,100,21,7,17,46,63,144
Jason Lawson,C,23,ORL,17,0,80,9,15,0.6,0,0,0.0,9,15,0.6,0.6,8,10,0.8,8,19,27,5,4,4,2,14,26
Tim Legler,SG,31,WAS,8,0,76,3,19,0.158,0,6,0.0,3,13,0.231,0.158,3,4,0.75,2,2,4,3,1,0,4,11,9
Voshon Lenard,SG,24,MIA,81,81,2621,363,854,0.425,153,378,0.405,210,476,0.441,0.515,141,179,0.7879999999999999,72,220,292,180,58,16,99,219,1020
Alton Lister,C,39,POR,7,0,44,3,8,0.375,0,0,0.0,3,8,0.375,0.375,0,0,0.0,2,9,11,1,1,1,2,12,6
Randy Livingston,PG,22,ATL,12,0,82,3,12,0.25,0,0,0.0,3,12,0.25,0.25,4,5,0.8,1,5,6,5,7,2,6,6,10
Horacio Llamas Grey,C,24,PHO,8,0,42,8,21,0.381,1,3,0.33299999999999996,7,18,0.389,0.405,7,10,0.7,4,14,18,1,1,3,9,14,24
Brad Lohaus,PF,33,SAS,9,0,102,7,21,0.33299999999999996,4,14,0.28600000000000003,3,7,0.429,0.429,1,3,0.33299999999999996,3,9,12,5,1,2,3,10,19
Grant Long,PF,31,DET,40,17,739,50,117,0.42700000000000005,0,4,0.0,50,113,0.442,0.42700000000000005,41,57,0.7190000000000001,57,93,150,25,29,12,22,91,141
Luc Longley,C,29,CHI,58,58,1703,277,609,0.455,0,0,0.0,277,609,0.455,0.455,109,148,0.736,113,228,341,161,34,62,130,206,663
George Lynch,SF,27,VAN,82,0,1493,248,516,0.48100000000000004,9,30,0.3,239,486,0.49200000000000005,0.489,111,158,0.703,147,215,362,122,65,41,104,161,616
Sam Mack,SF,27,VAN,57,54,1414,222,559,0.397,110,269,0.409,112,290,0.386,0.496,62,77,0.805,30,103,133,101,41,11,69,117,616
Don MacLean,SF,28,NJN,9,0,42,1,10,0.1,1,2,0.5,0,8,0.0,0.15,0,0,0.0,3,2,5,0,0,0,2,7,3
Gerald Madkins,SG,28,GSW,19,0,243,13,34,0.382,6,15,0.4,7,19,0.368,0.47100000000000003,5,7,0.7140000000000001,2,13,15,45,13,1,13,18,37
Rick Mahorn,C,39,DET,59,0,707,59,129,0.457,0,0,0.0,59,129,0.457,0.457,23,34,0.6759999999999999,65,130,195,15,14,7,37,123,141
Dan Majerle,SG,32,MIA,72,22,1928,184,439,0.419,111,295,0.376,73,144,0.507,0.546,40,51,0.784,48,220,268,157,68,15,65,139,519
Karl Malone*,PF,34,UTA,81,81,3030,780,1472,0.53,2,6,0.33299999999999996,778,1466,0.531,0.531,628,825,0.7609999999999999,189,645,834,316,96,70,247,237,2190
Matt Maloney,PG,26,HOU,78,78,2217,239,586,0.408,126,346,0.364,113,240,0.47100000000000003,0.515,65,78,0.833,16,126,142,219,62,5,107,99,669
Danny Manning,PF,31,PHO,70,11,1794,390,756,0.516,0,7,0.0,390,749,0.521,0.516,167,226,0.7390000000000001,110,282,392,139,71,46,100,201,947
Stephon Marbury,PG,20,MIN,82,81,3112,513,1237,0.415,95,304,0.313,418,933,0.44799999999999995,0.45299999999999996,329,450,0.731,58,172,230,704,104,7,256,222,1450
Donyell Marshall,SF,24,GSW,73,73,2611,451,1090,0.414,63,201,0.313,388,889,0.436,0.44299999999999995,158,216,0.731,210,418,628,159,95,73,147,226,1123
Darrick Martin,PG,26,LAC,82,63,2299,275,730,0.377,107,293,0.365,168,437,0.384,0.45,184,217,0.848,19,145,164,331,82,10,154,198,841
Jamal Mashburn,SF,25,MIA,48,48,1729,251,577,0.435,37,122,0.303,214,455,0.47,0.467,184,231,0.797,72,164,236,132,43,14,108,137,723
Anthony Mason,PF,31,CHH,81,80,3148,389,764,0.509,0,4,0.0,389,760,0.512,0.509,261,402,0.649,177,649,826,342,68,18,146,182,1039
Tony Massenburg,C,30,VAN,61,13,894,148,309,0.479,0,0,0.0,148,309,0.479,0.479,100,137,0.73,80,152,232,21,25,24,60,123,396
Vernon Maxwell,SG,32,TOT,42,0,636,103,258,0.39899999999999997,37,112,0.33,66,146,0.452,0.47100000000000003,48,60,0.8,14,43,57,52,16,4,40,71,291
Lee Mayberry,PG,27,VAN,79,32,1835,131,349,0.375,63,180,0.35,68,169,0.402,0.466,38,51,0.745,19,95,114,349,65,10,113,164,363
Bob McCann,SF,33,TOR,1,0,5,0,1,0.0,0,0,0.0,0,1,0.0,0.0,0,0,0.0,0,1,1,0,0,0,0,1,0
Walter McCarty,SF,23,BOS,82,64,2340,295,730,0.40399999999999997,54,175,0.309,241,555,0.434,0.441,144,194,0.742,141,223,364,177,110,44,141,274,788
George McCloud,SF,30,PHO,63,13,1213,173,427,0.405,71,208,0.341,102,219,0.466,0.488,39,51,0.765,45,173,218,84,54,13,63,132,456
Xavier McDaniel,SF,34,NJN,20,0,180,10,30,0.33299999999999996,0,0,0.0,10,30,0.33299999999999996,0.33299999999999996,5,8,0.625,12,19,31,9,3,2,8,23,25
Michael McDonald,C,28,CHH,1,0,4,0,0,0.0,0,0,0.0,0,0,0.0,0.0,0,0,0.0,1,0,1,0,0,0,2,1,0
Antonio McDyess,PF,23,PHO,81,81,2441,497,927,0.536,0,2,0.0,497,925,0.537,0.536,231,329,0.7020000000000001,206,407,613,106,100,135,142,292,1225
Tracy McGrady*,SF,18,TOR,64,17,1179,179,398,0.45,14,41,0.341,165,357,0.462,0.467,79,111,0.7120000000000001,105,164,269,98,49,61,66,86,451
Jim McIlvaine,C,25,SEA,78,72,1211,101,223,0.45299999999999996,0,3,0.0,101,220,0.45899999999999996,0.45299999999999996,45,81,0.556,96,163,259,19,24,137,54,240,247
Derrick McKey,SF,31,IND,57,4,1316,150,327,0.45899999999999996,4,17,0.235,146,310,0.47100000000000003,0.465,55,77,0.7140000000000001,74,137,211,88,57,30,79,156,359
Aaron McKie,SG-SF,25,TOT,81,32,1813,139,381,0.365,12,63,0.19,127,318,0.39899999999999997,0.381,42,55,0.764,58,173,231,175,101,13,76,164,332
Nate McMillan,SG,33,SEA,18,1,279,23,67,0.34299999999999997,15,34,0.441,8,33,0.242,0.455,1,1,1.0,13,27,40,55,14,4,12,41,62
Ron Mercer,SG,21,BOS,80,62,2662,515,1145,0.45,3,28,0.107,512,1117,0.45799999999999996,0.451,188,224,0.8390000000000001,109,171,280,176,125,17,132,213,1221
Marko Milič,SF,20,PHO,33,0,163,39,64,0.609,3,6,0.5,36,58,0.621,0.633,11,17,0.647,10,15,25,12,10,0,21,17,92
Anthony Miller,PF,26,ATL,37,0,228,29,52,0.5579999999999999,0,0,0.0,29,52,0.5579999999999999,0.5579999999999999,21,39,0.5379999999999999,30,40,70,3,15,3,14,41,79
Oliver Miller,C,27,TOR,64,53,1628,170,369,0.461,0,4,0.0,170,365,0.466,0.461,61,101,0.604,146,254,400,196,58,72,131,184,401
Reggie Miller*,SG,32,IND,81,81,2795,516,1081,0.47700000000000004,164,382,0.429,352,699,0.504,0.5529999999999999,382,440,0.868,46,186,232,171,78,11,128,148,1578
Chris Mills,SF,28,NYK,80,29,2183,292,675,0.433,40,137,0.292,252,538,0.46799999999999997,0.462,152,189,0.804,120,288,408,133,45,30,107,218,776
Terry Mills,PF,30,MIA,50,0,782,81,206,0.39299999999999996,25,81,0.309,56,125,0.44799999999999995,0.45399999999999996,25,33,0.758,34,118,152,39,19,9,45,129,212
Greg Minor,SG,26,BOS,69,16,1126,140,321,0.436,6,31,0.19399999999999998,134,290,0.462,0.445,59,86,0.6859999999999999,55,95,150,88,53,11,43,100,345
Sam Mitchell,SF,34,MIN,81,33,2239,371,800,0.46399999999999997,15,43,0.349,356,757,0.47,0.473,243,292,0.8320000000000001,118,267,385,107,64,22,66,200,1000
Eric Montross,C,26,TOT,48,30,691,61,144,0.424,0,0,0.0,61,144,0.424,0.424,16,40,0.4,69,130,199,11,13,27,29,127,138
Chris Morris,SF,32,UTA,54,1,538,85,207,0.41100000000000003,19,62,0.306,66,145,0.455,0.457,44,61,0.721,35,79,114,24,25,17,33,61,233
Lawrence Moten,SG,25,WAS,8,0,27,3,13,0.231,0,1,0.0,3,12,0.25,0.231,3,4,0.75,1,0,1,3,0,0,1,6,9
Alonzo Mourning*,C,27,MIA,58,56,1939,403,732,0.551,0,0,0.0,403,732,0.551,0.551,309,465,0.665,193,365,558,52,40,130,179,208,1115
Chris Mullin*,SF,34,IND,82,82,2177,333,692,0.48100000000000004,107,243,0.44,226,449,0.503,0.5589999999999999,154,164,0.9390000000000001,38,211,249,186,95,39,117,186,927
Eric Murdock,PG,29,MIA,82,1,1395,177,419,0.42200000000000004,28,91,0.308,149,328,0.45399999999999996,0.456,125,156,0.8009999999999999,39,117,156,219,103,13,104,173,507
Lamond Murray,SF,24,LAC,79,65,2579,473,984,0.48100000000000004,54,153,0.353,419,831,0.504,0.508,220,294,0.748,172,312,484,142,118,54,171,193,1220
Tracy Murray,SF,26,WAS,82,12,2227,449,1007,0.446,158,403,0.392,291,604,0.48200000000000004,0.524,182,209,0.871,75,202,277,84,67,25,102,167,1238
Dikembe Mutombo*,C,31,ATL,82,82,2917,399,743,0.537,0,0,0.0,399,743,0.537,0.537,303,452,0.67,276,656,932,82,34,277,168,254,1101
Martin Müürsepp,PF,23,DAL,41,7,603,83,191,0.435,16,38,0.42100000000000004,67,153,0.43799999999999994,0.47600000000000003,51,67,0.7609999999999999,46,68,114,30,29,14,29,96,233
Pete Myers,SG,34,NYK,9,0,40,5,10,0.5,0,0,0.0,5,10,0.5,0.5,4,6,0.667,5,5,10,3,4,0,4,7,14
Steve Nash*,PG,23,PHO,76,9,1664,268,584,0.45899999999999996,81,195,0.415,187,389,0.48100000000000004,0.528,74,86,0.86,32,128,160,262,63,4,98,145,691
Ivano Newbill,PF,27,VAN,28,2,249,20,57,0.35100000000000003,1,1,1.0,19,56,0.33899999999999997,0.36,17,30,0.5670000000000001,24,45,69,9,10,3,17,38,58
Johnny Newman,SF,34,DEN,74,15,2176,344,799,0.431,36,105,0.34299999999999997,308,694,0.444,0.45299999999999996,365,445,0.82,50,91,141,138,77,24,147,208,1089
Jeff Nordgaard,PF,24,MIL,13,0,48,5,18,0.278,0,0,0.0,5,18,0.278,0.278,8,9,0.889,4,10,14,3,2,0,3,7,18
Charles O'Bannon,SG,22,DET,30,0,234,26,69,0.377,0,3,0.0,26,66,0.39399999999999996,0.377,12,15,0.8,14,19,33,17,9,1,9,15,64
Jermaine O'Neal,PF,19,POR,60,9,808,112,231,0.485,0,2,0.0,112,229,0.489,0.485,45,89,0.506,80,121,201,17,15,58,55,101,269
Shaquille O'Neal*,C,25,LAL,60,57,2175,670,1147,0.584,0,0,0.0,670,1147,0.584,0.584,359,681,0.527,208,473,681,142,39,144,175,193,1699
Charles Oakley,PF,34,NYK,79,79,2734,307,698,0.44,0,6,0.0,307,692,0.444,0.44,97,114,0.851,218,506,724,201,123,22,126,280,711
Hakeem Olajuwon*,C,35,HOU,47,45,1633,306,633,0.483,0,3,0.0,306,630,0.486,0.483,160,212,0.755,116,344,460,143,84,96,126,152,772
Brian Oliver,SG,29,ATL,5,0,61,7,19,0.368,0,0,0.0,7,19,0.368,0.368,1,4,0.25,3,6,9,2,1,0,1,4,15
Jimmy Oliver,SG,28,WAS,1,0,10,2,4,0.5,1,2,0.5,1,2,0.5,0.625,0,0,0.0,0,2,2,1,0,0,0,1,5
Kevin Ollie,PG,25,TOT,35,0,430,37,98,0.37799999999999995,0,1,0.0,37,97,0.381,0.37799999999999995,49,70,0.7,9,30,39,65,13,0,44,31,123
Greg Ostertag,C,24,UTA,63,23,1288,115,239,0.48100000000000004,0,0,0.0,115,239,0.48100000000000004,0.48100000000000004,67,140,0.479,134,240,374,25,28,132,74,166,297
Bo Outlaw,PF,26,ORL,82,76,2953,301,543,0.5539999999999999,1,4,0.25,300,539,0.557,0.555,180,313,0.575,255,382,637,216,107,181,175,260,783
Doug Overton,PG,28,PHI,23,2,277,24,63,0.381,0,3,0.0,24,60,0.4,0.381,14,16,0.875,2,12,14,37,8,1,23,34,62
Billy Owens,SF,28,SAC,78,78,2348,338,728,0.46399999999999997,26,70,0.371,312,658,0.474,0.48200000000000004,116,197,0.589,170,412,582,219,93,38,153,231,818
Robert Pack,PG,28,DAL,12,10,292,33,98,0.337,3,6,0.5,30,92,0.326,0.35200000000000004,25,36,0.6940000000000001,8,26,34,42,20,1,38,17,94
Anthony Parker,SG,22,PHI,37,0,196,25,63,0.397,9,28,0.321,16,35,0.457,0.46799999999999997,13,20,0.65,8,18,26,19,11,3,11,17,72
Cherokee Parks,C,25,MIN,79,43,1703,224,449,0.499,0,1,0.0,224,448,0.5,0.499,110,169,0.6509999999999999,140,297,437,53,36,86,66,237,558
Gary Payton*,PG,29,SEA,82,82,3145,579,1278,0.45299999999999996,134,397,0.33799999999999997,445,881,0.505,0.505,279,375,0.7440000000000001,77,299,376,679,185,18,229,195,1571
Anthony Peeler,SG,28,TOT,38,32,1193,190,420,0.452,53,125,0.424,137,295,0.46399999999999997,0.515,36,47,0.7659999999999999,37,86,123,137,61,6,51,97,469
Will Perdue,C,32,SAS,79,30,1491,162,295,0.5489999999999999,0,1,0.0,162,294,0.551,0.5489999999999999,70,133,0.526,177,358,535,57,22,50,81,137,394
Sam Perkins,PF,36,SEA,81,0,1675,196,471,0.41600000000000004,87,222,0.392,109,249,0.43799999999999994,0.508,101,128,0.789,53,202,255,113,62,29,62,158,580
Elliot Perry,PG,28,MIL,81,33,1752,241,561,0.43,17,50,0.34,224,511,0.43799999999999994,0.445,92,109,0.8440000000000001,21,87,108,230,90,2,128,129,591
Chuck Person,PF,33,SAS,61,11,1455,143,398,0.359,95,276,0.344,48,122,0.39299999999999996,0.479,28,37,0.757,17,187,204,86,29,10,67,121,409
Wesley Person,SG,26,CLE,82,82,3198,440,957,0.46,192,447,0.43,248,510,0.486,0.56,132,170,0.7759999999999999,65,298,363,188,129,49,110,108,1204
Bobby Phills,SG,28,CHH,62,61,1887,246,552,0.446,44,114,0.386,202,438,0.461,0.486,106,140,0.757,59,157,216,187,81,18,108,181,642
Eric Piatkowski,SG,27,LAC,67,35,1740,257,568,0.452,106,259,0.409,151,309,0.489,0.546,140,170,0.8240000000000001,70,166,236,85,51,12,80,137,760
Ricky Pierce,SG,38,MIL,39,0,442,52,143,0.364,4,13,0.308,48,130,0.369,0.37799999999999995,43,52,0.8270000000000001,19,26,45,34,9,0,21,35,151
Scottie Pippen*,SF,32,CHI,44,44,1652,315,704,0.447,61,192,0.318,254,512,0.496,0.491,150,193,0.777,53,174,227,254,79,43,109,116,841
Scot Pollard,C,22,DET,33,0,317,35,70,0.5,0,0,0.0,35,70,0.5,0.5,19,23,0.826,34,40,74,9,8,10,12,48,89
Olden Polynice,C,33,SAC,70,25,1458,249,542,0.45899999999999996,0,1,0.0,249,541,0.46,0.45899999999999996,52,115,0.452,173,266,439,107,37,45,98,158,550
Mark Pope,SF,25,IND,28,0,193,14,41,0.341,1,3,0.33299999999999996,13,38,0.342,0.354,10,17,0.588,9,17,26,7,3,6,10,36,39
Terry Porter,PG,34,MIN,82,8,1786,259,577,0.449,92,233,0.395,167,344,0.485,0.529,167,195,0.856,37,131,168,271,63,16,104,103,777
Vitaly Potapenko,C,22,CLE,80,0,1412,234,488,0.48,0,1,0.0,234,487,0.48,0.48,102,144,0.708,110,203,313,57,27,28,132,198,570
Brent Price,PG,29,HOU,72,2,1332,128,310,0.413,73,187,0.39,55,123,0.447,0.531,77,98,0.7859999999999999,37,70,107,192,52,4,111,163,406
Mark Price,PG,33,ORL,63,33,1430,229,531,0.431,52,155,0.335,177,376,0.47100000000000003,0.48,87,103,0.845,24,105,129,297,53,5,162,92,597
Theo Ratliff,C,24,TOT,82,67,2447,306,597,0.513,0,0,0.0,306,597,0.513,0.513,197,281,0.701,221,326,547,57,50,258,116,292,809
Eldridge Recasner,SG,30,ATL,59,14,1454,206,452,0.456,62,148,0.419,144,304,0.474,0.524,74,79,0.937,32,110,142,117,41,1,91,94,548
Bryant Reeves,C,24,VAN,74,74,2527,492,941,0.523,0,4,0.0,492,937,0.525,0.523,223,316,0.706,196,389,585,155,39,80,156,278,1207
Khalid Reeves,PG,25,DAL,82,54,1950,248,593,0.418,56,152,0.368,192,441,0.435,0.465,165,213,0.775,54,131,185,230,80,10,130,195,717
Don Reid,PF,24,DET,68,44,994,94,176,0.534,0,0,0.0,94,176,0.534,0.534,50,71,0.7040000000000001,77,98,175,26,25,55,28,183,238
J.R. Reid,PF,29,CHH,79,1,1109,146,318,0.45899999999999996,3,8,0.375,143,310,0.461,0.46399999999999997,89,122,0.73,72,138,210,51,35,19,65,172,384
Shawn Respert,SG,25,TOT,57,4,911,130,293,0.444,31,93,0.33299999999999996,99,200,0.495,0.49700000000000005,48,61,0.787,37,63,100,61,34,1,48,75,339
Rodrick Rhodes,SF,24,HOU,58,13,1070,112,305,0.36700000000000005,2,8,0.25,110,297,0.37,0.37,111,180,0.617,28,42,70,110,62,10,97,125,337
Glen Rice,SF,30,CHH,82,82,3295,634,1386,0.457,130,300,0.433,504,1086,0.46399999999999997,0.504,428,504,0.8490000000000001,89,264,353,182,77,22,182,200,1826
Pooh Richardson,PG,31,LAC,69,17,1252,124,333,0.37200000000000005,11,57,0.193,113,276,0.409,0.389,30,43,0.698,17,79,96,226,44,3,54,71,289
Mitch Richmond*,SG,32,SAC,70,70,2569,543,1220,0.445,130,334,0.389,413,886,0.466,0.498,407,471,0.8640000000000001,50,179,229,279,88,15,181,154,1623
Isaiah Rider,SG,26,POR,74,66,2786,551,1302,0.423,135,420,0.321,416,882,0.47200000000000003,0.475,221,267,0.828,99,247,346,231,55,19,187,188,1458
Eric Riley,C,27,DAL,39,14,544,56,135,0.415,0,1,0.0,56,134,0.418,0.415,27,36,0.75,43,90,133,22,15,46,37,80,139
Stanley Roberts,C,27,MIN,74,44,1328,191,386,0.495,0,0,0.0,191,386,0.495,0.495,75,156,0.48100000000000004,109,254,363,27,24,72,70,226,457
Chris Robinson,SG,23,TOT,35,0,414,65,174,0.374,24,66,0.364,41,108,0.38,0.44299999999999995,8,16,0.5,9,37,46,39,19,4,33,50,162
Clifford Robinson,SF,31,PHO,80,64,2359,429,895,0.479,27,84,0.321,402,811,0.496,0.494,248,360,0.6890000000000001,152,258,410,170,92,90,140,249,1133
David Robinson*,C,32,SAS,73,73,2457,544,1065,0.511,1,4,0.25,543,1061,0.512,0.511,485,660,0.735,239,536,775,199,64,192,202,204,1574
Glenn Robinson,SF,25,MIL,56,56,2294,534,1136,0.47,25,65,0.385,509,1071,0.475,0.48100000000000004,215,266,0.8079999999999999,82,225,307,158,69,34,200,164,1308
James Robinson,PG,27,LAC,70,13,1231,195,501,0.389,74,225,0.32899999999999996,121,276,0.43799999999999994,0.46299999999999997,77,107,0.72,37,74,111,135,37,10,97,101,541
Larry Robinson,SF,30,VAN,6,0,41,6,19,0.316,3,6,0.5,3,13,0.231,0.395,2,2,1.0,2,10,12,1,4,0,2,0,17
Dennis Rodman*,PF,36,CHI,80,66,2856,155,360,0.431,4,23,0.174,151,337,0.44799999999999995,0.436,61,111,0.55,421,780,1201,230,47,18,147,238,375
Carlos Rogers,PF,26,TOT,21,0,376,47,91,0.516,0,2,0.0,47,89,0.528,0.516,18,32,0.563,35,32,67,18,10,8,14,35,112
Rodney Rogers,SF,26,LAC,76,70,2499,426,935,0.456,72,212,0.34,354,723,0.49,0.494,225,328,0.6859999999999999,155,269,424,202,93,38,193,242,1149
Roy Rogers,PF,24,TOT,15,0,106,9,25,0.36,0,0,0.0,9,25,0.36,0.36,2,6,0.33299999999999996,8,9,17,2,3,8,5,18,20
Sean Rooks,C,28,LAL,41,1,425,46,101,0.455,0,0,0.0,46,101,0.455,0.455,47,79,0.595,46,72,118,24,2,23,19,68,139
Jalen Rose,SF,25,IND,82,0,1706,290,607,0.478,25,73,0.342,265,534,0.496,0.498,166,228,0.728,28,167,195,155,56,14,132,171,771
Malik Rose,PF,23,SAS,53,0,429,59,136,0.434,1,3,0.33299999999999996,58,133,0.436,0.43799999999999994,39,61,0.639,40,50,90,19,21,7,44,79,158
Donald Royal,SF,31,TOT,31,5,323,25,69,0.36200000000000004,0,0,0.0,25,69,0.36200000000000004,0.36200000000000004,29,33,0.879,18,23,41,17,7,1,10,35,79
Clifford Rozier,C,25,MIN,6,0,30,3,6,0.5,0,0,0.0,3,6,0.5,0.5,0,1,0.0,3,3,6,0,0,0,4,7,6
Bryon Russell,SF,27,UTA,82,7,2219,226,525,0.43,73,214,0.341,153,311,0.49200000000000005,0.5,213,278,0.7659999999999999,78,248,326,101,90,31,81,229,738
Arvydas Sabonis*,C,33,POR,73,73,2333,407,826,0.493,30,115,0.261,377,711,0.53,0.511,323,405,0.7979999999999999,149,580,729,218,65,80,190,267,1167
Kevin Salvadori,C,27,SAC,16,0,87,1,13,0.077,0,0,0.0,1,13,0.077,0.077,3,6,0.5,5,15,20,3,0,11,5,12,5
Danny Schayes,C,38,ORL,74,33,1272,155,371,0.418,0,0,0.0,155,371,0.418,0.418,96,119,0.807,97,145,242,44,34,33,61,182,406
Detlef Schrempf,SF,35,SEA,78,78,2742,437,898,0.48700000000000004,61,147,0.415,376,751,0.501,0.521,297,352,0.8440000000000001,135,419,554,341,60,19,168,205,1232
Dennis Scott,SF,29,TOT,81,45,2290,329,828,0.397,125,342,0.365,204,486,0.42,0.473,105,130,0.8079999999999999,47,200,247,153,53,39,104,152,888
Shawnelle Scott,C,25,CLE,41,0,188,16,36,0.444,0,0,0.0,16,36,0.444,0.444,12,18,0.667,20,39,59,8,6,8,10,45,44
Shea Seals,SG,22,LAL,4,0,9,1,8,0.125,0,3,0.0,1,5,0.2,0.125,2,4,0.5,3,1,4,0,1,0,0,1,4
Malik Sealy,SF,27,DET,77,10,1641,216,505,0.428,9,41,0.22,207,464,0.446,0.43700000000000006,150,182,0.8240000000000001,48,171,219,100,65,20,79,156,591
Rony Seikaly,C,32,TOT,56,49,1636,250,579,0.43200000000000005,0,2,0.0,250,577,0.433,0.43200000000000005,246,332,0.741,146,247,393,77,28,43,146,164,746
God Shammgod,PG,21,WAS,20,0,146,19,58,0.32799999999999996,0,2,0.0,19,56,0.33899999999999997,0.32799999999999996,23,30,0.767,2,5,7,36,7,1,21,27,61
Brian Shaw,PG,31,TOT,59,34,1530,154,446,0.345,28,95,0.295,126,351,0.359,0.377,36,52,0.6920000000000001,37,178,215,261,49,17,99,148,372
Dickey Simpkins,PF,25,TOT,40,0,433,48,89,0.539,0,2,0.0,48,87,0.552,0.539,36,70,0.514,27,50,77,33,9,5,32,54,132
Reggie Slater,PF,27,TOR,78,28,1662,211,459,0.46,0,0,0.0,211,459,0.46,0.46,203,322,0.63,134,171,305,74,45,30,102,201,625
Charles Smith,SG,22,TOT,34,0,292,49,125,0.392,15,47,0.319,34,78,0.436,0.452,6,11,0.545,13,14,27,21,12,6,27,24,119
Joe Smith,PF,22,TOT,79,55,2344,464,1070,0.434,0,8,0.0,464,1062,0.43700000000000006,0.434,227,293,0.775,199,272,471,94,62,51,158,263,1155
Michael Smith,PF,25,TOT,48,33,1053,93,194,0.479,0,1,0.0,93,193,0.48200000000000004,0.479,65,103,0.631,120,186,306,88,41,15,51,95,251
Steve Smith,SG,28,ATL,73,73,2857,489,1101,0.444,97,276,0.35100000000000003,392,825,0.475,0.488,389,455,0.855,133,176,309,292,75,29,176,219,1464
Tony Smith,PG,29,MIL,7,0,80,8,24,0.33299999999999996,0,4,0.0,8,20,0.4,0.33299999999999996,3,4,0.75,4,3,7,10,5,2,9,7,19
Rik Smits,C,31,IND,73,69,2085,514,1038,0.495,0,3,0.0,514,1035,0.49700000000000005,0.495,188,240,0.7829999999999999,127,378,505,101,40,88,134,243,1216
Eric Snow,PG,24,TOT,64,0,918,79,184,0.429,2,17,0.11800000000000001,77,167,0.461,0.435,49,71,0.69,19,62,81,177,60,5,63,114,209
Felton Spencer,C,30,GSW,68,0,813,59,129,0.457,0,0,0.0,59,129,0.457,0.457,44,79,0.557,93,133,226,17,23,37,49,175,162
Latrell Sprewell,SG,27,GSW,14,13,547,110,277,0.397,9,48,0.188,101,229,0.441,0.413,70,94,0.745,7,44,51,68,19,5,44,26,299
Jerry Stackhouse,SG-SF,23,TOT,79,37,2545,424,975,0.435,47,195,0.24100000000000002,377,780,0.483,0.45899999999999996,354,450,0.787,105,161,266,241,89,59,224,175,1249
John Starks,SG,32,NYK,82,10,2188,372,947,0.39299999999999996,130,398,0.327,242,549,0.441,0.461,185,235,0.787,48,182,230,219,78,5,143,205,1059
Joe Stephens,SF,25,HOU,7,0,37,10,28,0.35700000000000004,3,10,0.3,7,18,0.389,0.41100000000000003,4,6,0.667,3,3,6,1,2,0,2,2,27
Kebu Stewart,PF,24,PHI,15,0,110,12,26,0.462,0,0,0.0,12,26,0.462,0.462,16,25,0.64,9,22,31,2,5,2,8,13,40
Michael Stewart,C,22,SAC,81,37,1761,155,323,0.48,0,0,0.0,155,323,0.48,0.48,65,142,0.45799999999999996,197,339,536,61,29,195,85,251,375
Bryant Stith,SG,27,DEN,31,15,718,75,225,0.33299999999999996,10,48,0.20800000000000002,65,177,0.36700000000000005,0.35600000000000004,75,86,0.872,15,50,65,50,21,8,35,52,235
John Stockton*,PG,35,UTA,64,64,1858,270,511,0.528,39,91,0.429,231,420,0.55,0.5670000000000001,191,231,0.8270000000000001,35,131,166,543,89,10,161,138,770
Ed Stokes,C,26,TOR,4,0,17,1,3,0.33299999999999996,0,0,0.0,1,3,0.33299999999999996,0.33299999999999996,1,2,0.5,1,3,4,1,1,2,2,4,3
Damon Stoudamire,PG,24,TOT,71,71,2839,448,1091,0.41100000000000003,91,304,0.299,357,787,0.45399999999999996,0.452,238,287,0.8290000000000001,87,211,298,580,113,7,223,150,1225
Erick Strickland,SG,24,DAL,67,19,1505,199,558,0.35700000000000004,48,163,0.294,151,395,0.382,0.4,65,84,0.774,35,126,161,167,56,8,106,140,511
Mark Strickland,PF,27,MIA,51,8,847,145,269,0.539,0,1,0.0,145,268,0.541,0.539,59,82,0.72,80,133,213,26,18,34,47,87,349
Rod Strickland,PG,31,WAS,76,76,3020,490,1130,0.434,12,48,0.25,478,1082,0.442,0.439,357,492,0.726,112,293,405,801,126,25,266,182,1349
Derek Strong,PF,29,ORL,58,8,1638,259,617,0.42,0,4,0.0,259,613,0.423,0.42,218,279,0.7809999999999999,152,275,427,51,31,24,74,122,736
Bob Sura,SG,24,CLE,46,4,942,87,231,0.377,19,60,0.317,68,171,0.39799999999999996,0.418,74,131,0.565,25,69,94,171,44,7,93,113,267
Žan Tabak,C,27,TOT,57,34,984,142,304,0.467,0,1,0.0,142,303,0.469,0.467,23,61,0.377,84,128,212,48,20,38,61,163,307
Johnny Taylor,SF,23,ORL,12,0,108,13,37,0.35100000000000003,1,2,0.5,12,35,0.34299999999999997,0.365,11,16,0.688,4,9,13,1,3,2,8,22,38
Maurice Taylor,PF,21,LAC,71,3,1513,321,675,0.47600000000000003,0,1,0.0,321,674,0.47600000000000003,0.47600000000000003,173,244,0.7090000000000001,118,178,296,53,34,40,107,222,815
Carl Thomas,SG,28,TOT,43,0,426,56,140,0.4,20,59,0.33899999999999997,36,81,0.444,0.47100000000000003,16,25,0.64,10,37,47,19,21,7,18,39,148
John Thomas,PF,22,TOT,54,2,535,55,113,0.48700000000000004,0,0,0.0,55,113,0.48700000000000004,0.48700000000000004,41,54,0.759,48,58,106,17,22,12,46,97,151
Kurt Thomas,PF,25,DAL,5,0,73,17,45,0.37799999999999995,0,0,0.0,17,45,0.37799999999999995,0.37799999999999995,3,3,1.0,8,16,24,3,1,0,10,19,37
Tim Thomas,SF,20,PHI,77,48,1779,306,684,0.447,62,171,0.363,244,513,0.47600000000000003,0.493,171,231,0.74,107,181,288,90,54,17,118,185,845
Brooks Thompson,PG,27,TOT,30,0,167,23,56,0.41100000000000003,9,30,0.3,14,26,0.5379999999999999,0.491,4,8,0.5,1,14,15,27,10,1,16,22,59
Otis Thorpe,PF,35,TOT,74,66,2197,294,624,0.47100000000000003,0,5,0.0,294,619,0.475,0.47100000000000003,164,240,0.6829999999999999,151,386,537,222,48,30,152,238,752
Gary Trent,PF,23,TOT,54,20,1360,241,505,0.47700000000000004,4,12,0.33299999999999996,237,493,0.48100000000000004,0.48100000000000004,144,212,0.679,123,215,338,72,35,27,94,161,630
Nick Van Exel,PG,26,LAL,64,46,2053,311,743,0.419,123,316,0.389,188,427,0.44,0.501,136,172,0.7909999999999999,31,163,194,442,64,6,104,120,881
Keith Van Horn,PF,22,NJN,62,62,2325,446,1047,0.426,69,224,0.308,377,823,0.45799999999999996,0.45899999999999996,258,305,0.846,142,266,408,106,64,25,164,216,1219
David Vaughn,PF,24,TOT,40,2,489,66,148,0.446,0,1,0.0,66,147,0.449,0.446,30,47,0.638,53,99,152,20,15,10,40,83,162
Jacque Vaughn,PG,22,UTA,45,0,419,44,122,0.361,3,8,0.375,41,114,0.36,0.373,48,68,0.706,4,34,38,84,9,1,56,63,139
Loy Vaught,PF,29,LAC,10,6,265,36,84,0.429,0,2,0.0,36,82,0.439,0.429,3,8,0.375,16,49,65,7,4,2,13,33,75
Stojko Vranković,C,34,LAC,65,38,996,79,186,0.425,0,0,0.0,79,186,0.425,0.425,37,65,0.569,71,192,263,36,11,66,46,130,195
Antoine Walker,PF,21,BOS,82,82,3268,722,1705,0.423,91,292,0.312,631,1413,0.447,0.45,305,473,0.645,270,566,836,273,142,60,292,262,1840
Samaki Walker,PF,21,DAL,41,19,1027,156,321,0.486,0,1,0.0,156,320,0.488,0.486,53,97,0.546,96,206,302,24,30,40,61,127,365
Ben Wallace,C,23,WAS,67,16,1124,85,164,0.518,0,0,0.0,85,164,0.518,0.518,35,98,0.35700000000000004,112,212,324,18,61,72,28,116,205
John Wallace,SF,23,TOR,82,36,2361,468,979,0.478,1,2,0.5,467,977,0.478,0.479,210,293,0.7170000000000001,117,256,373,110,62,101,172,239,1147
Rasheed Wallace,PF,23,POR,77,77,2896,466,875,0.5329999999999999,8,39,0.205,458,836,0.5479999999999999,0.537,184,278,0.662,132,346,478,195,75,88,167,268,1124
Rex Walters,SG,27,TOT,38,0,235,24,53,0.45299999999999996,6,22,0.273,18,31,0.581,0.509,26,28,0.929,5,19,24,35,8,1,27,28,80
Charlie Ward,PG,27,NYK,82,82,2317,235,516,0.455,81,215,0.377,154,301,0.512,0.534,91,113,0.805,32,242,274,466,144,37,175,195,642
Eric Washington,SG,23,DEN,66,36,1539,201,498,0.40399999999999997,44,137,0.321,157,361,0.435,0.44799999999999995,65,83,0.7829999999999999,47,80,127,78,53,25,72,143,511
Clarence Weatherspoon,PF,27,TOT,79,49,2325,268,608,0.441,0,0,0.0,268,608,0.441,0.441,200,277,0.722,198,396,594,89,85,74,119,194,736
Spud Webb,PG,34,ORL,4,0,34,5,12,0.41700000000000004,0,1,0.0,5,11,0.455,0.41700000000000004,2,2,1.0,2,1,3,5,1,0,7,6,12
Chris Webber,C,24,WAS,71,71,2809,647,1341,0.48200000000000004,65,205,0.317,582,1136,0.512,0.507,196,333,0.589,176,498,674,273,111,124,185,269,1555
Bubba Wells,SG,23,DAL,39,2,395,48,116,0.414,1,6,0.16699999999999998,47,110,0.42700000000000005,0.418,31,43,0.721,22,46,68,34,15,4,31,40,128
Bill Wennington,C,34,CHI,48,8,467,75,172,0.436,0,0,0.0,75,172,0.436,0.436,17,21,0.81,32,48,80,19,4,5,16,77,167
David Wesley,PG,27,CHH,81,81,2845,383,864,0.44299999999999995,59,170,0.34700000000000003,324,694,0.467,0.47700000000000004,229,288,0.795,49,164,213,529,140,30,226,229,1054
Doug West,SG,30,MIN,38,10,688,64,171,0.374,0,2,0.0,64,169,0.379,0.374,29,40,0.725,23,59,82,45,11,5,21,97,157
Mark West,C,37,IND,15,1,105,10,21,0.47600000000000003,0,0,0.0,10,21,0.47600000000000003,0.47600000000000003,3,6,0.5,6,9,15,2,2,4,8,15,23
DeJuan Wheat,PG,24,MIN,34,0,150,20,50,0.4,8,17,0.47100000000000003,12,33,0.364,0.48,9,15,0.6,3,8,11,25,6,1,9,12,57
Donald Whiteside,PG,28,ATL,3,0,16,1,2,0.5,0,1,0.0,1,1,1.0,0.5,0,2,0.0,0,1,1,1,0,0,1,0,2
Chris Whitney,PG,26,WAS,82,6,1073,126,355,0.355,52,169,0.308,74,186,0.39799999999999996,0.428,118,129,0.915,16,99,115,196,34,6,65,106,422
Gerald Wilkins,SG,34,ORL,72,16,1252,141,434,0.325,29,109,0.266,112,325,0.345,0.358,69,98,0.7040000000000001,16,74,90,78,34,6,79,78,380
Aaron Williams,PF,26,SEA,65,9,757,115,220,0.523,0,1,0.0,115,219,0.525,0.523,66,85,0.7759999999999999,48,99,147,14,19,38,50,119,296
Alvin Williams,SG,23,TOT,54,13,1071,125,282,0.44299999999999995,9,28,0.321,116,254,0.457,0.45899999999999996,65,90,0.722,24,57,81,103,38,3,58,79,324
Brandon Williams,SG,22,GSW,9,2,140,16,50,0.32,3,9,0.33299999999999996,13,41,0.317,0.35,2,4,0.5,4,11,15,3,6,3,9,18,37
Buck Williams,PF,37,NYK,41,6,738,75,149,0.503,0,0,0.0,75,149,0.503,0.503,52,71,0.732,78,105,183,21,17,15,38,93,202
Eric Williams,SF,25,DEN,4,4,145,24,61,0.39299999999999996,0,0,0.0,24,61,0.39299999999999996,0.39299999999999996,31,45,0.6890000000000001,10,11,21,12,4,0,9,9,79
Herb Williams,PF,39,NYK,27,0,178,18,43,0.419,0,0,0.0,18,43,0.419,0.419,1,8,0.125,6,23,29,4,6,9,5,34,37
Hot Rod Williams,C,35,PHO,71,30,1333,95,202,0.47,0,0,0.0,95,202,0.47,0.47,65,93,0.6990000000000001,107,205,312,49,33,60,29,138,255
Jayson Williams,C,29,NJN,65,65,2343,321,645,0.498,0,4,0.0,321,641,0.501,0.498,195,293,0.6659999999999999,443,440,883,67,45,49,95,236,837
Jerome Williams,PF,24,DET,77,3,1305,151,288,0.524,0,1,0.0,151,287,0.526,0.524,108,166,0.6509999999999999,170,209,379,48,51,10,60,144,410
Lorenzo Williams,PF,28,WAS,14,6,111,13,17,0.765,0,0,0.0,13,17,0.765,0.765,0,2,0.0,16,10,26,3,2,3,2,17,26
Micheal Williams,PG,31,MIN,25,0,161,16,48,0.33299999999999996,0,4,0.0,16,44,0.364,0.33299999999999996,32,33,0.97,2,12,14,32,9,2,16,24,64
Monty Williams,SF,26,SAS,72,16,1314,165,368,0.44799999999999995,1,2,0.5,164,366,0.44799999999999995,0.45,122,182,0.67,67,112,179,89,34,24,82,133,453
Scott Williams,C,29,PHI,58,7,801,93,213,0.43700000000000006,0,5,0.0,93,208,0.447,0.43700000000000006,51,63,0.81,87,124,211,29,17,21,30,132,237
Travis Williams,SF,28,CHH,39,0,365,56,119,0.47100000000000003,0,1,0.0,56,118,0.475,0.47100000000000003,24,46,0.522,53,39,92,20,18,5,30,55,136
Walt Williams,SF,27,TOT,59,17,1470,210,544,0.386,80,219,0.365,130,325,0.4,0.46,108,125,0.8640000000000001,50,150,200,122,59,35,92,161,608
Corliss Williamson,SF,24,SAC,79,75,2819,561,1134,0.495,0,9,0.0,561,1125,0.499,0.495,279,443,0.63,162,284,446,230,76,48,199,252,1401
Kevin Willis,PF,35,HOU,81,74,2528,531,1041,0.51,1,7,0.14300000000000002,530,1034,0.513,0.511,242,305,0.7929999999999999,232,447,679,78,55,38,170,235,1305
David Wingate,SG,34,SEA,58,2,546,66,140,0.47100000000000003,3,7,0.429,63,133,0.474,0.48200000000000004,15,29,0.517,19,60,79,37,21,3,37,58,150
Dontonio Wingfield,SF,23,POR,3,0,9,0,3,0.0,0,0,0.0,0,3,0.0,0.0,1,2,0.5,2,2,4,0,0,0,1,2,1
Joe Wolf,PF,33,DEN,57,8,621,40,121,0.331,2,10,0.2,38,111,0.342,0.33899999999999997,5,10,0.5,36,90,126,30,20,7,22,92,87
Lorenzen Wright,C,22,LAC,69,38,2067,241,542,0.445,0,2,0.0,241,540,0.446,0.445,141,214,0.659,180,426,606,55,55,87,81,237,623
Sharone Wright,C,25,TOR,7,0,44,7,14,0.5,0,0,0.0,7,14,0.5,0.5,2,4,0.5,1,8,9,4,0,0,2,7,16
George Zídek,C,24,TOT,12,0,64,7,29,0.24100000000000002,1,2,0.5,6,27,0.222,0.259,14,16,0.875,4,13,17,2,0,2,4,10,29
