Player,Pos,Age,Tm,G,GS,MP,FG,FGA,FG%,3P,3PA,3P%,2P,2PA,2P%,eFG%,FT,FTA,FT%,ORB,DRB,TRB,AST,STL,BLK,TOV,PF,PTS
Mahmoud Abdul-Rauf,PG,27,SAC,75,51,2131,411,924,0.445,94,246,0.382,317,678,0.46799999999999997,0.496,115,136,0.846,16,106,122,189,56,6,119,174,1031
Shareef Abdur-Rahim,PF,20,VAN,80,71,2802,550,1214,0.45299999999999996,7,27,0.259,543,1187,0.457,0.456,387,519,0.746,216,339,555,175,79,79,225,199,1494
Rafael Addison,SF,32,CHH,41,3,355,49,122,0.402,8,20,0.4,41,102,0.402,0.434,22,28,0.7859999999999999,19,26,45,34,8,3,17,52,128
Cory Alexander,PG,23,SAS,80,6,1454,194,490,0.396,94,252,0.373,100,238,0.42,0.49200000000000005,95,129,0.736,29,94,123,254,82,16,146,148,577
Jerome Allen,SG,24,TOT,76,1,943,78,221,0.353,30,93,0.32299999999999995,48,128,0.375,0.42100000000000004,42,72,0.583,25,73,98,152,31,4,69,84,228
Ray Allen*,SG,21,MIL,82,81,2532,390,908,0.43,117,298,0.39299999999999996,273,610,0.44799999999999995,0.494,205,249,0.823,97,229,326,210,75,10,149,218,1102
Derrick Alston,C,24,ATL,2,0,11,0,5,0.0,0,0,0.0,0,5,0.0,0.0,0,2,0.0,3,1,4,0,0,0,0,0,0
Ashraf Amaya,PF,25,WSB,31,0,144,12,40,0.3,1,1,1.0,11,39,0.282,0.313,15,28,0.536,19,33,52,3,7,3,10,29,40
Greg Anderson,C,32,SAS,82,48,1659,130,262,0.496,0,1,0.0,130,261,0.498,0.496,62,93,0.667,157,291,448,34,63,67,73,225,322
Kenny Anderson,PG,26,POR,82,81,3081,485,1137,0.42700000000000005,132,366,0.361,353,771,0.45799999999999996,0.485,334,435,0.768,91,272,363,584,162,15,193,222,1436
Nick Anderson,SG,29,ORL,63,61,2163,288,725,0.397,143,405,0.353,145,320,0.45299999999999996,0.496,38,94,0.40399999999999997,66,238,304,182,120,32,86,160,757
Shandon Anderson,SG,23,UTA,65,0,1066,147,318,0.462,24,47,0.511,123,271,0.45399999999999996,0.5,68,99,0.687,52,127,179,49,27,8,73,113,386
Willie Anderson,SG,30,MIA,28,1,303,29,64,0.45299999999999996,8,19,0.42100000000000004,21,45,0.467,0.516,17,20,0.85,15,27,42,34,14,4,19,36,83
Greg Anthony,PG,29,VAN,65,44,1863,199,507,0.39299999999999996,88,238,0.37,111,269,0.413,0.479,130,178,0.73,25,159,184,407,129,4,129,122,616
B.J. Armstrong,PG,29,GSW,49,17,1020,148,327,0.45299999999999996,25,90,0.278,123,237,0.519,0.491,68,79,0.861,7,67,74,126,25,2,53,56,389
Darrell Armstrong,PG,28,ORL,67,0,1010,132,345,0.38299999999999995,55,181,0.304,77,164,0.47,0.462,92,106,0.868,35,41,76,175,61,9,99,114,411
Vincent Askew,SG,30,TOT,43,0,838,81,186,0.435,7,24,0.292,74,162,0.457,0.45399999999999996,70,88,0.795,25,73,98,90,17,6,46,123,239
Keith Askins,SF,29,MIA,78,30,1773,138,319,0.433,69,172,0.401,69,147,0.469,0.541,39,58,0.672,86,185,271,75,53,19,59,196,384
Stacey Augmon,SG,28,TOT,60,10,942,105,220,0.47700000000000004,0,0,0.0,105,220,0.47700000000000004,0.47700000000000004,69,97,0.711,47,91,138,56,42,17,64,87,279
Isaac Austin,C,27,MIA,82,17,1881,321,639,0.502,0,3,0.0,321,636,0.505,0.502,150,226,0.664,136,342,478,101,45,43,161,244,792
Vin Baker,PF,25,MIL,78,78,3159,632,1251,0.505,15,54,0.278,617,1197,0.515,0.511,358,521,0.687,267,537,804,211,81,112,245,275,1637
Charles Barkley*,PF,33,HOU,53,53,2009,335,692,0.484,58,205,0.28300000000000003,277,487,0.569,0.526,288,415,0.6940000000000001,212,504,716,248,69,25,151,153,1016
Dana Barros,PG,29,BOS,24,8,708,110,253,0.435,43,105,0.41,67,148,0.45299999999999996,0.52,37,43,0.86,5,43,48,81,26,6,39,34,300
Brent Barry,SG,25,LAC,59,0,1094,155,379,0.409,56,173,0.324,99,206,0.48100000000000004,0.483,76,93,0.8170000000000001,30,80,110,154,51,15,76,88,442
Jon Barry,SG,27,ATL,58,8,965,100,246,0.40700000000000003,48,124,0.387,52,122,0.426,0.504,37,46,0.804,26,73,99,115,55,3,59,56,285
Benoit Benjamin,C,32,TOR,4,3,44,5,12,0.41700000000000004,0,0,0.0,5,12,0.41700000000000004,0.41700000000000004,3,4,0.75,3,6,9,1,1,0,2,5,13
Elmer Bennett,PG,26,TOT,9,0,75,6,19,0.316,3,9,0.33299999999999996,3,10,0.3,0.395,7,10,0.7,0,4,4,11,4,0,10,7,22
Travis Best,PG,24,IND,76,46,2064,274,620,0.442,57,155,0.368,217,465,0.467,0.488,149,197,0.7559999999999999,36,130,166,318,98,5,153,221,754
Mookie Blaylock,PG,29,ATL,78,78,3056,501,1159,0.43200000000000005,221,604,0.366,280,555,0.505,0.528,131,174,0.753,114,299,413,463,212,20,185,141,1354
Corie Blount,PF,28,LAL,58,18,1009,92,179,0.514,1,3,0.33299999999999996,91,176,0.517,0.517,56,83,0.675,113,163,276,35,22,26,50,121,241
Muggsy Bogues,PG,32,CHH,65,65,1880,204,443,0.46,60,144,0.41700000000000004,144,299,0.48200000000000004,0.528,54,64,0.8440000000000001,25,116,141,469,82,2,108,114,522
Dexter Boney,SG,26,PHO,8,0,48,6,19,0.316,1,6,0.16699999999999998,5,13,0.385,0.342,6,8,0.75,3,3,6,0,2,1,1,3,19
Melvin Booker,PG,24,TOT,21,4,430,46,105,0.43799999999999994,12,37,0.324,34,68,0.5,0.495,18,20,0.9,7,22,29,53,3,2,27,28,122
Bruce Bowen,SF,25,MIA,1,0,1,0,0,0.0,0,0,0.0,0,0,0.0,0.0,0,0,0.0,0,0,0,0,0,1,0,0,0
Donnie Boyce,SG,23,ATL,22,2,154,21,63,0.33299999999999996,2,16,0.125,19,47,0.40399999999999997,0.349,11,22,0.5,7,8,15,13,10,4,16,17,55
Shawn Bradley,C,24,TOT,73,70,2288,406,905,0.449,0,8,0.0,406,897,0.45299999999999996,0.449,149,228,0.654,221,390,611,52,40,248,134,237,961
Mark Bradtke,C,28,PHI,36,0,251,25,58,0.431,0,0,0.0,25,58,0.431,0.431,9,13,0.6920000000000001,26,42,68,7,5,5,9,34,59
Terrell Brandon,PG,26,CLE,78,78,2868,575,1313,0.43799999999999994,101,271,0.373,474,1042,0.455,0.47600000000000003,268,297,0.902,48,253,301,490,138,30,178,177,1519
Frank Brickowski,PF,37,BOS,17,2,255,32,73,0.43799999999999994,7,20,0.35,25,53,0.47200000000000003,0.486,10,14,0.7140000000000001,6,28,34,15,5,4,19,42,81
Scott Brooks,PG,31,NYK,38,0,251,19,39,0.48700000000000004,5,12,0.41700000000000004,14,27,0.519,0.551,14,15,0.9329999999999999,6,12,18,29,21,0,17,35,57
Chucky Brown,SF,28,TOT,70,1,757,78,154,0.506,1,6,0.16699999999999998,77,148,0.52,0.51,47,70,0.6709999999999999,41,107,148,28,9,22,19,100,204
Dee Brown,PG,28,BOS,21,2,522,61,166,0.36700000000000005,20,65,0.308,41,101,0.406,0.428,18,22,0.818,8,40,48,67,31,7,24,45,160
Marcus Brown,PG,22,POR,21,0,184,28,70,0.4,13,32,0.406,15,38,0.395,0.493,13,19,0.684,4,11,15,20,8,2,13,26,82
Mike Brown,C,33,PHO,6,1,83,5,12,0.41700000000000004,0,0,0.0,5,12,0.41700000000000004,0.41700000000000004,6,10,0.6,9,16,25,5,1,1,2,9,16
P.J. Brown,PF,27,MIA,80,71,2592,300,656,0.457,0,2,0.0,300,654,0.45899999999999996,0.457,161,220,0.732,239,431,670,92,85,98,113,283,761
Randy Brown,PG,28,CHI,72,3,1057,140,333,0.42,4,22,0.182,136,311,0.43700000000000006,0.426,57,84,0.679,34,77,111,133,81,17,58,116,341
Kobe Bryant,SG,18,LAL,71,6,1103,176,422,0.41700000000000004,51,136,0.375,125,286,0.43700000000000006,0.47700000000000004,136,166,0.8190000000000001,47,85,132,91,49,23,112,102,539
Mark Bryant,PF,31,PHO,41,18,1018,152,275,0.5529999999999999,0,0,0.0,152,275,0.5529999999999999,0.5529999999999999,76,108,0.7040000000000001,67,145,212,47,22,5,46,136,380
Jud Buechler,SF,28,CHI,76,0,703,58,158,0.36700000000000005,18,54,0.33299999999999996,40,104,0.385,0.424,5,14,0.35700000000000004,45,81,126,60,23,21,27,50,139
Matt Bullard,PF,29,HOU,71,12,1025,114,284,0.401,67,183,0.366,47,101,0.465,0.519,25,34,0.735,13,104,117,67,21,18,38,68,320
Scott Burrell,SF,26,TOT,57,2,939,98,271,0.36200000000000004,41,116,0.353,57,155,0.368,0.43700000000000006,57,76,0.75,49,109,158,74,28,19,53,120,294
Willie Burton,SF,28,ATL,24,2,380,39,116,0.336,13,46,0.28300000000000003,26,70,0.371,0.392,57,68,0.838,11,30,41,11,8,3,26,55,148
Mitchell Butler,SG,26,POR,49,1,465,52,125,0.41600000000000004,12,39,0.308,40,86,0.465,0.46399999999999997,32,50,0.64,19,34,53,30,13,2,27,55,148
Jason Caffey,PF,23,CHI,75,19,1405,205,385,0.532,0,1,0.0,205,384,0.534,0.532,139,211,0.659,135,166,301,89,25,9,97,149,549
Michael Cage,C,35,PHI,82,24,1247,66,141,0.46799999999999997,0,0,0.0,66,141,0.46799999999999997,0.46799999999999997,19,41,0.46299999999999997,112,208,320,43,48,42,17,118,151
Adrian Caldwell,PF,30,TOT,45,0,569,40,92,0.435,0,2,0.0,40,90,0.444,0.435,21,50,0.42,58,109,167,12,16,8,28,87,101
Marcus Camby,C,22,TOR,63,38,1897,375,778,0.48200000000000004,2,14,0.14300000000000002,373,764,0.488,0.483,183,264,0.693,131,263,394,97,66,130,134,214,935
Elden Campbell,PF,28,LAL,77,77,2516,442,942,0.469,1,4,0.25,441,938,0.47,0.47,263,370,0.711,207,408,615,126,46,117,130,276,1148
Antoine Carr,PF,35,UTA,82,0,1460,252,522,0.483,0,3,0.0,252,519,0.486,0.483,99,127,0.78,60,135,195,74,24,63,75,214,603
Chris Carr,SG,22,MIN,55,10,830,125,271,0.461,31,88,0.35200000000000004,94,183,0.514,0.518,56,73,0.767,31,82,113,48,24,10,37,93,337
Jimmy Carruth,PF,27,MIL,4,0,21,2,3,0.667,0,0,0.0,2,3,0.667,0.667,1,1,1.0,0,4,4,0,0,2,1,4,5
Sam Cassell,PG,27,TOT,61,44,1714,337,783,0.43,81,231,0.35100000000000003,256,552,0.46399999999999997,0.48200000000000004,212,251,0.845,47,135,182,305,77,19,168,200,967
Duane Causwell,C,28,SAC,46,8,581,48,94,0.511,2,3,0.667,46,91,0.505,0.521,20,37,0.541,57,70,127,20,15,38,34,131,118
Cedric Ceballos,SF,27,TOT,50,40,1426,282,617,0.457,26,102,0.255,256,515,0.49700000000000005,0.478,139,186,0.747,102,228,330,64,33,23,85,113,729
Tom Chambers,PF,37,CHH,12,5,83,7,31,0.226,2,3,0.667,5,28,0.179,0.258,3,4,0.75,3,11,14,4,1,0,9,14,19
Rex Chapman,SG,29,PHO,65,33,1833,332,749,0.44299999999999995,110,314,0.35,222,435,0.51,0.517,124,149,0.8320000000000001,25,156,181,182,52,7,96,108,898
Calbert Cheaney,SG,25,WSB,79,79,2411,369,730,0.505,4,30,0.133,365,700,0.521,0.508,95,137,0.693,70,198,268,114,77,18,94,226,837
Pete Chilcutt,PF,28,VAN,54,1,662,72,165,0.436,25,69,0.36200000000000004,47,96,0.49,0.512,13,22,0.591,67,89,156,47,26,17,28,52,182
Randolph Childress,PG,24,TOT,23,0,155,14,40,0.35,5,19,0.263,9,21,0.429,0.413,6,8,0.75,1,5,6,17,9,0,18,16,39
Chris Childs,PG,29,NYK,65,61,2076,211,510,0.414,70,181,0.387,141,329,0.429,0.48200000000000004,113,149,0.758,22,169,191,398,78,11,180,213,605
Doug Christie,SG,26,TOR,81,81,3127,396,949,0.41700000000000004,147,383,0.384,249,566,0.44,0.495,237,306,0.775,85,347,432,315,201,45,200,245,1176
Derrick Coleman,PF,29,PHI,57,54,2102,364,836,0.435,32,119,0.26899999999999996,332,717,0.46299999999999997,0.455,272,365,0.745,157,416,573,193,50,75,184,164,1032
Bimbo Coles,PG,28,GSW,51,13,1183,122,314,0.389,30,102,0.294,92,212,0.434,0.436,37,49,0.755,39,79,118,149,35,7,59,96,311
Marty Conlon,C,29,BOS,74,15,1614,214,454,0.47100000000000003,2,10,0.2,212,444,0.47700000000000004,0.474,144,171,0.8420000000000001,128,195,323,104,46,18,109,154,574
Tyrone Corbin,SF,34,ATL,70,65,2305,253,600,0.42200000000000004,74,208,0.35600000000000004,179,392,0.457,0.483,86,108,0.7959999999999999,76,218,294,124,90,7,85,176,666
Joe Courtney,PF,27,TOT,9,0,100,11,30,0.36700000000000005,0,0,0.0,11,30,0.36700000000000005,0.36700000000000005,3,5,0.6,9,7,16,0,0,0,3,14,25
John Crotty,PG,27,MIA,48,0,659,79,154,0.513,20,49,0.408,59,105,0.562,0.578,54,64,0.8440000000000001,15,32,47,102,18,0,42,79,232
Terry Cummings,PF,35,SEA,45,3,828,155,319,0.486,3,5,0.6,152,314,0.484,0.491,57,82,0.695,70,113,183,39,33,7,45,113,370
Earl Cureton,PF,39,TOR,9,0,46,3,8,0.375,0,0,0.0,3,8,0.375,0.375,1,3,0.33299999999999996,4,5,9,4,0,0,1,10,7
Dell Curry,SG,32,CHH,68,20,2078,384,836,0.45899999999999996,126,296,0.426,258,540,0.478,0.535,114,142,0.8029999999999999,40,171,211,118,60,14,93,147,1008
Michael Curry,SG,28,DET,81,2,1217,99,221,0.44799999999999995,23,77,0.299,76,144,0.528,0.5,97,108,0.898,23,96,119,43,31,12,28,128,318
Erick Dampier,C,21,IND,72,21,1052,131,336,0.39,1,1,1.0,130,335,0.38799999999999996,0.391,107,168,0.637,96,198,294,43,19,73,84,153,370
Lloyd Daniels,SG,29,TOT,22,0,310,36,119,0.303,21,70,0.3,15,49,0.306,0.391,5,6,0.833,19,24,43,26,10,3,14,33,98
Sasha Danilović,SG,26,TOT,56,42,1789,248,570,0.435,85,236,0.36,163,334,0.488,0.51,121,151,0.8009999999999999,29,107,136,102,54,9,116,160,702
Yinka Dare,C,24,NJN,41,2,313,19,54,0.35200000000000004,0,0,0.0,19,54,0.35200000000000004,0.35200000000000004,19,37,0.514,35,47,82,3,4,28,21,51,57
Antonio Davis,PF,28,IND,82,28,2335,308,641,0.48,1,14,0.071,307,627,0.49,0.48100000000000004,241,362,0.6659999999999999,190,408,598,65,42,84,141,260,858
Ben Davis,PF,24,PHO,20,0,98,10,26,0.385,0,0,0.0,10,26,0.385,0.385,9,20,0.45,12,15,27,0,4,1,3,16,29
Dale Davis,PF,27,IND,80,76,2589,370,688,0.5379999999999999,0,0,0.0,370,688,0.5379999999999999,0.5379999999999999,92,215,0.428,301,471,772,59,60,77,108,233,832
Emanual Davis,PG,28,HOU,13,0,230,24,54,0.444,12,27,0.444,12,27,0.444,0.556,5,8,0.625,2,20,22,26,9,2,17,20,65
Hubert Davis,SG,26,TOR,36,0,623,74,184,0.402,16,70,0.22899999999999998,58,114,0.509,0.446,17,23,0.7390000000000001,11,29,40,34,11,2,21,40,181
Mark Davis,SF,23,PHI,75,17,1705,251,535,0.469,24,93,0.258,227,442,0.514,0.49200000000000005,113,168,0.6729999999999999,138,185,323,135,85,31,118,230,639
Todd Day,SG,27,BOS,81,27,2277,398,999,0.39799999999999996,126,348,0.36200000000000004,272,651,0.418,0.461,256,331,0.773,109,221,330,117,108,48,127,208,1178
Andrew DeClercq,C,23,GSW,71,1,1065,142,273,0.52,0,0,0.0,142,273,0.52,0.52,91,151,0.603,122,176,298,32,33,27,76,229,375
Terry Dehere,PG,25,LAC,73,3,1053,148,383,0.386,52,160,0.325,96,223,0.43,0.45399999999999996,122,148,0.8240000000000001,15,80,95,158,27,3,96,142,470
Vinny Del Negro,SG,30,SAS,72,53,2243,365,781,0.467,44,140,0.314,321,641,0.501,0.496,112,129,0.868,39,171,210,231,59,7,92,131,886
Bison Dele,C,27,CHI,9,0,138,26,63,0.413,0,0,0.0,26,63,0.413,0.413,11,15,0.733,14,19,33,12,3,5,11,20,63
Tony Delk,PG,23,CHH,61,1,867,119,256,0.465,52,112,0.46399999999999997,67,144,0.465,0.5660000000000001,42,51,0.8240000000000001,31,68,99,99,36,6,68,71,332
Dell Demps,SG,26,ORL,2,0,10,0,3,0.0,0,1,0.0,0,2,0.0,0.0,2,2,1.0,0,0,0,0,1,0,0,1,2
Vlade Divac*,C,28,CHH,81,80,2840,418,847,0.494,11,47,0.23399999999999999,407,800,0.509,0.5,177,259,0.6829999999999999,241,484,725,301,103,180,193,277,1024
Sherman Douglas,PG,30,MIL,79,79,2316,306,610,0.502,38,114,0.33299999999999996,268,496,0.54,0.5329999999999999,114,171,0.667,57,136,193,427,78,10,153,191,764
Greg Dreiling,C,34,DAL,40,3,389,34,74,0.45899999999999996,1,1,1.0,33,73,0.452,0.466,11,27,0.40700000000000003,19,57,76,11,8,7,9,65,80
Clyde Drexler*,SG,34,HOU,62,62,2271,397,899,0.442,119,335,0.355,278,564,0.493,0.508,201,268,0.75,118,255,373,354,119,36,156,151,1114
Nate Driggers,SG,23,BOS,15,0,132,13,43,0.302,0,9,0.0,13,34,0.382,0.302,10,14,0.7140000000000001,12,10,22,6,3,2,6,10,36
Kevin Duckworth,C,32,LAC,26,22,384,45,103,0.43700000000000006,3,4,0.75,42,99,0.424,0.451,11,16,0.688,23,37,60,16,9,11,33,63,104
Chris Dudley,C,31,POR,81,14,1840,126,293,0.43,0,0,0.0,126,293,0.43,0.43,65,137,0.474,204,389,593,41,39,96,80,247,317
Joe Dumars*,SG,33,DET,79,79,2923,385,875,0.44,166,384,0.43200000000000005,219,491,0.446,0.535,222,256,0.867,38,153,191,318,57,1,128,97,1158
Tony Dumas,SG,24,TOT,24,1,278,33,96,0.344,4,28,0.14300000000000002,29,68,0.426,0.365,16,25,0.64,3,13,16,25,10,2,16,45,86
Acie Earl,C,26,TOT,47,0,500,67,180,0.37200000000000005,0,5,0.0,67,175,0.38299999999999995,0.37200000000000005,54,84,0.643,35,61,96,20,15,28,35,61,188
Tyus Edney,PG,23,SAC,70,20,1376,150,391,0.384,8,42,0.19,142,349,0.40700000000000003,0.39399999999999996,177,215,0.823,34,79,113,226,60,2,112,98,485
Blue Edwards,SF,31,VAN,61,12,1439,182,458,0.397,25,89,0.281,157,369,0.425,0.425,89,109,0.8170000000000001,49,140,189,114,38,20,81,135,478
Kevin Edwards,PG,31,NJN,32,0,477,69,183,0.377,15,43,0.349,54,140,0.386,0.418,37,43,0.86,9,34,43,57,17,4,49,34,190
Craig Ehlo,SG,35,SEA,62,0,848,87,248,0.35100000000000003,27,95,0.284,60,153,0.392,0.405,13,26,0.5,39,71,110,68,36,4,45,71,214
Howard Eisley,PG,24,UTA,82,0,1083,139,308,0.451,20,72,0.278,119,236,0.504,0.484,70,89,0.787,20,64,84,198,44,10,110,141,368
Mario Elie,SF,33,HOU,78,77,2687,291,585,0.49700000000000005,120,286,0.42,171,299,0.5720000000000001,0.6,207,231,0.8959999999999999,60,175,235,310,92,12,135,200,909
Sean Elliott,SF,28,SAS,39,39,1393,196,464,0.42200000000000004,42,126,0.33299999999999996,154,338,0.456,0.46799999999999997,148,196,0.755,48,142,190,124,24,24,89,105,582
Dale Ellis,SF,36,DEN,82,51,2940,477,1151,0.414,192,528,0.364,285,623,0.457,0.498,215,263,0.8170000000000001,99,194,293,165,60,7,146,178,1361
LaPhonso Ellis,PF,26,DEN,55,49,2002,445,1014,0.439,95,259,0.36700000000000005,350,755,0.46399999999999997,0.486,218,282,0.773,107,279,386,131,44,41,117,181,1203
Pervis Ellison,PF,29,BOS,6,4,125,6,16,0.375,0,0,0.0,6,16,0.375,0.375,3,5,0.6,9,17,26,4,5,9,7,21,15
Brian Evans,SF,23,ORL,14,0,59,8,22,0.364,4,8,0.5,4,14,0.28600000000000003,0.455,0,0,0.0,1,7,8,7,1,2,2,6,20
Patrick Ewing*,C,34,NYK,78,78,2887,655,1342,0.488,2,9,0.222,653,1333,0.49,0.489,439,582,0.754,175,659,834,156,69,189,269,250,1751
Jamie Feick,PF-C,22,TOT,41,0,624,56,157,0.35700000000000004,5,14,0.35700000000000004,51,143,0.35700000000000004,0.373,34,67,0.507,82,132,214,26,16,14,31,78,151
Duane Ferrell,SF,31,IND,62,18,1115,159,337,0.47200000000000003,18,44,0.409,141,293,0.48100000000000004,0.499,58,94,0.617,57,84,141,66,38,6,55,120,394
Danny Ferry,PF,30,CLE,82,48,2633,341,794,0.429,114,284,0.401,227,510,0.445,0.501,74,87,0.851,82,255,337,151,56,32,94,245,870
Michael Finley,SF,23,TOT,83,54,2790,475,1071,0.444,101,280,0.361,374,791,0.473,0.491,198,245,0.8079999999999999,88,284,372,224,68,24,164,138,1249
Matt Fish,C,27,TOT,6,0,8,1,3,0.33299999999999996,0,0,0.0,1,3,0.33299999999999996,0.33299999999999996,0,0,0.0,1,4,5,0,0,0,2,2,2
Derek Fisher,PG,22,LAL,80,3,921,104,262,0.397,22,73,0.301,82,189,0.434,0.439,79,120,0.6579999999999999,25,72,97,119,41,5,71,87,309
Greg Foster,C,28,UTA,79,12,920,111,245,0.45299999999999996,2,3,0.667,109,242,0.45,0.457,54,65,0.831,56,131,187,31,10,20,54,145,278
Rick Fox,SF,27,BOS,76,75,2650,433,950,0.456,101,278,0.363,332,672,0.494,0.509,207,263,0.787,114,280,394,286,167,40,178,279,1174
Todd Fuller,C,22,GSW,75,18,949,114,266,0.429,0,0,0.0,114,266,0.429,0.429,76,110,0.691,108,141,249,24,10,20,52,146,304
Kevin Gamble,SF,31,SAC,62,2,953,123,286,0.43,54,112,0.48200000000000004,69,174,0.397,0.524,7,10,0.7,13,94,107,77,21,17,27,76,307
Kevin Garnett,SF,20,MIN,77,77,2995,549,1100,0.499,6,21,0.28600000000000003,543,1079,0.503,0.502,205,272,0.754,190,428,618,236,105,163,175,199,1309
Dean Garrett,C,30,MIN,68,47,1665,223,389,0.573,0,0,0.0,223,389,0.573,0.573,96,138,0.696,149,346,495,38,40,95,34,158,542
Chris Gatling,PF,29,TOT,47,1,1283,327,623,0.525,1,6,0.16699999999999998,326,617,0.528,0.526,236,329,0.7170000000000001,134,236,370,28,39,31,120,138,891
Reggie Geary,PG,23,CLE,39,0,246,22,58,0.379,8,21,0.381,14,37,0.37799999999999995,0.44799999999999995,5,11,0.455,4,11,15,36,13,2,15,36,57
Matt Geiger,C,27,CHH,49,13,1044,171,350,0.489,6,20,0.3,165,330,0.5,0.49700000000000005,89,127,0.701,100,158,258,38,20,27,67,153,437
Kendall Gill,SF,28,NJN,82,81,3199,644,1453,0.44299999999999995,74,220,0.336,570,1233,0.462,0.469,427,536,0.797,183,316,499,326,154,46,218,225,1789
Armen Gilliam,PF,32,MIL,80,25,2050,246,522,0.47100000000000003,0,0,0.0,246,522,0.47100000000000003,0.47100000000000003,199,259,0.768,136,361,497,53,61,40,105,206,691
Anthony Goldwire,PG,25,TOT,60,30,1188,131,330,0.397,64,153,0.418,67,177,0.379,0.494,61,78,0.782,12,72,84,219,33,2,76,104,387
Greg Graham,SG,26,SEA,28,0,197,29,80,0.363,9,31,0.29,20,49,0.408,0.419,26,40,0.65,2,11,13,11,12,1,10,12,93
Brian Grant,PF,24,SAC,24,15,607,91,207,0.44,0,0,0.0,91,207,0.44,0.44,70,90,0.778,49,93,142,28,19,25,44,75,252
Gary Grant,PG,31,MIA,28,0,365,39,110,0.355,14,46,0.304,25,64,0.391,0.418,18,22,0.818,8,30,38,45,16,0,27,39,110
Harvey Grant,PF,31,WSB,78,25,1604,129,314,0.41100000000000003,28,89,0.315,101,225,0.449,0.455,30,39,0.769,63,193,256,68,46,48,30,167,316
Horace Grant,PF,31,ORL,67,67,2496,358,695,0.515,1,6,0.16699999999999998,357,689,0.518,0.516,128,179,0.715,206,394,600,163,101,65,99,157,845
Devin Gray,PF,24,TOT,6,0,49,8,26,0.308,0,0,0.0,8,26,0.308,0.308,2,5,0.4,6,8,14,2,4,0,5,11,18
Evric Gray,SF,27,NJN,5,0,42,4,15,0.267,1,4,0.25,3,11,0.273,0.3,4,4,1.0,1,2,3,2,1,0,3,5,13
Jeff Grayer,SG,31,SAC,25,0,316,38,83,0.45799999999999996,4,11,0.364,34,72,0.47200000000000003,0.48200000000000004,11,20,0.55,21,17,38,25,8,7,15,42,91
A.C. Green,PF,33,TOT,83,73,2492,234,484,0.483,1,20,0.05,233,464,0.502,0.485,128,197,0.65,222,434,656,69,70,16,74,145,597
Litterial Green,PG,26,DET,45,0,311,30,64,0.469,0,10,0.0,30,54,0.556,0.469,30,47,0.638,6,16,22,41,16,1,15,27,90
Tom Gugliotta,PF,27,MIN,81,81,3131,592,1339,0.442,24,93,0.258,568,1246,0.456,0.451,464,566,0.82,187,515,702,335,130,89,293,237,1672
Jack Haley,C,33,NJN,20,0,74,13,37,0.35100000000000003,0,0,0.0,13,37,0.35100000000000003,0.35100000000000003,14,19,0.737,13,19,32,5,1,1,2,14,40
Darvin Ham,SF,23,TOT,36,3,318,33,62,0.532,0,0,0.0,33,62,0.532,0.532,17,35,0.486,29,27,56,14,9,8,22,57,83
Steve Hamer,C,23,BOS,35,3,268,30,57,0.526,0,2,0.0,30,55,0.545,0.526,16,29,0.552,17,43,60,7,2,4,13,39,76
Tom Hammonds,PF,29,DEN,81,8,1758,191,398,0.48,0,2,0.0,191,396,0.48200000000000004,0.48,124,172,0.721,135,266,401,64,16,24,88,205,506
Darrin Hancock,SF,25,TOT,24,0,133,16,35,0.457,0,0,0.0,16,35,0.457,0.457,10,14,0.7140000000000001,4,14,18,12,9,1,11,15,42
Anfernee Hardaway,PG,25,ORL,59,59,2221,421,941,0.447,85,267,0.318,336,674,0.499,0.493,283,345,0.82,82,181,263,332,93,35,145,123,1210
Tim Hardaway,PG,30,MIA,81,81,3136,575,1384,0.415,203,590,0.344,372,794,0.469,0.489,291,364,0.799,49,228,277,695,151,9,230,165,1644
Derek Harper,PG,35,DAL,75,29,2210,299,674,0.444,60,176,0.341,239,498,0.48,0.488,95,128,0.742,30,107,137,321,92,12,132,144,753
Ron Harper,PG,33,CHI,76,74,1740,177,406,0.436,68,188,0.36200000000000004,109,218,0.5,0.52,58,82,0.7070000000000001,46,147,193,191,86,38,50,138,480
Othella Harrington,PF,23,HOU,57,1,860,112,204,0.5489999999999999,0,3,0.0,112,201,0.557,0.5489999999999999,49,81,0.605,75,123,198,18,12,22,57,112,273
Lucious Harris,SG,26,PHI,54,3,813,112,294,0.381,36,99,0.364,76,195,0.39,0.442,33,47,0.7020000000000001,27,44,71,50,41,3,34,45,293
Antonio Harvey,PF,26,SEA,6,0,26,5,11,0.455,0,0,0.0,5,11,0.455,0.455,5,6,0.833,2,8,10,1,0,4,1,8,15
Hersey Hawkins,SG,30,SEA,82,82,2755,369,795,0.46399999999999997,143,355,0.40299999999999997,226,440,0.514,0.5539999999999999,258,295,0.875,92,228,320,250,159,12,130,146,1139
Michael Hawkins,PG,24,BOS,29,0,326,29,68,0.426,10,31,0.32299999999999995,19,37,0.514,0.5,12,15,0.8,9,22,31,64,16,1,28,40,80
Shane Heal,PG,26,MIN,43,0,236,26,97,0.268,20,65,0.308,6,32,0.188,0.371,3,5,0.6,2,16,18,33,3,3,17,20,75
Alan Henderson,PF,24,ATL,30,0,501,77,162,0.475,0,0,0.0,77,162,0.475,0.475,45,75,0.6,47,69,116,23,21,6,29,73,199
Mark Hendrickson,PF,22,PHI,29,1,301,32,77,0.41600000000000004,3,12,0.25,29,65,0.446,0.435,18,26,0.6920000000000001,35,57,92,3,10,4,14,32,85
Carl Herrera,PF,30,SAS,75,58,1837,257,593,0.433,2,6,0.33299999999999996,255,587,0.434,0.435,81,118,0.6859999999999999,118,222,340,50,62,53,95,217,597
Grant Hill*,SF,24,DET,80,80,3147,625,1259,0.496,10,33,0.303,615,1226,0.502,0.5,450,633,0.711,123,598,721,583,144,48,259,186,1710
Tyrone Hill,C,28,CLE,74,70,2582,357,595,0.6,0,1,0.0,357,594,0.601,0.6,241,381,0.633,259,477,736,92,63,30,147,268,955
Fred Hoiberg,SG,24,IND,47,0,572,67,156,0.429,29,70,0.414,38,86,0.442,0.522,61,77,0.792,13,68,81,41,27,6,22,51,224
Jeff Hornacek,SG,33,UTA,82,82,2592,413,856,0.48200000000000004,72,195,0.369,341,661,0.516,0.525,293,326,0.899,60,181,241,361,124,26,134,188,1191
Robert Horry,SF,26,TOT,54,29,1395,157,360,0.436,49,154,0.318,108,206,0.524,0.504,60,90,0.667,68,169,237,110,66,55,72,153,423
Allan Houston,SG,25,NYK,81,81,2681,437,1032,0.423,148,384,0.385,289,648,0.446,0.495,175,218,0.8029999999999999,43,197,240,179,41,18,167,233,1197
Juwan Howard,SF,23,WSB,82,82,3324,638,1313,0.486,0,2,0.0,638,1311,0.48700000000000004,0.486,294,389,0.7559999999999999,202,450,652,311,93,23,246,259,1570
Stephen Howard,SF,26,TOT,49,0,418,62,108,0.574,0,0,0.0,62,108,0.574,0.574,52,81,0.642,29,56,85,11,19,12,25,62,176
Lindsey Hunter,PG,26,DET,82,76,3023,421,1042,0.40399999999999997,166,468,0.355,255,574,0.444,0.484,158,203,0.778,59,174,233,154,129,24,96,206,1166
Bobby Hurley,PG,25,SAC,49,12,632,46,125,0.368,14,45,0.311,32,80,0.4,0.424,37,53,0.698,9,29,38,146,27,3,55,53,143
Allen Iverson*,PG,21,PHI,76,74,3045,625,1504,0.41600000000000004,155,455,0.341,470,1049,0.44799999999999995,0.467,382,544,0.7020000000000001,115,197,312,567,157,24,337,233,1787
Jaren Jackson,SG,29,WSB,75,0,1133,134,329,0.40700000000000003,53,158,0.335,81,171,0.474,0.488,53,69,0.768,31,101,132,65,45,16,60,131,374
Jim Jackson,SG-SF,26,TOT,77,77,2831,444,1029,0.431,86,247,0.348,358,782,0.45799999999999996,0.473,252,310,0.813,132,279,411,316,86,32,208,194,1226
Mark Jackson,PG,31,TOT,82,82,3054,289,679,0.426,66,178,0.371,223,501,0.445,0.474,168,213,0.789,91,304,395,935,97,12,274,161,812
Henry James,PF,31,ATL,53,15,945,125,306,0.408,76,181,0.42,49,125,0.392,0.5329999999999999,30,36,0.833,27,54,81,21,11,1,29,98,356
Chris Jent,SF,27,NYK,3,0,10,2,6,0.33299999999999996,2,3,0.667,0,3,0.0,0.5,0,0,0.0,1,0,1,1,0,0,0,2,6
Avery Johnson,PG,31,SAS,76,76,2472,327,685,0.47700000000000004,6,26,0.231,321,659,0.48700000000000004,0.48200000000000004,140,203,0.69,32,115,147,513,96,15,146,158,800
Eddie Johnson,SF,37,TOT,52,2,913,160,362,0.442,49,131,0.374,111,231,0.48100000000000004,0.51,55,68,0.809,27,111,138,52,15,2,47,81,424
Ervin Johnson,C,29,DEN,82,82,2599,243,467,0.52,0,2,0.0,243,465,0.523,0.52,96,156,0.615,231,682,913,71,65,227,118,288,582
Kevin Johnson,PG,30,PHO,70,70,2658,441,890,0.496,89,202,0.441,352,688,0.512,0.546,439,515,0.852,54,199,253,653,102,12,217,141,1410
Larry Johnson,SF,27,NYK,76,76,2613,376,735,0.512,34,105,0.324,342,630,0.5429999999999999,0.535,190,274,0.693,165,228,393,174,64,36,136,249,976
Charles Jones,PF,39,HOU,12,0,93,2,5,0.4,0,0,0.0,2,5,0.4,0.4,0,0,0.0,5,8,13,3,2,4,0,8,4
Eddie Jones,SG,25,LAL,80,80,2998,473,1081,0.43799999999999994,152,389,0.391,321,692,0.46399999999999997,0.508,276,337,0.8190000000000001,90,236,326,270,189,49,169,226,1374
Popeye Jones,PF,26,TOR,79,61,2421,258,537,0.48,1,13,0.077,257,524,0.49,0.48100000000000004,99,121,0.818,270,410,680,84,58,39,116,269,616
Michael Jordan*,SG,33,CHI,82,82,3106,920,1892,0.486,111,297,0.374,809,1595,0.507,0.516,480,576,0.833,113,369,482,352,140,44,166,156,2431
Reggie Jordan,SG,29,TOT,19,0,130,16,26,0.615,0,0,0.0,16,26,0.615,0.615,8,17,0.47100000000000003,11,16,27,12,7,3,8,15,40
Adam Keefe,C,26,UTA,62,0,915,82,160,0.513,0,1,0.0,82,159,0.516,0.513,71,103,0.6890000000000001,75,141,216,32,30,13,45,97,235
Shawn Kemp,PF,27,SEA,81,75,2750,526,1032,0.51,12,33,0.364,514,999,0.515,0.516,452,609,0.742,275,532,807,156,125,81,280,320,1516
Tim Kempton,PF,33,SAS,10,0,59,1,5,0.2,0,0,0.0,1,5,0.2,0.2,2,2,1.0,3,5,8,2,1,1,7,4,4
Steve Kerr,PG,31,CHI,82,0,1861,249,467,0.5329999999999999,110,237,0.46399999999999997,139,230,0.604,0.6509999999999999,54,67,0.8059999999999999,29,101,130,175,67,3,43,98,662
Jerome Kersey,SF,34,LAL,70,44,1766,194,449,0.43200000000000005,17,65,0.262,177,384,0.461,0.451,71,118,0.602,112,251,363,89,119,49,74,219,476
Jason Kidd*,PG,23,TOT,55,45,1964,213,529,0.40299999999999997,61,165,0.37,152,364,0.418,0.46,112,165,0.679,64,185,249,496,124,20,142,114,599
Frankie King,SG,24,PHI,7,0,59,7,17,0.41200000000000003,1,2,0.5,6,15,0.4,0.441,5,5,1.0,4,10,14,5,4,0,3,7,20
Jimmy King,SG,23,DEN,2,0,22,2,6,0.33299999999999996,0,0,0.0,2,6,0.33299999999999996,0.33299999999999996,2,4,0.5,2,0,2,2,3,0,1,2,6
Stacey King,C,30,TOT,11,0,103,11,22,0.5,0,0,0.0,11,22,0.5,0.5,2,7,0.28600000000000003,11,16,27,1,2,1,6,14,24
Kerry Kittles,SG,22,NJN,82,57,3012,507,1189,0.426,158,419,0.377,349,770,0.45299999999999996,0.493,175,227,0.7709999999999999,106,213,319,249,157,35,127,165,1347
Joe Kleine,C,35,TOT,59,10,848,69,170,0.406,2,3,0.667,67,167,0.401,0.41200000000000003,28,38,0.737,62,141,203,35,17,18,41,110,168
Travis Knight,C,22,LAL,71,14,1156,140,275,0.509,0,0,0.0,140,275,0.509,0.509,62,100,0.62,130,189,319,39,31,58,49,170,342
Larry Krystkowiak,PF,32,LAL,3,0,11,1,2,0.5,0,0,0.0,1,2,0.5,0.5,1,2,0.5,2,3,5,3,2,0,1,3,3
Toni Kukoč,SF,28,CHI,57,15,1610,285,605,0.47100000000000003,50,151,0.331,235,454,0.518,0.512,134,174,0.77,94,167,261,256,60,29,91,97,754
Christian Laettner,PF,27,ATL,82,82,3140,548,1128,0.486,31,88,0.35200000000000004,517,1040,0.49700000000000005,0.5,359,440,0.816,212,508,720,223,102,64,218,277,1486
Andrew Lang,C,30,MIL,52,52,1194,115,248,0.46399999999999997,0,0,0.0,115,248,0.46399999999999997,0.46399999999999997,44,61,0.721,94,184,278,25,26,47,39,140,274
Antonio Lang,PF,24,CLE,64,1,843,68,162,0.42,0,6,0.0,68,156,0.436,0.42,35,48,0.7290000000000001,52,75,127,33,33,30,50,111,171
Priest Lauderdale,C,23,ATL,35,0,180,49,89,0.551,0,1,0.0,49,88,0.557,0.551,13,23,0.565,16,27,43,12,1,9,37,39,111
Eric Leckner,C,30,TOT,20,1,126,14,33,0.424,0,0,0.0,14,33,0.424,0.424,6,12,0.5,5,31,36,5,3,2,10,35,34
Tim Legler,SG,30,WSB,15,0,182,15,48,0.313,8,29,0.276,7,19,0.368,0.396,6,7,0.857,0,21,21,7,3,5,9,21,44
Voshon Lenard,SG,23,MIA,73,47,2111,314,684,0.45899999999999996,183,442,0.414,131,242,0.541,0.593,86,105,0.8190000000000001,38,179,217,161,50,18,109,168,897
Martin Lewis,SF,21,TOR,9,0,50,6,14,0.429,1,3,0.33299999999999996,5,11,0.455,0.46399999999999997,1,2,0.5,4,2,6,4,1,2,1,8,14
Alton Lister,C,38,BOS,53,2,516,32,77,0.41600000000000004,0,0,0.0,32,77,0.41600000000000004,0.41600000000000004,23,31,0.742,66,102,168,13,8,14,30,95,87
Randy Livingston,PG,21,HOU,64,0,981,100,229,0.43700000000000006,9,22,0.409,91,207,0.44,0.456,42,65,0.6459999999999999,32,62,94,155,39,12,102,107,251
Horacio Llamas Grey,C,23,PHO,20,2,101,15,28,0.536,0,0,0.0,15,28,0.536,0.536,4,8,0.5,4,14,18,4,10,5,11,25,34
Brad Lohaus,PF,32,TOR,6,0,45,4,15,0.267,2,7,0.28600000000000003,2,8,0.25,0.33299999999999996,0,0,0.0,1,6,7,1,1,0,1,6,10
Grant Long,PF,30,DET,65,24,1166,123,275,0.447,17,47,0.36200000000000004,106,228,0.465,0.478,63,84,0.75,88,134,222,39,43,6,48,106,326
John Long,SG,40,TOR,32,0,370,46,117,0.39299999999999996,12,34,0.353,34,83,0.41,0.444,25,28,0.893,6,34,40,21,9,2,24,28,129
Luc Longley,C,28,CHI,59,59,1472,221,485,0.456,0,2,0.0,221,483,0.45799999999999996,0.456,95,120,0.792,121,211,332,141,23,66,111,191,537
George Lynch,SF,26,VAN,41,27,1059,137,291,0.47100000000000003,8,31,0.258,129,260,0.496,0.485,60,97,0.619,98,163,261,76,63,17,64,97,342
Sam Mack,SF,26,HOU,52,10,904,105,262,0.401,47,142,0.331,58,120,0.483,0.49,35,42,0.833,20,86,106,58,29,6,42,67,292
Don MacLean,SF,27,PHI,37,2,733,163,365,0.447,12,38,0.316,151,327,0.462,0.46299999999999997,64,97,0.66,41,99,140,37,12,10,47,71,402
Rick Mahorn,C,38,DET,22,7,218,20,54,0.37,0,1,0.0,20,53,0.377,0.37,16,22,0.727,19,34,53,6,4,3,10,34,56
Dan Majerle,SF,31,MIA,36,26,1264,141,347,0.406,68,201,0.33799999999999997,73,146,0.5,0.504,40,59,0.6779999999999999,45,117,162,116,54,14,50,75,390
Karl Malone*,PF,33,UTA,82,82,2998,864,1571,0.55,0,13,0.0,864,1558,0.555,0.55,521,690,0.755,193,616,809,368,113,48,233,217,2249
Matt Maloney,PG,25,HOU,82,82,2386,271,615,0.441,154,381,0.40399999999999997,117,234,0.5,0.5660000000000001,71,93,0.763,19,141,160,303,82,1,122,125,767
Danny Manning,PF,30,PHO,77,17,2134,426,795,0.536,7,36,0.19399999999999998,419,759,0.552,0.54,181,251,0.721,137,332,469,173,81,74,161,268,1040
Rich Manning,PF,26,TOT,26,2,201,32,82,0.39,2,4,0.5,30,78,0.385,0.402,9,14,0.643,16,23,39,3,4,2,7,29,75
Stephon Marbury,PG,19,MIN,67,64,2324,355,871,0.408,102,288,0.354,253,583,0.434,0.466,245,337,0.727,54,130,184,522,67,19,210,159,1057
Šarūnas Marčiulionis*,SG,32,DEN,17,0,255,38,101,0.376,11,30,0.36700000000000005,27,71,0.38,0.431,29,36,0.8059999999999999,12,18,30,25,12,1,40,38,116
Donny Marshall,SF,24,CLE,56,0,548,52,160,0.325,33,87,0.379,19,73,0.26,0.428,38,54,0.7040000000000001,22,48,70,24,24,3,32,60,175
Donyell Marshall,SF,23,GSW,61,20,1022,174,421,0.413,35,111,0.315,139,310,0.44799999999999995,0.455,61,98,0.622,92,184,276,54,25,46,55,96,444
Cuonzo Martin,SG,25,MIL,3,0,13,0,7,0.0,0,2,0.0,0,5,0.0,0.0,0,0,0.0,1,0,1,1,0,0,1,1,0
Darrick Martin,PG,25,LAC,82,64,1820,292,718,0.40700000000000003,91,234,0.389,201,484,0.415,0.47,218,250,0.872,26,87,113,339,57,2,127,165,893
Jamal Mashburn,SF,24,TOT,69,51,2164,286,743,0.385,90,277,0.325,196,466,0.42100000000000004,0.445,160,228,0.7020000000000001,69,225,294,204,78,12,114,186,822
Anthony Mason,PF,30,CHH,73,73,3143,433,825,0.525,1,3,0.33299999999999996,432,822,0.526,0.525,319,428,0.745,186,643,829,414,76,33,165,202,1186
Tony Massenburg,PF,29,NJN,79,49,1954,219,452,0.485,0,1,0.0,219,451,0.486,0.485,130,206,0.631,222,295,517,23,38,50,91,217,568
Vernon Maxwell,SG,31,SAS,72,31,2068,340,906,0.375,115,372,0.309,225,534,0.42100000000000004,0.439,134,180,0.7440000000000001,27,132,159,153,87,19,121,168,929
Lee Mayberry,PG,26,VAN,80,38,1952,149,370,0.40299999999999997,83,221,0.376,66,149,0.44299999999999995,0.515,29,46,0.63,29,105,134,329,60,8,90,159,410
Walter McCarty,PF,22,NYK,35,0,192,26,68,0.382,4,14,0.28600000000000003,22,54,0.40700000000000003,0.41200000000000003,8,14,0.5710000000000001,8,15,23,13,7,9,17,38,64
Amal McCaskill,C,23,ORL,17,1,109,10,32,0.313,0,2,0.0,10,30,0.33299999999999996,0.313,8,12,0.667,4,18,22,7,3,5,11,7,28
George McCloud,SF,29,TOT,64,28,1493,238,578,0.41200000000000003,99,254,0.39,139,324,0.429,0.49700000000000005,83,101,0.8220000000000001,36,143,179,109,61,8,61,126,658
Xavier McDaniel,PF,33,NJN,62,5,1170,138,355,0.389,5,25,0.2,133,330,0.40299999999999997,0.396,65,89,0.73,124,194,318,65,36,17,70,144,346
Antonio McDyess,PF,22,DEN,74,73,2565,536,1157,0.46299999999999997,6,35,0.171,530,1122,0.47200000000000003,0.466,274,387,0.708,155,382,537,106,62,126,199,276,1352
Jim McIlvaine,C,24,SEA,82,79,1477,130,276,0.47100000000000003,1,7,0.14300000000000002,129,269,0.48,0.473,53,107,0.495,132,198,330,23,39,164,62,247,314
Jeff McInnis,PG,22,DEN,13,0,117,23,49,0.469,12,26,0.462,11,23,0.478,0.5920000000000001,7,10,0.7,2,4,6,18,2,1,13,16,65
Derrick McKey,SF,30,IND,50,49,1449,148,379,0.391,15,58,0.259,133,321,0.414,0.41,89,123,0.7240000000000001,80,161,241,135,47,30,83,141,400
Aaron McKie,SG,24,TOT,83,11,1625,150,365,0.41100000000000003,41,103,0.39799999999999996,109,262,0.41600000000000004,0.467,92,110,0.836,40,181,221,161,77,22,90,130,433
Nate McMillan,PG,32,SEA,37,2,798,61,149,0.409,28,84,0.33299999999999996,33,65,0.508,0.503,19,29,0.655,15,103,118,140,58,6,32,78,169
Loren Meyer,PF,24,TOT,54,33,708,108,244,0.44299999999999995,4,7,0.5710000000000001,104,237,0.439,0.451,46,64,0.7190000000000001,53,92,145,19,11,15,62,125,266
Anthony Miller,PF,25,ATL,1,0,14,0,5,0.0,0,0,0.0,0,5,0.0,0.0,0,0,0.0,2,5,7,0,0,0,0,2,0
Oliver Miller,C,26,TOT,61,8,1152,123,238,0.517,0,2,0.0,123,236,0.521,0.517,48,79,0.608,105,201,306,87,47,63,90,181,294
Reggie Miller*,SG,31,IND,81,81,2966,552,1244,0.444,229,536,0.42700000000000005,323,708,0.456,0.536,418,475,0.88,53,233,286,273,75,25,166,172,1751
Chris Mills,SF,27,CLE,80,79,3167,405,894,0.45299999999999996,86,220,0.391,319,674,0.473,0.501,176,209,0.8420000000000001,118,379,497,198,86,41,120,222,1072
Terry Mills,PF,29,DET,79,5,1997,312,702,0.444,175,415,0.42200000000000004,137,287,0.47700000000000004,0.569,58,70,0.8290000000000001,68,309,377,99,35,27,85,161,857
Greg Minor,SF,25,BOS,23,15,547,94,196,0.48,1,8,0.125,93,188,0.495,0.48200000000000004,31,36,0.861,30,50,80,34,15,2,22,45,220
Sam Mitchell,SF,33,MIN,82,5,2044,269,603,0.446,4,25,0.16,265,578,0.45799999999999996,0.449,224,295,0.759,112,214,326,79,51,20,93,232,766
Eric Mobley,C,26,VAN,28,8,307,28,63,0.444,0,0,0.0,28,63,0.444,0.444,16,30,0.5329999999999999,30,28,58,14,5,10,29,44,72
Eric Montross,C,25,TOT,78,77,1828,159,349,0.456,0,0,0.0,159,349,0.456,0.456,21,62,0.33899999999999997,181,337,518,61,20,73,77,268,339
Tracy Moore,SG,31,HOU,27,1,237,33,85,0.38799999999999996,11,43,0.256,22,42,0.524,0.45299999999999996,22,31,0.71,11,15,26,20,5,0,14,19,99
Chris Morris,SF,31,UTA,73,1,977,122,299,0.408,31,113,0.27399999999999997,91,186,0.489,0.46,39,54,0.722,37,125,162,43,29,24,45,121,314
Lawrence Moten,SG,24,VAN,67,18,1214,171,441,0.38799999999999996,41,141,0.29100000000000004,130,300,0.433,0.434,64,99,0.6459999999999999,43,76,119,129,48,24,81,83,447
Alonzo Mourning*,C,26,MIA,66,65,2320,473,885,0.534,1,9,0.111,472,876,0.539,0.535,363,565,0.642,189,467,656,104,56,189,226,272,1310
Chris Mullin*,SF,33,GSW,79,63,2733,438,792,0.5529999999999999,83,202,0.41100000000000003,355,590,0.602,0.605,184,213,0.8640000000000001,75,242,317,322,130,33,192,155,1143
Eric Murdock,PG,28,DEN,12,0,114,15,33,0.455,4,10,0.4,11,23,0.478,0.515,11,12,0.917,1,10,11,24,9,2,11,9,45
Gheorghe Mureșan,C,25,WSB,73,69,1849,327,541,0.604,0,0,0.0,327,541,0.604,0.604,123,199,0.618,141,340,481,29,43,96,117,230,777
Lamond Murray,SF,23,LAC,74,1,1295,181,435,0.41600000000000004,31,91,0.341,150,344,0.436,0.452,156,211,0.7390000000000001,85,148,233,57,53,29,86,113,549
Tracy Murray,SF,25,WSB,82,1,1814,288,678,0.425,106,300,0.353,182,378,0.48100000000000004,0.503,135,161,0.8390000000000001,84,169,253,78,69,19,86,150,817
Dikembe Mutombo*,C,30,ATL,80,80,2973,380,721,0.527,0,0,0.0,380,721,0.527,0.527,306,434,0.705,268,661,929,110,49,264,186,249,1066
Martin Müürsepp,PF,22,TOT,42,0,348,54,131,0.41200000000000003,4,24,0.16699999999999998,50,107,0.467,0.42700000000000005,44,70,0.629,35,32,67,20,12,11,18,58,156
Steve Nash*,PG,22,PHO,65,2,684,74,175,0.423,23,55,0.418,51,120,0.425,0.489,42,51,0.8240000000000001,16,47,63,138,20,0,63,92,213
Ruben Nembhard,SG-PG,24,TOT,10,0,113,16,37,0.43200000000000005,0,6,0.0,16,31,0.516,0.43200000000000005,8,10,0.8,3,5,8,17,9,0,8,12,40
Ivano Newbill,PF,26,ATL,72,2,850,40,91,0.44,0,0,0.0,40,91,0.44,0.44,20,52,0.385,76,128,204,24,28,15,42,115,100
Johnny Newman,SF,33,MIL,82,4,2060,246,547,0.45,34,98,0.34700000000000003,212,449,0.47200000000000003,0.48100000000000004,189,247,0.765,66,120,186,116,73,17,115,257,715
Gaylon Nickerson,SG,27,TOT,4,0,42,4,12,0.33299999999999996,0,2,0.0,4,10,0.4,0.33299999999999996,7,7,1.0,1,4,5,1,1,1,1,1,15
Ken Norman,SF,32,ATL,17,0,220,27,94,0.287,6,38,0.158,21,56,0.375,0.319,4,12,0.33299999999999996,8,31,39,12,7,3,18,17,64
Moochie Norris,PG,23,VAN,8,0,89,4,22,0.182,2,10,0.2,2,12,0.16699999999999998,0.22699999999999998,2,5,0.4,3,9,12,23,4,0,5,5,12
Ed O'Bannon,SF,24,TOT,64,5,809,93,279,0.33299999999999996,18,70,0.257,75,209,0.359,0.366,31,35,0.8859999999999999,50,98,148,39,29,12,20,97,235
Jermaine O'Neal,PF,18,POR,45,0,458,69,153,0.451,0,1,0.0,69,152,0.45399999999999996,0.451,47,78,0.603,39,85,124,8,2,26,27,46,185
Shaquille O'Neal*,C,24,LAL,51,51,1941,552,991,0.557,0,4,0.0,552,987,0.5589999999999999,0.557,232,479,0.484,195,445,640,159,46,147,146,180,1336
Charles Oakley,PF,33,NYK,80,80,2873,339,694,0.488,5,19,0.263,334,675,0.495,0.49200000000000005,181,224,0.8079999999999999,246,535,781,221,111,21,171,305,864
Hakeem Olajuwon*,C,34,HOU,78,78,2852,727,1426,0.51,5,16,0.313,722,1410,0.512,0.512,351,446,0.787,173,543,716,236,117,173,281,249,1810
Jimmy Oliver,SG,27,TOR,4,0,43,4,13,0.308,1,6,0.16699999999999998,3,7,0.429,0.34600000000000003,2,2,1.0,1,4,5,1,2,0,3,2,11
Greg Ostertag,C,23,UTA,77,70,1818,210,408,0.515,0,4,0.0,210,404,0.52,0.515,139,205,0.6779999999999999,180,385,565,27,24,152,74,233,559
Bo Outlaw,PF,25,LAC,82,25,2195,254,417,0.609,0,8,0.0,254,409,0.621,0.609,117,232,0.504,174,280,454,157,94,142,107,227,625
Doug Overton,PG,27,PHI,61,4,634,81,190,0.426,10,40,0.25,71,150,0.473,0.45299999999999996,45,48,0.938,18,50,68,101,24,0,39,44,217
Billy Owens,SF,27,SAC,66,56,1995,299,640,0.467,25,72,0.34700000000000003,274,568,0.48200000000000004,0.48700000000000004,101,145,0.6970000000000001,134,258,392,187,62,25,133,187,724
Ray Owes,PF,24,GSW,57,1,592,75,180,0.41700000000000004,1,5,0.2,74,175,0.423,0.419,26,46,0.565,64,99,163,15,15,20,23,86,177
Robert Pack,PG,27,TOT,54,42,1782,272,693,0.392,31,112,0.27699999999999997,241,581,0.415,0.415,196,243,0.807,28,118,146,452,94,6,217,139,771
Robert Parish*,C,43,CHI,43,3,406,70,143,0.49,0,0,0.0,70,143,0.49,0.49,21,31,0.677,42,47,89,22,6,19,28,40,161
Cherokee Parks,PF,24,MIN,76,0,961,103,202,0.51,0,1,0.0,103,201,0.512,0.51,46,76,0.605,83,112,195,34,41,48,32,150,252
Gary Payton*,PG,28,SEA,82,82,3213,706,1482,0.47600000000000003,119,380,0.313,587,1102,0.5329999999999999,0.517,254,355,0.715,106,272,378,583,197,13,215,208,1785
Anthony Peeler,SG,27,VAN,72,57,2291,402,1011,0.39799999999999996,128,343,0.373,274,668,0.41,0.461,109,133,0.82,54,193,247,256,105,17,157,168,1041
Will Perdue,C,31,SAS,65,34,1918,233,410,0.568,0,0,0.0,233,410,0.568,0.568,99,171,0.579,251,387,638,38,32,102,87,184,565
Sam Perkins,C,35,SEA,81,4,1976,290,661,0.439,122,309,0.395,168,352,0.47700000000000004,0.531,187,229,0.8170000000000001,74,226,300,103,69,49,77,134,889
Elliot Perry,PG,27,MIL,82,3,1595,217,458,0.474,49,137,0.358,168,321,0.523,0.527,79,106,0.745,24,100,124,247,98,3,111,117,562
Wesley Person,SG,25,PHO,80,42,2326,409,903,0.45299999999999996,171,414,0.413,238,489,0.48700000000000004,0.5479999999999999,91,114,0.7979999999999999,68,224,292,123,86,20,76,102,1080
Bobby Phills,SG,27,CLE,69,65,2375,328,766,0.428,85,216,0.39399999999999996,243,550,0.442,0.484,125,174,0.718,63,182,245,233,113,21,135,174,866
Eric Piatkowski,SG,26,LAC,65,0,747,134,298,0.45,51,120,0.425,83,178,0.466,0.535,69,84,0.821,49,56,105,52,33,10,46,85,388
Ricky Pierce,SG,37,TOT,60,27,1250,239,497,0.48100000000000004,42,95,0.442,197,402,0.49,0.523,139,155,0.897,36,85,121,80,28,9,68,97,659
Ed Pinckney,PF,33,MIA,27,0,273,23,43,0.535,0,0,0.0,23,43,0.535,0.535,20,25,0.8,25,40,65,6,8,9,19,30,66
Scottie Pippen*,SF,31,CHI,82,82,3095,648,1366,0.474,156,424,0.368,492,942,0.522,0.531,204,291,0.701,160,371,531,467,154,45,214,213,1656
Olden Polynice,C,32,SAC,82,82,2893,442,967,0.457,0,6,0.0,442,961,0.46,0.457,141,251,0.562,272,500,772,178,46,80,166,298,1025
Terry Porter,PG,33,MIN,82,20,1568,187,449,0.41600000000000004,67,200,0.335,120,249,0.48200000000000004,0.491,127,166,0.765,31,145,176,295,54,11,128,104,568
Vitaly Potapenko,C,21,CLE,80,3,1238,186,423,0.44,1,2,0.5,185,421,0.439,0.441,92,125,0.736,105,112,217,40,26,34,109,216,465
Brent Price,PG,28,HOU,25,0,390,44,105,0.419,17,53,0.321,27,52,0.519,0.5,21,21,1.0,10,19,29,65,17,0,32,34,126
Mark Price,PG,32,GSW,70,49,1876,263,589,0.447,112,283,0.396,151,306,0.493,0.542,155,171,0.9059999999999999,36,143,179,342,67,3,161,100,793
Theo Ratliff,C,23,DET,76,38,1292,179,337,0.531,0,0,0.0,179,337,0.531,0.531,81,116,0.698,109,147,256,13,29,111,56,181,439
Dino Rađa*,C,29,BOS,25,25,874,149,339,0.44,0,1,0.0,149,338,0.441,0.44,51,71,0.718,44,167,211,48,23,48,70,76,349
Eldridge Recasner,SG,29,ATL,71,4,1207,148,350,0.423,58,140,0.414,90,210,0.429,0.506,51,58,0.879,35,80,115,94,38,4,65,97,405
Bryant Reeves,C,23,VAN,75,75,2777,498,1025,0.486,1,11,0.091,497,1014,0.49,0.486,216,307,0.7040000000000001,174,436,610,160,29,67,175,270,1213
Khalid Reeves,PG,24,TOT,63,30,1432,184,470,0.391,83,227,0.366,101,243,0.41600000000000004,0.48,65,87,0.747,34,85,119,226,34,9,108,159,516
Don Reid,PF,23,DET,47,14,462,54,112,0.48200000000000004,0,1,0.0,54,111,0.486,0.48200000000000004,24,32,0.75,36,65,101,14,16,15,23,105,132
Shawn Respert,SG,24,TOT,41,0,495,59,139,0.424,20,57,0.35100000000000003,39,82,0.47600000000000003,0.496,34,39,0.872,14,25,39,40,20,2,30,40,172
Glen Rice,SF,29,CHH,79,78,3362,722,1513,0.47700000000000004,207,440,0.47,515,1073,0.48,0.546,464,535,0.867,67,251,318,160,72,26,177,190,2115
Pooh Richardson,PG,30,LAC,59,18,1065,131,344,0.381,42,128,0.32799999999999996,89,216,0.41200000000000003,0.442,26,43,0.605,25,73,98,169,54,5,62,82,330
Mitch Richmond*,SG,31,SAC,81,81,3125,717,1578,0.45399999999999996,204,477,0.428,513,1101,0.466,0.519,457,531,0.861,59,260,319,338,118,24,237,211,2095
Isaiah Rider,SG,25,POR,76,68,2563,456,983,0.46399999999999997,99,257,0.385,357,726,0.49200000000000005,0.514,212,261,0.812,94,210,304,198,45,19,212,199,1223
Fred Roberts,PF,36,DAL,12,0,40,6,15,0.4,0,0,0.0,6,15,0.4,0.4,10,14,0.7140000000000001,2,8,10,0,0,1,5,2,22
Stanley Roberts,C,26,LAC,18,2,378,63,148,0.426,0,0,0.0,63,148,0.426,0.426,45,64,0.703,24,67,91,9,8,23,23,57,171
Chris Robinson,SG,22,VAN,41,6,681,69,182,0.379,34,89,0.382,35,93,0.376,0.473,16,26,0.615,23,48,71,65,28,9,34,85,188
Clifford Robinson,SF,30,POR,81,79,3077,444,1043,0.426,121,350,0.34600000000000003,323,693,0.466,0.484,215,309,0.696,90,231,321,261,99,66,172,251,1224
David Robinson*,C,31,SAS,6,6,147,36,72,0.5,0,0,0.0,36,72,0.5,0.5,34,52,0.654,19,32,51,8,6,6,8,9,106
Glenn Robinson,SF,24,MIL,80,79,3114,669,1438,0.465,63,180,0.35,606,1258,0.48200000000000004,0.48700000000000004,288,364,0.7909999999999999,130,372,502,248,103,68,269,225,1689
James Robinson,PG,26,MIN,69,5,1309,196,482,0.40700000000000003,102,267,0.382,94,215,0.43700000000000006,0.512,78,114,0.684,24,88,112,126,30,8,69,125,572
Rumeal Robinson,PG,30,TOT,54,3,508,66,164,0.402,18,56,0.321,48,108,0.444,0.457,26,35,0.743,6,41,47,73,24,2,43,60,176
Dennis Rodman*,PF,35,CHI,55,54,1947,128,286,0.44799999999999995,5,19,0.263,123,267,0.461,0.456,50,88,0.568,320,563,883,170,32,19,111,172,311
Lou Roe,SF,24,GSW,17,0,107,14,48,0.292,3,11,0.273,11,37,0.297,0.32299999999999995,9,19,0.474,7,7,14,6,3,1,11,10,40
Carlos Rogers,PF,25,TOR,56,3,1397,212,404,0.525,25,66,0.379,187,338,0.5529999999999999,0.556,102,170,0.6,120,184,304,37,42,69,53,140,551
Rodney Rogers,SF,25,LAC,81,62,2480,408,884,0.462,65,180,0.361,343,704,0.48700000000000004,0.498,191,288,0.6629999999999999,137,274,411,222,88,61,221,272,1072
Roy Rogers,PF,23,VAN,82,50,1848,244,483,0.505,1,1,1.0,243,482,0.504,0.506,54,94,0.574,139,247,386,46,21,163,86,214,543
Sean Rooks,C,27,LAL,69,3,735,87,185,0.47,0,1,0.0,87,184,0.473,0.47,91,130,0.7,56,107,163,42,17,38,51,123,265
Jalen Rose,SF,24,IND,66,6,1188,172,377,0.456,21,72,0.292,151,305,0.495,0.484,117,156,0.75,27,94,121,155,57,18,107,136,482
Malik Rose,PF,22,CHH,54,1,525,61,128,0.47700000000000004,0,2,0.0,61,126,0.484,0.47700000000000004,38,62,0.613,70,94,164,32,28,17,41,114,160
Donald Royal,SF,30,TOT,62,4,858,62,146,0.425,0,2,0.0,62,144,0.431,0.425,94,117,0.8029999999999999,52,102,154,25,23,11,47,100,218
Clifford Rozier,C,24,TOT,42,29,737,79,174,0.45399999999999996,0,2,0.0,79,172,0.45899999999999996,0.45399999999999996,31,61,0.508,102,132,234,31,24,44,29,97,189
Bryon Russell,SF,26,UTA,81,81,2525,297,620,0.479,108,264,0.409,189,356,0.531,0.5660000000000001,171,244,0.701,79,252,331,123,129,27,94,237,873
Arvydas Sabonis*,C,32,POR,69,68,1762,328,658,0.498,49,132,0.371,279,526,0.53,0.536,223,287,0.777,114,433,547,146,63,84,151,203,928
Kevin Salvadori,C,26,SAC,23,0,154,12,33,0.364,0,0,0.0,12,33,0.364,0.364,13,18,0.722,6,19,25,10,2,13,12,17,37
Jason Sasser,SF,23,TOT,8,0,69,9,23,0.391,1,3,0.33299999999999996,8,20,0.4,0.413,0,0,0.0,1,7,8,2,3,0,2,11,19
Danny Schayes,PF,37,ORL,45,6,540,47,120,0.392,0,1,0.0,47,119,0.395,0.392,39,52,0.75,41,84,125,14,15,16,27,74,133
Steve Scheffler,C,29,SEA,7,0,29,6,7,0.857,0,0,0.0,6,7,0.857,0.857,1,2,0.5,1,2,3,0,0,0,5,5,13
Dwayne Schintzius,C,28,LAC,15,0,116,13,36,0.361,1,2,0.5,12,34,0.353,0.375,7,8,0.875,9,13,22,4,1,9,7,22,34
Detlef Schrempf,SF,34,SEA,61,60,2192,356,724,0.49200000000000005,57,161,0.354,299,563,0.531,0.531,253,316,0.8009999999999999,87,307,394,266,63,16,150,151,1022
Brent Scott,PF,25,IND,16,0,55,8,17,0.47100000000000003,0,0,0.0,8,17,0.47100000000000003,0.47100000000000003,3,6,0.5,3,6,9,3,1,1,4,14,19
Byron Scott,SG,35,LAL,79,8,1440,163,379,0.43,73,188,0.38799999999999996,90,191,0.47100000000000003,0.526,127,151,0.841,21,97,118,99,46,16,53,72,526
Dennis Scott,SF,28,ORL,66,62,2166,298,749,0.39799999999999996,147,373,0.39399999999999996,151,376,0.402,0.496,80,101,0.792,40,163,203,139,74,19,81,138,823
James Scott,SF,24,MIA,8,0,32,0,8,0.0,0,4,0.0,0,4,0.0,0.0,1,2,0.5,1,5,6,3,2,0,2,5,1
Shawnelle Scott,C,24,CLE,16,0,50,8,16,0.5,0,0,0.0,8,16,0.5,0.5,4,11,0.364,8,8,16,0,0,3,0,6,20
Malik Sealy,SG,26,LAC,80,79,2456,373,942,0.396,79,222,0.35600000000000004,294,720,0.408,0.43799999999999994,254,290,0.8759999999999999,59,179,238,165,124,45,154,185,1079
Rony Seikaly,C,31,ORL,74,68,2615,460,907,0.507,0,3,0.0,460,904,0.509,0.507,357,500,0.7140000000000001,274,427,701,92,49,107,218,275,1277
Brian Shaw,PG,30,ORL,77,31,1867,189,516,0.366,63,194,0.325,126,322,0.391,0.42700000000000005,111,140,0.7929999999999999,47,147,194,319,67,26,170,197,552
Lionel Simmons,SF,28,SAC,41,0,521,45,136,0.331,7,30,0.233,38,106,0.358,0.35700000000000004,42,48,0.875,30,74,104,57,8,13,34,63,139
Dickey Simpkins,PF,24,CHI,48,0,395,31,93,0.33299999999999996,1,4,0.25,30,89,0.337,0.33899999999999997,28,40,0.7,36,56,92,31,5,5,35,44,91
Reggie Slater,PF,26,TOR,26,0,406,82,149,0.55,0,2,0.0,82,147,0.5579999999999999,0.55,39,75,0.52,40,55,95,21,9,6,29,34,203
Charles Smith,PF,31,SAS,19,7,329,34,84,0.405,0,1,0.0,34,83,0.41,0.405,20,26,0.769,18,47,65,14,13,22,22,44,88
Joe Smith,PF,21,GSW,80,80,3086,587,1293,0.45399999999999996,12,46,0.261,575,1247,0.461,0.45899999999999996,307,377,0.8140000000000001,261,418,679,125,74,86,192,244,1493
Kenny Smith,PG,31,TOT,48,3,765,101,239,0.423,59,135,0.43700000000000006,42,104,0.40399999999999997,0.546,39,45,0.867,4,40,44,116,19,0,71,30,300
Michael Smith,PF,24,SAC,81,52,2526,202,375,0.539,0,0,0.0,202,375,0.539,0.539,128,258,0.496,257,512,769,191,82,60,130,251,532
Steve Smith,SG,27,ATL,72,72,2818,491,1145,0.429,130,388,0.335,361,757,0.47700000000000004,0.486,333,393,0.847,90,148,238,305,62,23,176,173,1445
Stevin Smith,SG,25,DAL,8,0,60,6,18,0.33299999999999996,1,6,0.16699999999999998,5,12,0.41700000000000004,0.361,1,1,1.0,2,8,10,4,1,0,4,9,14
Tony Smith,PG,28,CHH,69,39,1291,138,337,0.409,32,99,0.32299999999999995,106,238,0.445,0.457,38,59,0.644,38,56,94,150,48,19,73,110,346
Rik Smits,C,30,IND,52,52,1518,356,733,0.486,2,8,0.25,354,725,0.488,0.48700000000000004,173,217,0.797,105,256,361,67,22,59,126,175,887
Eric Snow,PG,23,SEA,67,0,775,74,164,0.451,4,15,0.267,70,149,0.47,0.46299999999999997,47,66,0.7120000000000001,17,53,70,159,37,3,48,94,199
Elmore Spencer,C,27,SEA,1,0,5,0,1,0.0,0,0,0.0,0,1,0.0,0.0,0,0,0.0,0,0,0,0,1,0,1,0,0
Felton Spencer,C,29,TOT,73,65,1558,139,284,0.489,0,0,0.0,139,284,0.489,0.489,94,161,0.584,157,259,416,22,34,50,88,275,372
Latrell Sprewell,SG,26,GSW,80,79,3353,649,1444,0.449,147,415,0.354,502,1029,0.488,0.5,493,585,0.843,58,308,366,507,132,45,322,153,1938
Jerry Stackhouse,SG,22,PHI,81,81,3166,533,1308,0.40700000000000003,102,342,0.298,431,966,0.446,0.446,511,667,0.7659999999999999,156,182,338,253,93,63,316,219,1679
John Starks,SG,31,NYK,77,1,2042,369,856,0.431,150,407,0.369,219,449,0.488,0.519,173,225,0.769,36,169,205,217,90,11,158,196,1061
Matt Steigenga,SF,26,CHI,2,0,12,1,4,0.25,0,2,0.0,1,2,0.5,0.25,1,2,0.5,0,3,3,2,1,1,2,1,3
Joe Stephens,PF,24,HOU,2,0,9,1,5,0.2,1,3,0.33299999999999996,0,2,0.0,0.3,0,0,0.0,2,1,3,0,3,0,3,3,3
Larry Stewart,SF,28,SEA,70,21,982,112,252,0.444,9,37,0.243,103,215,0.479,0.462,67,93,0.72,75,96,171,52,31,23,63,108,300
Bryant Stith,SG,26,DEN,52,52,1788,251,603,0.41600000000000004,70,182,0.385,181,421,0.43,0.474,202,234,0.863,74,143,217,133,60,20,101,119,774
John Stockton*,PG,34,UTA,82,82,2896,416,759,0.5479999999999999,76,180,0.42200000000000004,340,579,0.5870000000000001,0.598,275,325,0.846,45,183,228,860,166,15,248,194,1183
Damon Stoudamire,PG,23,TOR,81,81,3311,564,1407,0.401,176,496,0.355,388,911,0.426,0.46299999999999997,330,401,0.823,86,244,330,709,123,13,288,162,1634
Erick Strickland,SG,23,DAL,28,15,759,102,256,0.39799999999999996,28,92,0.304,74,164,0.451,0.45299999999999996,65,80,0.813,21,69,90,68,27,5,66,75,297
Mark Strickland,PF,26,MIA,31,0,153,25,60,0.41700000000000004,0,1,0.0,25,59,0.424,0.41700000000000004,12,21,0.5710000000000001,16,21,37,1,4,10,15,17,62
Rod Strickland,PG,30,WSB,82,81,2997,515,1105,0.466,13,77,0.16899999999999998,502,1028,0.488,0.47200000000000003,367,497,0.738,95,240,335,727,143,14,270,166,1410
Derek Strong,PF,28,ORL,82,21,2004,262,586,0.447,0,13,0.0,262,573,0.457,0.447,175,218,0.8029999999999999,174,345,519,73,47,20,102,196,699
Bob Sura,SG,23,CLE,82,23,2269,253,587,0.431,53,164,0.32299999999999995,200,423,0.473,0.47600000000000003,196,319,0.614,76,232,308,390,90,33,181,218,755
Brett Szabo,C,28,BOS,70,24,662,54,121,0.446,0,1,0.0,54,120,0.45,0.446,45,61,0.738,56,109,165,17,16,32,41,119,153
Žan Tabak,C,26,TOR,13,4,218,32,71,0.451,0,0,0.0,32,71,0.451,0.451,20,29,0.69,20,29,49,14,6,11,21,35,84
Carl Thomas,SG,27,CLE,19,0,77,9,24,0.375,2,12,0.16699999999999998,7,12,0.583,0.41700000000000004,1,1,1.0,3,10,13,8,2,1,6,7,21
Kurt Thomas,PF,24,MIA,18,9,374,39,105,0.371,0,1,0.0,39,104,0.375,0.371,35,46,0.7609999999999999,31,76,107,9,12,9,25,67,113
Brooks Thompson,PG,26,TOT,67,6,1055,162,406,0.39899999999999997,97,244,0.39799999999999996,65,162,0.401,0.518,24,38,0.632,18,78,96,180,55,2,87,126,445
LaSalle Thompson,C,35,TOT,26,0,140,3,19,0.158,0,0,0.0,3,19,0.158,0.158,4,6,0.667,7,27,34,2,3,6,9,33,10
Otis Thorpe,C,34,DET,79,79,2661,419,787,0.532,0,2,0.0,419,785,0.534,0.532,198,303,0.653,226,396,622,133,59,17,145,298,1036
Sedale Threatt,SG,35,HOU,21,0,334,28,74,0.37799999999999995,8,20,0.4,20,54,0.37,0.43200000000000005,6,8,0.75,5,19,24,40,15,3,13,29,70
Wayman Tisdale,PF,32,PHO,53,15,778,158,371,0.426,0,0,0.0,158,371,0.426,0.426,30,48,0.625,35,85,120,20,8,21,36,111,346
Keith Tower,C,26,MIL,5,1,72,3,8,0.375,0,0,0.0,3,8,0.375,0.375,1,8,0.125,2,7,9,1,2,1,2,12,7
Gary Trent,PF,22,POR,82,28,1918,361,674,0.536,0,11,0.0,361,663,0.544,0.536,160,229,0.6990000000000001,156,272,428,87,48,35,129,186,882
Nick Van Exel,PG,25,LAL,79,79,2937,432,1075,0.402,177,468,0.37799999999999995,255,607,0.42,0.484,165,200,0.825,44,182,226,672,75,10,212,110,1206
David Vaughn,PF,23,ORL,35,6,298,31,72,0.431,0,0,0.0,31,72,0.431,0.431,19,30,0.633,35,60,95,7,8,15,29,43,81
Loy Vaught,PF,28,LAC,82,82,2838,542,1084,0.5,2,12,0.16699999999999998,540,1072,0.504,0.501,134,191,0.7020000000000001,222,595,817,110,85,25,137,241,1220
Stojko Vranković,C,33,MIN,53,35,766,78,139,0.561,0,0,0.0,78,139,0.561,0.561,25,37,0.6759999999999999,57,111,168,14,10,67,52,121,181
Antoine Walker,PF,20,BOS,82,68,2970,576,1354,0.425,52,159,0.327,524,1195,0.43799999999999994,0.445,231,366,0.631,288,453,741,262,105,53,230,271,1435
Samaki Walker,PF,20,DAL,43,12,602,83,187,0.444,0,1,0.0,83,186,0.446,0.444,48,74,0.649,47,100,147,17,15,22,39,71,214
Ben Wallace,PF,22,WSB,34,0,197,16,46,0.348,0,0,0.0,16,46,0.348,0.348,6,20,0.3,25,33,58,2,8,11,18,27,38
John Wallace,SF,22,NYK,68,6,787,122,236,0.517,2,4,0.5,120,232,0.517,0.521,79,110,0.718,51,104,155,37,21,25,76,102,325
Rasheed Wallace,PF,22,POR,62,56,1892,380,681,0.5579999999999999,9,33,0.273,371,648,0.573,0.565,169,265,0.638,122,297,419,74,48,59,114,198,938
Rex Walters,SG,26,PHI,59,16,1041,148,325,0.455,57,148,0.385,91,177,0.514,0.5429999999999999,49,62,0.79,21,86,107,113,28,3,61,75,402
Charlie Ward,PG,26,NYK,79,21,1763,133,337,0.395,48,154,0.312,85,183,0.46399999999999997,0.466,95,125,0.76,45,175,220,326,83,15,147,188,409
Jamie Watson,SF,24,TOT,23,6,340,31,72,0.431,4,12,0.33299999999999996,27,60,0.45,0.45799999999999996,12,16,0.75,18,29,47,33,22,4,24,34,78
Clarence Weatherspoon,SF,26,PHI,82,82,2949,398,811,0.491,1,6,0.16699999999999998,397,805,0.493,0.491,206,279,0.738,219,460,679,140,74,86,137,187,1003
Chris Webber,PF,23,WSB,72,72,2806,604,1167,0.518,60,151,0.397,544,1016,0.535,0.5429999999999999,177,313,0.565,238,505,743,331,122,137,230,258,1445
Bill Wennington,C,33,CHI,61,19,783,118,237,0.498,0,2,0.0,118,235,0.502,0.498,44,53,0.83,46,83,129,41,10,11,31,132,280
Robert Werdann,C,26,NJN,6,0,31,3,7,0.429,0,0,0.0,3,7,0.429,0.429,3,3,1.0,3,3,6,0,2,1,2,10,9
David Wesley,PG,26,BOS,74,73,2991,456,974,0.46799999999999997,103,286,0.36,353,688,0.513,0.521,225,288,0.7809999999999999,67,197,264,537,162,13,211,221,1240
Doug West,SG,29,MIN,68,66,1920,226,484,0.467,15,45,0.33299999999999996,211,439,0.48100000000000004,0.48200000000000004,64,94,0.6809999999999999,37,111,148,113,61,24,66,218,531
Mark West,C,36,CLE,70,43,959,100,180,0.556,0,0,0.0,100,180,0.556,0.556,27,56,0.48200000000000004,69,117,186,19,11,55,52,142,227
Ennis Whatley,PG,34,POR,3,0,22,2,4,0.5,0,0,0.0,2,4,0.5,0.5,0,0,0.0,0,3,3,3,0,0,1,5,4
Donald Whiteside,PG,27,TOR,27,1,259,18,55,0.327,12,36,0.33299999999999996,6,19,0.316,0.436,11,15,0.733,2,10,12,36,11,0,17,23,59
Chris Whitney,PG,25,WSB,82,1,1117,139,330,0.42100000000000004,58,163,0.35600000000000004,81,167,0.485,0.509,94,113,0.8320000000000001,13,91,104,182,49,4,68,100,430
Dominique Wilkins*,SF,37,SAS,63,26,1945,397,953,0.41700000000000004,70,239,0.293,327,714,0.45799999999999996,0.45299999999999996,281,350,0.8029999999999999,169,233,402,119,39,31,135,100,1145
Gerald Wilkins,SG,33,ORL,80,26,2202,323,759,0.426,66,203,0.325,257,556,0.462,0.469,136,190,0.716,59,114,173,173,54,12,123,144,848
Aaron Williams,PF-C,25,TOT,33,1,563,85,148,0.574,0,1,0.0,85,147,0.578,0.574,33,49,0.6729999999999999,62,81,143,15,16,29,32,72,203
Buck Williams,PF,36,NYK,74,4,1496,175,326,0.537,0,1,0.0,175,325,0.5379999999999999,0.537,115,179,0.642,166,231,397,53,40,38,79,204,465
Eric Williams,SG,24,BOS,72,67,2435,374,820,0.456,2,8,0.25,372,812,0.45799999999999996,0.457,328,436,0.752,126,203,329,129,72,13,139,213,1078
Herb Williams,PF,38,NYK,21,2,184,18,46,0.391,0,1,0.0,18,45,0.4,0.391,3,4,0.75,9,22,31,5,4,5,5,18,39
Hot Rod Williams,C,34,PHO,68,66,2137,204,416,0.49,0,2,0.0,204,414,0.493,0.49,133,198,0.672,178,384,562,100,67,88,66,176,541
Jayson Williams,PF,28,NJN,41,40,1432,221,540,0.409,0,4,0.0,221,536,0.41200000000000003,0.409,108,183,0.59,242,311,553,51,24,36,82,158,550
Jerome Williams,PF,23,DET,33,0,177,20,51,0.392,0,0,0.0,20,51,0.392,0.392,9,17,0.529,22,28,50,7,13,1,13,18,49
Lorenzo Williams,C,27,WSB,19,0,264,20,31,0.645,0,0,0.0,20,31,0.645,0.645,5,7,0.7140000000000001,28,41,69,4,6,8,18,49,45
Monty Williams,SF,25,SAS,65,26,1345,234,460,0.509,0,1,0.0,234,459,0.51,0.509,120,186,0.645,98,108,206,91,55,52,116,161,588
Reggie Williams,SF,32,TOT,13,0,200,29,76,0.382,9,34,0.265,20,42,0.47600000000000003,0.441,9,12,0.75,5,26,31,10,8,4,12,33,76
Scott Williams,C,28,PHI,62,52,1317,162,318,0.509,0,2,0.0,162,316,0.513,0.509,38,55,0.691,155,242,397,41,44,41,50,206,362
Walt Williams,SF,26,TOR,73,73,2647,419,982,0.42700000000000005,175,437,0.4,244,545,0.44799999999999995,0.516,186,243,0.765,103,264,367,197,97,62,174,282,1199
Corliss Williamson,SF,23,SAC,79,31,1992,371,745,0.498,0,3,0.0,371,742,0.5,0.498,173,251,0.6890000000000001,139,187,326,124,60,49,157,263,915
Kevin Willis,PF,34,HOU,75,32,1964,350,728,0.48100000000000004,2,14,0.14300000000000002,348,714,0.48700000000000004,0.48200000000000004,140,202,0.693,146,415,561,71,42,32,119,216,842
David Wingate,SG,33,SEA,65,2,929,89,214,0.41600000000000004,25,71,0.35200000000000004,64,143,0.44799999999999995,0.474,33,40,0.825,23,51,74,80,44,5,37,108,236
Dontonio Wingfield,SF,22,POR,47,0,569,79,193,0.409,26,77,0.33799999999999997,53,116,0.457,0.47700000000000004,27,40,0.675,63,74,137,45,14,6,49,101,211
Joe Wolf,C,32,MIL,56,7,525,40,89,0.449,1,7,0.14300000000000002,39,82,0.47600000000000003,0.455,14,19,0.737,32,80,112,20,14,11,14,105,95
David Wood,PF,32,MIL,46,0,240,20,38,0.526,5,15,0.33299999999999996,15,23,0.652,0.5920000000000001,12,18,0.667,5,22,27,13,7,6,6,36,57
Haywoode Workman,PG,31,IND,4,2,81,11,20,0.55,0,3,0.0,11,17,0.647,0.55,0,1,0.0,4,3,7,11,3,0,5,10,22
Lorenzen Wright,C,21,LAC,77,51,1936,236,491,0.48100000000000004,1,4,0.25,235,487,0.483,0.48200000000000004,88,150,0.5870000000000001,206,265,471,49,48,60,79,211,561
Sharone Wright,C,24,TOR,60,28,1009,161,403,0.4,0,1,0.0,161,402,0.4,0.4,68,133,0.511,79,107,186,28,15,50,93,146,390
George Zídek,C,23,TOT,52,2,376,49,118,0.415,0,2,0.0,49,116,0.42200000000000004,0.415,45,57,0.789,35,51,86,14,5,3,27,61,143
Aleksandar Đorđević,SG,29,POR,8,0,61,8,16,0.5,5,7,0.7140000000000001,3,9,0.33299999999999996,0.6559999999999999,4,5,0.8,1,4,5,5,0,0,5,3,25
