Player,Pos,Age,Tm,G,GS,MP,FG,FGA,FG%,3P,3PA,3P%,2P,2PA,2P%,eFG%,FT,FTA,FT%,ORB,DRB,TRB,AST,STL,BLK,TOV,PF,PTS
Shareef Abdur-Rahim,PF,28,POR,54,49,1867,337,670,0.503,15,39,0.385,322,631,0.51,0.514,220,254,0.866,123,269,392,111,49,26,117,150,909
Cory Alexander,SG,31,CHA,16,1,201,16,49,0.327,8,19,0.42100000000000004,8,30,0.267,0.408,9,12,0.75,8,21,29,37,9,1,19,29,49
Malik Allen,PF,26,TOT,36,1,519,84,177,0.475,0,0,0.0,84,177,0.475,0.475,26,28,0.929,40,59,99,18,9,22,18,53,194
Ray Allen*,SG,29,SEA,78,78,3064,640,1494,0.428,209,556,0.376,431,938,0.45899999999999996,0.498,378,428,0.883,79,268,347,289,84,5,171,167,1867
Tony Allen,SG,23,BOS,77,34,1262,184,387,0.475,12,31,0.387,172,356,0.483,0.491,112,152,0.737,85,136,221,64,76,24,77,156,492
Rafer Alston,PG,28,TOR,80,78,2717,403,974,0.414,139,389,0.35700000000000004,264,585,0.451,0.485,191,258,0.74,42,237,279,514,118,7,170,212,1136
Chris Andersen,C,26,NOH,67,2,1430,191,358,0.534,0,3,0.0,191,355,0.5379999999999999,0.534,131,190,0.6890000000000001,137,273,410,71,14,100,64,144,513
Derek Anderson,SG,30,POR,47,32,1239,152,391,0.389,58,151,0.384,94,240,0.392,0.46299999999999997,70,87,0.805,25,103,128,143,36,4,70,89,432
Kenny Anderson,PG,34,TOT,43,20,743,85,201,0.423,6,13,0.462,79,188,0.42,0.43799999999999994,27,37,0.73,24,64,88,103,33,0,49,87,203
Shandon Anderson,SF-SG,31,TOT,66,5,1171,98,217,0.452,5,29,0.172,93,188,0.495,0.46299999999999997,54,66,0.818,41,150,191,70,40,14,50,138,255
Carmelo Anthony,SF,20,DEN,75,75,2608,530,1230,0.431,42,158,0.266,488,1072,0.455,0.44799999999999995,456,573,0.7959999999999999,141,285,426,194,68,30,224,229,1558
Rafael Araújo,C,24,TOR,59,41,736,76,175,0.434,1,3,0.33299999999999996,75,172,0.436,0.43700000000000006,43,55,0.782,59,126,185,16,21,8,52,157,196
Gilbert Arenas,PG,23,WAS,80,80,3274,656,1523,0.431,205,562,0.365,451,961,0.469,0.498,521,640,0.8140000000000001,83,295,378,411,139,23,242,245,2038
Trevor Ariza,SF,19,NYK,80,12,1382,172,389,0.442,3,13,0.231,169,376,0.449,0.446,121,174,0.695,89,153,242,85,70,18,73,150,468
Darrell Armstrong,PG,36,TOT,66,16,988,89,277,0.321,28,111,0.252,61,166,0.36700000000000005,0.37200000000000005,58,68,0.853,35,80,115,178,45,8,67,92,264
Carlos Arroyo,PG,25,TOT,70,16,1448,167,429,0.389,8,30,0.267,159,399,0.39799999999999996,0.39899999999999997,119,149,0.799,26,78,104,280,44,4,107,143,461
Chucky Atkins,PG,30,LAL,82,82,2903,388,910,0.426,176,455,0.387,212,455,0.466,0.523,163,203,0.8029999999999999,31,166,197,358,73,2,151,181,1115
Stacey Augmon,SF,36,ORL,55,7,663,68,167,0.40700000000000003,0,0,0.0,68,167,0.40700000000000003,0.40700000000000003,57,77,0.74,45,54,99,36,23,8,31,83,193
Maurice Baker,PG,25,TOT,5,0,19,0,1,0.0,0,0,0.0,0,1,0.0,0.0,0,0,0.0,1,1,2,1,1,0,1,3,0
Vin Baker,PF-C,33,TOT,27,0,204,13,42,0.31,0,1,0.0,13,41,0.317,0.31,9,17,0.529,17,22,39,10,2,4,17,38,35
Marcus Banks,PG,23,BOS,81,2,1145,115,286,0.402,21,59,0.35600000000000004,94,227,0.414,0.439,121,163,0.742,29,97,126,155,63,13,79,146,372
Leandro Barbosa,PG,22,PHO,63,6,1087,168,354,0.475,51,139,0.36700000000000005,117,215,0.544,0.547,55,69,0.797,32,98,130,126,30,7,87,127,442
Matt Barnes,SF,24,SAC,43,9,715,62,151,0.41100000000000003,5,22,0.22699999999999998,57,129,0.442,0.42700000000000005,35,58,0.603,49,84,133,57,30,7,45,80,164
Andre Barrett,PG,22,TOT,38,1,483,45,124,0.363,14,52,0.26899999999999996,31,72,0.431,0.419,14,19,0.737,11,29,40,69,19,1,27,51,118
Brent Barry,SG,33,SAS,81,8,1742,194,459,0.423,100,280,0.35700000000000004,94,179,0.525,0.532,113,135,0.8370000000000001,29,161,190,178,39,20,64,123,601
Jon Barry,SG,35,TOT,69,2,1505,161,368,0.43799999999999994,71,165,0.43,90,203,0.44299999999999995,0.534,62,71,0.873,26,133,159,167,60,9,67,95,455
Tony Battie,C,28,ORL,81,32,1894,163,354,0.46,0,6,0.0,163,348,0.46799999999999997,0.46,68,94,0.723,109,343,452,42,30,81,81,244,394
Shane Battier,SG,26,MEM,80,72,2516,271,613,0.442,70,177,0.395,201,436,0.461,0.499,180,228,0.789,158,255,413,126,91,77,75,201,792
Lonny Baxter,PF,26,NOH,4,0,36,3,11,0.273,0,0,0.0,3,11,0.273,0.273,0,2,0.0,4,4,8,0,0,0,4,10,6
Raja Bell,SG,28,UTA,63,32,1790,303,667,0.45399999999999996,54,134,0.40299999999999997,249,533,0.467,0.495,112,150,0.747,48,153,201,91,44,8,79,205,772
Jonathan Bender,SF,24,IND,7,0,93,16,40,0.4,1,5,0.2,15,35,0.429,0.413,3,6,0.5,5,9,14,4,1,2,10,9,36
Travis Best,PG,32,NJN,76,6,1461,190,452,0.42,26,85,0.306,164,367,0.447,0.449,108,122,0.885,19,88,107,143,66,9,67,148,514
Mike Bibby,PG,26,SAC,80,80,3084,560,1264,0.44299999999999995,131,364,0.36,429,900,0.47700000000000004,0.495,320,413,0.775,77,255,332,541,124,30,203,191,1571
Andris Biedriņš,C,18,GSW,30,1,384,45,78,0.5770000000000001,0,1,0.0,45,77,0.584,0.5770000000000001,19,40,0.475,47,71,118,12,12,24,12,87,109
Chauncey Billups,PG,28,DET,80,80,2866,404,913,0.442,165,387,0.426,239,526,0.45399999999999996,0.5329999999999999,343,382,0.898,48,223,271,464,81,9,180,194,1316
Steve Blake,PG,24,WAS,44,1,648,61,186,0.32799999999999996,36,93,0.387,25,93,0.26899999999999996,0.425,33,41,0.805,18,53,71,69,13,0,39,47,191
Mark Blount,C,29,BOS,82,57,2130,327,618,0.529,0,1,0.0,327,617,0.53,0.529,117,164,0.713,143,254,397,129,33,64,158,229,771
Tony Bobbitt,SG,25,LAL,2,0,12,2,5,0.4,1,2,0.5,1,3,0.33299999999999996,0.5,0,0,0.0,0,3,3,0,0,0,0,1,5
Keith Bogans,SG,24,CHA,74,42,1791,262,688,0.381,57,173,0.32899999999999996,205,515,0.39799999999999996,0.42200000000000004,133,183,0.727,76,150,226,135,68,8,122,167,714
Matt Bonner,C,24,TOR,82,0,1553,247,463,0.5329999999999999,39,92,0.424,208,371,0.561,0.5760000000000001,56,71,0.789,108,177,285,48,39,19,40,220,589
Calvin Booth,C,28,TOT,51,1,451,49,108,0.45399999999999996,0,1,0.0,49,107,0.45799999999999996,0.45399999999999996,26,32,0.813,29,78,107,8,15,28,16,78,124
Carlos Boozer,PF,23,UTA,51,51,1772,361,693,0.521,0,1,0.0,361,692,0.522,0.521,187,268,0.698,141,316,457,144,41,24,137,179,909
Curtis Borchardt,C,24,UTA,67,23,859,74,172,0.43,0,0,0.0,74,172,0.43,0.43,52,71,0.732,86,138,224,49,10,32,52,160,200
Chris Bosh,PF,20,TOR,81,81,3017,473,1005,0.47100000000000003,3,10,0.3,470,995,0.47200000000000003,0.47200000000000003,412,542,0.76,194,524,718,153,76,113,187,226,1361
Bruce Bowen,SF,33,SAS,82,82,2627,251,598,0.42,102,253,0.40299999999999997,149,345,0.43200000000000005,0.505,71,112,0.634,50,235,285,126,55,39,57,175,675
Ryan Bowen,SF,29,HOU,66,6,604,47,111,0.423,3,6,0.5,44,105,0.419,0.43700000000000006,14,21,0.667,21,55,76,18,23,5,7,61,111
Earl Boykins,PG,28,DEN,82,5,2162,340,824,0.413,56,166,0.337,284,658,0.43200000000000005,0.447,279,303,0.9209999999999999,37,106,143,372,78,12,121,122,1015
Michael Bradley,PF,25,TOT,18,0,119,15,24,0.625,0,1,0.0,15,23,0.652,0.625,3,8,0.375,8,20,28,5,1,2,5,12,33
Shawn Bradley,C,32,DAL,77,14,885,84,186,0.452,0,0,0.0,84,186,0.452,0.452,43,63,0.6829999999999999,70,144,214,15,25,63,33,153,211
Torraye Braggs,PF,28,HOU,7,0,24,3,7,0.429,0,0,0.0,3,7,0.429,0.429,0,0,0.0,7,5,12,0,0,0,2,4,6
Elton Brand,PF,25,LAC,81,81,3001,629,1251,0.503,0,3,0.0,629,1248,0.504,0.503,364,484,0.752,296,474,770,208,62,169,183,240,1622
Jamison Brewer,PG,24,NYK,18,0,185,11,37,0.297,3,15,0.2,8,22,0.364,0.33799999999999997,6,13,0.462,6,16,22,12,8,1,13,11,31
Primož Brezec,C,25,CHA,72,72,2276,387,756,0.512,0,0,0.0,387,756,0.512,0.512,164,220,0.745,226,305,531,86,33,55,106,183,938
Damone Brown,SF,25,WAS,14,0,152,23,62,0.371,4,11,0.364,19,51,0.373,0.40299999999999997,4,9,0.444,10,18,28,14,1,6,15,17,54
Devin Brown,SG,26,SAS,67,0,1238,173,409,0.423,45,121,0.37200000000000005,128,288,0.444,0.478,103,130,0.792,37,139,176,92,39,12,53,83,494
Kedrick Brown,SF,23,PHI,8,0,55,2,6,0.33299999999999996,0,3,0.0,2,3,0.667,0.33299999999999996,8,10,0.8,1,10,11,4,3,1,5,4,12
Kwame Brown,PF,22,WAS,42,14,908,109,237,0.46,0,0,0.0,109,237,0.46,0.46,74,129,0.574,72,134,206,39,25,15,67,112,292
P.J. Brown,PF,35,NOH,82,78,2817,338,758,0.446,0,0,0.0,338,758,0.446,0.446,210,243,0.8640000000000001,266,471,737,178,74,50,101,233,886
Tierre Brown,PG,25,LAL,76,0,1066,124,348,0.35600000000000004,26,72,0.361,98,276,0.355,0.39399999999999996,59,75,0.787,21,72,93,155,32,1,74,59,333
Rick Brunson,PG,32,LAC,80,39,1945,166,442,0.376,48,130,0.369,118,312,0.37799999999999995,0.43,57,74,0.77,23,164,187,410,82,7,125,106,437
Kobe Bryant,SG,26,LAL,66,66,2689,573,1324,0.433,131,387,0.33899999999999997,442,937,0.47200000000000003,0.48200000000000004,542,664,0.816,95,297,392,398,86,53,270,174,1819
Greg Buckner,SG,28,DEN,70,41,1522,160,303,0.528,49,121,0.405,111,182,0.61,0.609,63,81,0.778,66,142,208,133,75,6,49,169,432
Rodney Buford,SF,27,NJN,64,17,1313,187,489,0.382,34,108,0.315,153,381,0.402,0.41700000000000004,37,45,0.8220000000000001,33,156,189,63,40,4,35,101,445
Antonio Burks,PG,24,MEM,24,0,219,28,60,0.467,3,11,0.273,25,49,0.51,0.49200000000000005,14,19,0.737,1,11,12,28,13,1,12,25,73
Caron Butler,SF,24,LAL,77,77,2746,441,991,0.445,38,125,0.304,403,866,0.465,0.46399999999999997,275,319,0.862,146,304,450,146,110,23,125,213,1195
Jackie Butler,C,19,NYK,3,0,5,4,4,1.0,0,0,0.0,4,4,1.0,1.0,2,2,1.0,0,0,0,0,1,0,1,0,10
Rasual Butler,SF,25,MIA,65,15,1203,163,409,0.39899999999999997,57,153,0.373,106,256,0.414,0.46799999999999997,37,48,0.7709999999999999,15,136,151,62,18,29,37,104,420
Žarko Čabarkapa,PF,23,TOT,40,0,475,86,177,0.486,13,36,0.361,73,141,0.518,0.523,53,65,0.815,35,67,102,25,10,5,30,59,238
Marcus Camby,C,30,DEN,66,66,2015,279,600,0.465,0,4,0.0,279,596,0.46799999999999997,0.465,125,173,0.723,131,530,661,152,61,199,103,177,683
Elden Campbell,C,36,TOT,40,1,390,39,123,0.317,0,2,0.0,39,121,0.322,0.317,42,55,0.764,28,65,93,19,8,7,29,57,120
Brian Cardinal,PF,27,MEM,58,16,1433,160,432,0.37,44,125,0.35200000000000004,116,307,0.37799999999999995,0.42100000000000004,158,181,0.873,63,162,225,114,88,19,83,172,522
Geno Carlisle,SG,28,POR,6,0,16,2,3,0.667,0,0,0.0,2,3,0.667,0.667,4,6,0.667,1,0,1,1,0,0,1,1,8
Matt Carroll,SG,24,CHA,25,0,430,70,180,0.389,13,39,0.33299999999999996,57,141,0.40399999999999997,0.425,71,83,0.855,13,47,60,17,17,2,25,37,224
Anthony Carter,PG,29,MIN,66,12,742,72,177,0.40700000000000003,2,17,0.11800000000000001,70,160,0.43799999999999994,0.41200000000000003,35,51,0.6859999999999999,12,57,69,161,35,18,62,88,181
Vince Carter,SF-SG,28,TOT,77,76,2828,696,1541,0.452,127,313,0.406,569,1228,0.46299999999999997,0.493,367,460,0.7979999999999999,106,295,401,327,109,48,168,243,1886
Sam Cassell,PG,35,MIN,59,38,1522,319,687,0.46399999999999997,27,103,0.262,292,584,0.5,0.484,134,155,0.865,25,132,157,301,36,14,109,160,799
Kelvin Cato,C,30,ORL,62,50,1525,160,297,0.539,0,0,0.0,160,297,0.539,0.539,112,143,0.7829999999999999,102,314,416,40,55,82,64,170,432
Lionel Chalmers,PG,24,LAC,36,0,433,42,125,0.336,12,49,0.245,30,76,0.395,0.384,15,24,0.625,4,27,31,51,13,0,24,30,111
Tyson Chandler,C,22,CHI,80,10,2189,207,419,0.494,0,2,0.0,207,417,0.496,0.494,226,336,0.6729999999999999,261,514,775,65,69,141,118,268,640
Calbert Cheaney,SG,33,GSW,55,5,951,113,265,0.426,0,3,0.0,113,262,0.431,0.426,24,37,0.649,32,92,124,64,17,15,35,95,250
Josh Childress,SG,21,ATL,80,44,2376,302,642,0.47,13,56,0.23199999999999998,289,586,0.493,0.48100000000000004,190,231,0.823,195,287,482,151,74,35,106,184,807
Doug Christie,SG,34,TOT,52,44,1525,130,332,0.392,15,62,0.242,115,270,0.426,0.414,70,78,0.897,38,139,177,199,80,18,104,106,345
Speedy Claxton,PG,26,TOT,62,47,1866,257,611,0.42100000000000004,11,61,0.18,246,550,0.447,0.43,187,254,0.736,37,147,184,374,109,8,119,184,712
Mateen Cleaves,PG,27,SEA,14,0,65,5,14,0.35700000000000004,0,2,0.0,5,12,0.41700000000000004,0.35700000000000004,3,4,0.75,2,4,6,7,2,0,2,2,13
Derrick Coleman,C,37,DET,5,0,50,3,14,0.214,0,2,0.0,3,12,0.25,0.214,3,3,1.0,3,12,15,0,0,0,2,6,9
Jason Collier,C,27,ATL,70,44,942,174,376,0.46299999999999997,6,14,0.429,168,362,0.46399999999999997,0.47100000000000003,48,71,0.6759999999999999,84,100,184,18,15,13,63,147,402
Jarron Collins,C,26,UTA,50,38,961,65,157,0.414,0,1,0.0,65,156,0.41700000000000004,0.414,83,119,0.6970000000000001,57,107,164,61,11,6,34,146,213
Jason Collins,C,26,NJN,80,80,2542,186,451,0.41200000000000003,2,6,0.33299999999999996,184,445,0.413,0.415,137,209,0.6559999999999999,153,335,488,105,71,71,91,322,511
Nick Collison,C,24,SEA,82,4,1396,190,354,0.537,0,3,0.0,190,351,0.541,0.537,83,118,0.703,156,220,376,32,34,50,62,252,463
Brian Cook,C,24,LAL,72,0,1087,176,422,0.41700000000000004,78,199,0.392,98,223,0.439,0.509,28,37,0.757,63,153,216,35,23,26,29,139,458
Omar Cook,PG,23,TOR,5,0,74,10,24,0.41700000000000004,0,4,0.0,10,20,0.5,0.41700000000000004,3,6,0.5,2,5,7,22,6,1,6,6,23
Jamal Crawford,SG,24,NYK,70,67,2688,437,1097,0.39799999999999996,185,512,0.361,252,585,0.431,0.483,182,216,0.843,33,170,203,302,92,19,148,135,1241
Austin Croshere,PF,29,IND,73,22,1827,188,497,0.37799999999999995,45,174,0.259,143,323,0.44299999999999995,0.424,226,256,0.883,103,272,375,98,48,17,104,154,647
Eddy Curry,C,22,CHI,63,60,1808,393,730,0.5379999999999999,0,0,0.0,393,730,0.5379999999999999,0.5379999999999999,226,314,0.72,116,222,338,37,21,58,163,202,1012
Michael Curry,SF,36,IND,18,7,249,13,29,0.44799999999999995,0,0,0.0,13,29,0.44799999999999995,0.44799999999999995,4,8,0.5,8,19,27,15,5,4,5,39,30
Samuel Dalembert,C,23,PHI,72,60,1785,250,477,0.524,0,0,0.0,250,477,0.524,0.524,89,148,0.601,187,355,542,35,46,121,114,241,589
Erick Dampier,C,29,DAL,59,56,1609,202,367,0.55,0,3,0.0,202,364,0.555,0.55,138,228,0.605,183,318,501,51,15,80,102,205,542
Antonio Daniels,PG,29,SEA,75,2,2026,273,623,0.43799999999999994,49,165,0.297,224,458,0.489,0.478,248,304,0.816,20,149,169,309,51,3,78,78,843
Erik Daniels,SF,22,SAC,21,0,72,6,18,0.33299999999999996,1,2,0.5,5,16,0.313,0.361,0,0,0.0,7,11,18,4,2,0,6,7,13
Marquis Daniels,SG,24,DAL,60,17,1412,220,504,0.43700000000000006,7,35,0.2,213,469,0.45399999999999996,0.44299999999999995,98,133,0.737,87,129,216,128,83,14,86,124,545
Antonio Davis,PF,36,CHI,72,62,1843,193,419,0.461,0,0,0.0,193,419,0.461,0.461,115,152,0.757,152,276,428,80,27,41,96,147,501
Baron Davis,PG,25,TOT,46,32,1581,291,752,0.387,118,354,0.33299999999999996,173,398,0.435,0.465,185,243,0.7609999999999999,32,143,175,362,81,14,131,126,885
Dale Davis,C,35,TOT,61,28,1307,112,234,0.479,0,0,0.0,112,234,0.479,0.479,60,99,0.606,152,223,375,47,32,65,43,162,284
Josh Davis,PF,24,PHI,42,5,328,42,111,0.37799999999999995,19,53,0.358,23,58,0.397,0.46399999999999997,14,17,0.8240000000000001,29,50,79,12,8,4,15,45,117
Ricky Davis,SG,25,BOS,82,11,2696,481,1041,0.462,61,180,0.33899999999999997,420,861,0.488,0.491,286,351,0.815,66,183,249,246,89,27,205,174,1309
Andrew DeClercq,C,31,ORL,8,0,49,4,9,0.444,0,0,0.0,4,9,0.444,0.444,1,3,0.33299999999999996,7,3,10,0,2,0,1,14,9
Carlos Delfino,SG,22,DET,30,4,459,42,117,0.359,9,35,0.257,33,82,0.402,0.397,23,40,0.575,13,42,55,38,22,6,23,44,116
Tony Delk,SG,31,ATL,56,1,1340,246,591,0.41600000000000004,72,202,0.35600000000000004,174,389,0.447,0.47700000000000004,103,136,0.757,28,102,130,104,47,3,54,123,667
Luol Deng,SF,19,CHI,61,45,1663,280,645,0.434,31,117,0.265,249,528,0.47200000000000003,0.45799999999999996,120,162,0.741,92,230,322,135,48,27,118,98,711
Boris Diaw,SG,22,ATL,66,25,1201,124,294,0.42200000000000004,9,50,0.18,115,244,0.47100000000000003,0.43700000000000006,57,77,0.74,54,116,170,149,37,18,87,123,314
Dan Dickau,PG,26,TOT,71,46,2090,306,756,0.405,85,245,0.34700000000000003,221,511,0.43200000000000005,0.461,190,228,0.833,34,146,180,347,76,4,145,201,887
Kaniel Dickens,SF,26,NJN,11,0,61,4,14,0.28600000000000003,3,9,0.33299999999999996,1,5,0.2,0.39299999999999996,2,2,1.0,3,6,9,1,2,1,2,5,13
DeSagana Diop,C,23,CLE,39,0,306,20,69,0.29,0,2,0.0,20,67,0.299,0.29,0,5,0.0,30,40,70,15,8,27,12,53,40
Vlade Divac*,C,36,LAL,15,0,130,13,31,0.419,0,0,0.0,13,31,0.419,0.419,8,12,0.667,18,14,32,19,4,1,14,25,34
Juan Dixon,SG,26,WAS,63,4,1054,186,447,0.41600000000000004,48,147,0.327,138,300,0.46,0.47,87,97,0.897,32,87,119,111,43,4,68,98,507
Michael Doleac,C,27,MIA,80,8,1175,148,331,0.447,0,2,0.0,148,329,0.45,0.447,25,41,0.61,74,185,259,47,23,22,36,160,321
Keyon Dooling,PG,24,MIA,74,0,1184,139,345,0.40299999999999997,19,75,0.253,120,270,0.444,0.43,85,109,0.78,11,79,90,132,39,11,65,120,382
Predrag Drobnjak,C,29,ATL,71,1,1435,238,543,0.43799999999999994,25,71,0.35200000000000004,213,472,0.451,0.461,96,120,0.8,73,165,238,49,42,24,78,138,597
Chris Duhon,PG,22,CHI,82,73,2177,172,488,0.35200000000000004,94,265,0.355,78,223,0.35,0.449,49,67,0.731,23,190,213,398,82,3,119,205,487
Tim Duncan,PF,28,SAS,66,66,2203,517,1042,0.496,3,9,0.33299999999999996,514,1033,0.498,0.498,305,455,0.67,202,530,732,179,45,174,127,144,1342
Mike Dunleavy,SF,24,GSW,79,79,2570,408,905,0.451,107,276,0.38799999999999996,301,629,0.479,0.51,134,172,0.779,97,338,435,203,79,26,132,198,1057
Ronald Dupree,SF,24,DET,47,0,472,61,127,0.48,1,2,0.5,60,125,0.48,0.484,29,47,0.617,34,61,95,24,7,10,22,60,152
Ndudi Ebi,SG,20,MIN,2,0,54,11,21,0.524,0,1,0.0,11,20,0.55,0.524,5,9,0.556,6,10,16,1,1,1,3,7,27
Corsley Edwards,C,25,NOH,10,0,110,10,31,0.32299999999999995,0,0,0.0,10,31,0.32299999999999995,0.32299999999999995,7,12,0.583,12,13,25,3,3,4,2,19,27
John Edwards,C,23,IND,25,1,139,11,30,0.36700000000000005,0,0,0.0,11,30,0.36700000000000005,0.36700000000000005,7,14,0.5,8,11,19,3,3,4,8,12,29
Howard Eisley,PG,32,UTA,74,1,1428,161,405,0.39799999999999996,27,103,0.262,134,302,0.444,0.431,66,83,0.795,15,75,90,250,45,9,111,156,415
Obinna Ekezie,C,29,ATL,42,31,732,79,182,0.434,0,1,0.0,79,181,0.436,0.434,72,93,0.774,69,110,179,11,22,12,45,129,230
Francisco Elson,C,28,DEN,67,11,939,101,216,0.46799999999999997,1,3,0.33299999999999996,100,213,0.469,0.47,45,79,0.57,61,140,201,34,34,41,40,129,248
Melvin Ely,PF,26,CHA,79,17,1649,227,526,0.43200000000000005,0,0,0.0,227,526,0.43200000000000005,0.43200000000000005,122,212,0.575,142,184,326,76,32,69,115,199,576
Andre Emmett,SG,22,MEM,8,0,28,2,6,0.33299999999999996,0,0,0.0,2,6,0.33299999999999996,0.33299999999999996,3,5,0.6,0,2,2,0,0,0,1,4,7
Maurice Evans,SG,26,SAC,65,11,1233,165,373,0.442,27,82,0.32899999999999996,138,291,0.474,0.479,59,78,0.7559999999999999,88,113,201,45,37,8,34,104,416
Reggie Evans,PF,24,SEA,79,79,1881,131,275,0.47600000000000003,0,2,0.0,131,273,0.48,0.47600000000000003,125,234,0.534,254,482,736,58,58,15,104,202,387
Michael Finley,SG,31,DAL,64,64,2358,387,907,0.42700000000000005,116,285,0.40700000000000003,271,622,0.436,0.491,113,136,0.831,45,217,262,169,48,18,60,123,1003
Derek Fisher,PG,30,GSW,74,32,2222,297,755,0.39299999999999996,108,291,0.371,189,464,0.40700000000000003,0.465,175,203,0.862,38,180,218,301,76,4,129,176,877
Marcus Fizer,PF,26,MIL,54,0,903,133,292,0.455,0,6,0.0,133,286,0.465,0.455,70,103,0.68,29,146,175,64,25,13,63,96,336
Luis Flores,PG,23,TOT,16,0,77,14,29,0.483,5,10,0.5,9,19,0.474,0.569,2,2,1.0,1,2,3,11,2,0,11,9,35
Danny Fortson,C,28,SEA,62,0,1047,118,226,0.522,0,0,0.0,118,226,0.522,0.522,227,258,0.88,157,191,348,8,15,7,91,265,463
Jeff Foster,C,28,IND,61,43,1594,168,324,0.519,0,5,0.0,168,319,0.527,0.519,90,142,0.634,205,345,550,43,46,12,55,186,426
Tremaine Fowlkes,SF,28,IND,8,0,56,9,17,0.529,1,3,0.33299999999999996,8,14,0.5710000000000001,0.5589999999999999,0,2,0.0,3,5,8,0,2,0,5,7,19
Adonal Foyle,C,29,GSW,78,50,1700,156,311,0.502,0,0,0.0,156,311,0.502,0.502,40,72,0.556,165,264,429,56,26,159,58,201,352
Richie Frahm,SG,27,POR,43,0,499,56,140,0.4,31,80,0.38799999999999996,25,60,0.41700000000000004,0.511,21,25,0.84,17,44,61,30,15,4,14,35,164
Steve Francis,PG,27,ORL,78,78,2978,563,1330,0.423,38,127,0.299,525,1203,0.436,0.43799999999999994,499,606,0.823,126,324,450,547,112,28,317,273,1663
Matt Freije,PF,23,NOH,23,11,441,37,127,0.29100000000000004,14,54,0.259,23,73,0.315,0.34600000000000003,5,8,0.625,16,45,61,20,13,2,17,40,93
Lawrence Funderburke,PF,34,CHI,2,0,21,3,6,0.5,0,0,0.0,3,6,0.5,0.5,3,5,0.6,1,2,3,0,0,0,0,2,9
Dan Gadzuric,C,26,MIL,81,81,1783,243,451,0.539,0,0,0.0,243,451,0.539,0.539,107,199,0.5379999999999999,261,413,674,30,47,106,81,224,593
Reece Gaines,PG,24,TOT,21,0,187,17,50,0.34,4,14,0.28600000000000003,13,36,0.361,0.38,3,4,0.75,1,13,14,7,5,1,7,17,41
Alex Garcia,SG,24,NOH,8,3,146,18,52,0.34600000000000003,5,18,0.278,13,34,0.382,0.39399999999999996,3,4,0.75,7,8,15,18,4,1,8,15,44
Kevin Garnett,PF,28,MIN,82,82,3121,683,1360,0.502,6,25,0.24,677,1335,0.507,0.504,445,549,0.8109999999999999,247,861,1108,466,121,112,222,207,1817
Pat Garrity,PF,28,ORL,71,0,955,123,306,0.402,49,147,0.33299999999999996,74,159,0.465,0.48200000000000004,29,33,0.879,21,103,124,30,19,9,30,107,324
Pau Gasol,PF,24,MEM,56,53,1790,357,695,0.514,1,6,0.16699999999999998,356,689,0.517,0.514,282,367,0.768,130,280,410,135,37,93,137,146,997
Devean George,SF,27,LAL,15,3,306,37,104,0.35600000000000004,21,58,0.36200000000000004,16,46,0.348,0.457,15,20,0.75,13,40,53,14,8,2,12,32,110
Eddie Gill,PG,26,IND,73,3,1021,81,242,0.335,36,117,0.308,45,125,0.36,0.409,71,81,0.877,16,96,112,83,59,5,60,105,269
Kendall Gill,SG,36,MIL,14,0,284,32,80,0.4,3,9,0.33299999999999996,29,71,0.408,0.419,18,20,0.9,11,26,37,27,14,4,9,37,85
Manu Ginóbili,SG,27,SAS,74,74,2193,367,780,0.47100000000000003,97,258,0.376,270,522,0.517,0.5329999999999999,355,442,0.8029999999999999,75,254,329,288,119,27,172,190,1186
Gordan Giriček,SG,27,UTA,81,44,1660,283,632,0.44799999999999995,38,105,0.36200000000000004,245,527,0.465,0.478,111,137,0.81,25,157,182,137,46,11,90,155,715
Dion Glover,SG,26,SAS,7,0,68,8,22,0.364,1,8,0.125,7,14,0.5,0.386,8,10,0.8,3,8,11,4,3,3,2,9,25
Anthony Goldwire,PG,33,TOT,33,2,537,57,136,0.419,32,80,0.4,25,56,0.446,0.537,26,31,0.8390000000000001,10,49,59,78,15,0,15,32,172
Drew Gooden,PF,23,CLE,82,80,2523,464,943,0.49200000000000005,5,28,0.179,459,915,0.502,0.495,251,310,0.81,207,546,753,130,77,76,133,233,1184
Ben Gordon,SG,21,CHI,82,3,2002,434,1056,0.41100000000000003,134,331,0.405,300,725,0.414,0.474,233,270,0.863,55,160,215,164,53,10,186,224,1235
Brian Grant,C,32,LAL,69,8,1136,103,209,0.493,0,0,0.0,103,209,0.493,0.493,57,79,0.722,101,156,257,34,23,23,43,175,263
Willie Green,SG,23,PHI,57,21,1066,155,423,0.366,30,105,0.28600000000000003,125,318,0.39299999999999996,0.402,97,125,0.7759999999999999,22,111,133,100,34,6,75,121,437
Adrian Griffin,SF,30,CHI,69,1,667,58,161,0.36,2,9,0.222,56,152,0.368,0.366,33,44,0.75,52,94,146,53,43,4,30,78,151
Eddie Griffin,PF,22,MIN,70,0,1492,202,522,0.387,67,204,0.32799999999999996,135,318,0.425,0.451,56,78,0.718,128,325,453,53,23,118,55,120,527
Tom Gugliotta,PF,35,TOT,47,9,966,99,241,0.41100000000000003,8,26,0.308,91,215,0.423,0.42700000000000005,33,43,0.767,56,135,191,68,41,17,57,104,239
Marcus Haislip,PF,24,IND,9,0,106,13,38,0.342,0,1,0.0,13,37,0.35100000000000003,0.342,6,11,0.545,5,10,15,3,2,2,6,15,32
Darvin Ham,SF,31,DET,47,0,275,17,37,0.45899999999999996,0,0,0.0,17,37,0.45899999999999996,0.45899999999999996,12,31,0.387,19,16,35,5,6,7,8,39,46
Richard Hamilton,SG,26,DET,76,76,2926,510,1160,0.44,36,118,0.305,474,1042,0.455,0.455,368,429,0.858,74,221,295,372,77,13,217,232,1424
Zendon Hamilton,C,29,MIL,16,0,159,11,32,0.344,0,0,0.0,11,32,0.344,0.344,29,48,0.604,18,24,42,6,5,2,12,26,51
Ben Handlogten,C,31,UTA,21,5,297,43,83,0.518,0,1,0.0,43,82,0.524,0.518,9,17,0.529,23,42,65,13,7,5,18,55,95
Anfernee Hardaway,SF,33,NYK,37,0,894,110,260,0.423,15,50,0.3,95,210,0.452,0.452,34,46,0.7390000000000001,19,70,89,74,28,3,50,79,269
Matt Harpring,SF,28,UTA,78,55,2584,418,855,0.489,9,43,0.209,409,812,0.504,0.494,245,315,0.778,196,284,480,142,70,16,133,250,1090
Al Harrington,SF,24,ATL,66,66,2550,453,986,0.45899999999999996,16,74,0.21600000000000003,437,912,0.479,0.46799999999999997,236,351,0.672,145,316,461,208,85,16,204,249,1158
Junior Harrington,SG,24,NOH,29,7,550,64,178,0.36,6,19,0.316,58,159,0.365,0.376,29,35,0.8290000000000001,13,50,63,62,25,5,41,72,163
Othella Harrington,PF,31,CHI,70,28,1271,217,424,0.512,0,0,0.0,217,424,0.512,0.512,127,177,0.718,106,186,292,56,24,18,84,188,561
Devin Harris,PG,21,DAL,76,19,1173,157,366,0.429,44,131,0.336,113,235,0.48100000000000004,0.489,78,103,0.757,28,74,102,169,77,19,82,139,436
Lucious Harris,SG,34,CLE,73,4,1128,118,299,0.395,21,65,0.32299999999999995,97,234,0.415,0.43,56,69,0.812,39,82,121,49,27,6,29,68,313
David Harrison,C,22,IND,43,14,760,106,184,0.5760000000000001,0,0,0.0,106,184,0.5760000000000001,0.5760000000000001,52,91,0.5710000000000001,48,87,135,13,16,55,53,134,264
Jason Hart,PG,26,CHA,74,27,1887,257,573,0.449,35,95,0.368,222,478,0.46399999999999997,0.479,157,200,0.785,18,185,203,367,99,14,102,167,706
Donnell Harvey,PF,24,NJN,3,0,16,2,2,1.0,0,0,0.0,2,2,1.0,1.0,4,4,1.0,2,5,7,1,1,1,1,2,8
Udonis Haslem,PF,24,MIA,80,80,2675,346,641,0.54,0,4,0.0,346,637,0.5429999999999999,0.54,178,225,0.7909999999999999,239,487,726,108,63,41,113,260,870
Trenton Hassell,SG,25,MIN,82,51,2068,225,475,0.474,1,11,0.091,224,464,0.483,0.475,90,114,0.789,80,139,219,128,30,30,64,200,541
Jarvis Hayes,SF,23,WAS,54,22,1560,206,530,0.389,42,123,0.341,164,407,0.40299999999999997,0.428,99,118,0.8390000000000001,41,186,227,90,49,9,62,107,553
Brendan Haywood,C,25,WAS,68,68,1865,239,427,0.56,0,0,0.0,239,427,0.56,0.56,159,261,0.609,202,262,464,57,52,114,96,218,637
Alan Henderson,PF,32,DAL,78,10,1203,116,220,0.527,0,2,0.0,116,218,0.532,0.527,41,76,0.539,164,184,348,21,29,37,49,149,273
Nenê Hilário,C,22,DEN,55,18,1317,194,386,0.503,0,2,0.0,194,384,0.505,0.503,140,212,0.66,104,221,325,84,50,48,94,167,528
Grant Hill*,SF,32,ORL,67,67,2338,517,1015,0.509,3,13,0.231,514,1002,0.513,0.511,280,341,0.821,77,241,318,220,97,28,161,144,1317
Kirk Hinrich,PG,24,CHI,77,77,2800,445,1122,0.397,145,408,0.355,300,714,0.42,0.461,171,216,0.792,32,272,304,494,122,21,176,244,1206
Fred Hoiberg,SG,32,MIN,76,0,1272,139,284,0.489,70,145,0.483,69,139,0.496,0.613,89,102,0.873,32,149,181,85,50,15,20,105,437
Robert Horry,PF,34,SAS,75,16,1396,157,375,0.419,51,138,0.37,106,237,0.447,0.48700000000000004,86,109,0.789,91,177,268,80,67,60,69,138,451
Eddie House,PG-SG,26,TOT,68,7,891,165,366,0.451,44,97,0.45399999999999996,121,269,0.45,0.511,23,27,0.852,16,67,83,96,44,6,35,65,397
Allan Houston,SG,33,NYK,20,11,532,85,205,0.415,31,80,0.38799999999999996,54,125,0.43200000000000005,0.49,36,43,0.8370000000000001,4,19,23,42,8,2,21,40,237
Dwight Howard,PF,19,ORL,82,82,2670,352,677,0.52,0,2,0.0,352,675,0.521,0.52,277,413,0.6709999999999999,287,536,823,75,77,136,165,232,981
Josh Howard,SF,24,DAL,76,76,2446,377,793,0.475,34,115,0.29600000000000004,343,678,0.506,0.49700000000000005,170,232,0.733,169,315,484,109,116,49,122,211,958
Juwan Howard,PF,31,HOU,61,47,1624,244,541,0.451,0,1,0.0,244,540,0.452,0.451,97,115,0.843,126,220,346,94,32,5,79,143,585
Troy Hudson,PG,28,MIN,79,32,1729,266,664,0.401,89,258,0.345,177,406,0.436,0.46799999999999997,70,90,0.778,19,86,105,283,27,6,113,121,691
Larry Hughes,SG,26,WAS,61,61,2358,467,1086,0.43,59,209,0.282,408,877,0.465,0.457,352,453,0.777,74,308,382,285,176,18,153,168,1345
Ryan Humphrey,SF,25,MEM,35,0,317,42,103,0.408,0,2,0.0,42,101,0.41600000000000004,0.408,18,37,0.486,50,37,87,6,10,1,23,35,102
Kris Humphries,PF,19,UTA,67,4,873,116,287,0.40399999999999997,2,6,0.33299999999999996,114,281,0.406,0.408,44,101,0.436,73,124,197,43,25,18,52,96,278
Brandon Hunter,PF,24,ORL,31,0,224,37,73,0.507,0,0,0.0,37,73,0.507,0.507,21,39,0.5379999999999999,25,44,69,3,4,7,22,42,95
Lindsey Hunter,SG,34,DET,76,3,1144,108,302,0.358,23,84,0.27399999999999997,85,218,0.39,0.396,46,58,0.7929999999999999,38,85,123,130,68,13,68,125,285
Steven Hunter,C,23,PHO,76,3,1046,135,220,0.614,0,1,0.0,135,219,0.616,0.614,78,163,0.479,98,129,227,13,4,102,44,131,348
Andre Iguodala,SG,21,PHI,82,82,2686,269,546,0.493,47,142,0.331,222,404,0.55,0.536,156,210,0.743,89,375,464,246,138,48,139,204,741
Zydrunas Ilgauskas,C,29,CLE,78,78,2615,458,979,0.46799999999999997,2,7,0.28600000000000003,456,972,0.469,0.469,402,503,0.799,299,373,672,100,53,165,191,313,1320
Didier Ilunga-Mbenga,C,24,DAL,15,1,58,6,14,0.429,0,0,0.0,6,14,0.429,0.429,3,4,0.75,3,5,8,0,0,5,5,13,15
Allen Iverson*,PG,29,PHI,75,75,3174,771,1818,0.424,104,338,0.308,667,1480,0.451,0.45299999999999996,656,786,0.835,51,248,299,596,180,9,344,140,2302
Royal Ivey,PG,23,ATL,62,5,809,85,198,0.429,3,9,0.33299999999999996,82,189,0.434,0.43700000000000006,47,67,0.701,19,65,84,103,39,7,58,140,220
Bobby Jackson,SG,31,SAC,25,0,536,109,255,0.42700000000000005,33,96,0.344,76,159,0.478,0.49200000000000005,50,58,0.862,23,62,85,59,14,2,28,58,301
Jermaine Jackson,SG,28,NYK,21,0,230,17,33,0.515,0,2,0.0,17,31,0.5479999999999999,0.515,8,13,0.615,3,20,23,24,7,1,10,26,42
Jim Jackson,SF,34,TOT,64,27,1987,248,582,0.426,122,295,0.414,126,287,0.439,0.531,54,58,0.9309999999999999,33,236,269,183,35,5,115,153,672
Luke Jackson,SF,23,CLE,10,0,43,10,27,0.37,4,6,0.667,6,21,0.28600000000000003,0.444,5,6,0.833,2,4,6,3,0,0,2,4,29
Marc Jackson,C,30,PHI,81,23,1976,340,731,0.465,0,2,0.0,340,729,0.466,0.465,289,349,0.828,184,222,406,81,32,18,131,171,969
Stephen Jackson,SF,26,IND,51,49,1806,330,819,0.40299999999999997,103,286,0.36,227,533,0.426,0.466,190,229,0.83,44,206,250,119,64,14,123,154,953
Casey Jacobsen,SG-SF,23,TOT,84,1,1798,165,408,0.40399999999999997,66,177,0.373,99,231,0.429,0.485,151,192,0.7859999999999999,35,132,167,113,33,8,71,104,547
Jerome James,C,29,SEA,80,80,1330,174,342,0.509,0,2,0.0,174,340,0.512,0.509,47,65,0.723,81,160,241,19,23,111,88,279,395
LeBron James,SF,20,CLE,80,80,3388,795,1684,0.47200000000000003,108,308,0.35100000000000003,687,1376,0.499,0.504,477,636,0.75,111,477,588,577,177,52,262,146,2175
Mike James,PG,29,TOT,74,5,1859,331,751,0.441,100,259,0.386,231,492,0.47,0.507,109,145,0.752,35,173,208,263,65,6,106,174,871
Antawn Jamison,PF,28,WAS,68,68,2605,519,1189,0.43700000000000006,71,208,0.341,448,981,0.457,0.466,225,296,0.76,160,359,519,154,55,16,118,151,1334
Marko Jarić,PG,26,LAC,50,41,1656,189,457,0.414,56,151,0.371,133,306,0.435,0.475,59,82,0.72,20,141,161,303,84,17,98,107,493
Al Jefferson,PF,20,BOS,71,1,1051,195,369,0.528,0,3,0.0,195,366,0.5329999999999999,0.528,85,135,0.63,119,193,312,24,22,55,66,195,475
Richard Jefferson,SF,24,NJN,33,33,1355,238,564,0.42200000000000004,30,89,0.337,208,475,0.43799999999999994,0.449,227,269,0.8440000000000001,49,191,240,133,33,17,132,109,733
Jared Jeffries,SF,23,WAS,77,71,2007,203,434,0.46799999999999997,16,51,0.314,187,383,0.488,0.486,101,173,0.584,152,222,374,151,66,35,114,206,523
Horace Jenkins,PG,30,DET,15,0,104,15,45,0.33299999999999996,0,9,0.0,15,36,0.41700000000000004,0.33299999999999996,12,13,0.9229999999999999,3,6,9,9,5,1,7,6,42
Britton Johnsen,SF,25,IND,6,1,87,6,22,0.273,0,4,0.0,6,18,0.33299999999999996,0.273,0,0,0.0,5,5,10,4,1,0,3,10,12
Anthony Johnson,PG,30,IND,63,36,1747,203,456,0.445,41,108,0.38,162,348,0.466,0.49,85,113,0.752,32,147,179,302,59,15,96,144,532
DerMarr Johnson,SG,24,DEN,71,40,1232,185,371,0.499,53,148,0.358,132,223,0.5920000000000001,0.57,80,101,0.792,43,108,151,75,43,18,65,140,503
Ervin Johnson,C,37,MIN,46,23,410,28,54,0.519,1,1,1.0,27,53,0.509,0.528,16,25,0.64,43,70,113,6,7,13,18,86,73
Joe Johnson,SF,23,PHO,82,82,3240,544,1179,0.461,177,370,0.478,367,809,0.45399999999999996,0.536,135,180,0.75,120,302,422,291,79,24,148,167,1400
Linton Johnson,SF,24,SAS,2,0,15,0,2,0.0,0,1,0.0,0,1,0.0,0.0,0,0,0.0,0,3,3,0,1,0,1,1,0
Dahntay Jones,SG,24,MEM,52,7,649,83,190,0.43700000000000006,23,60,0.38299999999999995,60,130,0.462,0.49700000000000005,44,64,0.688,11,58,69,21,13,11,29,81,233
Damon Jones,PG,28,MIA,82,66,2576,331,726,0.456,225,521,0.43200000000000005,106,205,0.517,0.611,68,86,0.7909999999999999,14,217,231,350,44,5,98,121,955
Eddie Jones,SF,33,MIA,80,80,2839,351,820,0.428,142,382,0.37200000000000005,209,438,0.47700000000000004,0.515,174,216,0.8059999999999999,38,367,405,212,86,38,99,251,1018
Fred Jones,SG,25,IND,77,14,2268,275,647,0.425,87,229,0.38,188,418,0.45,0.49200000000000005,176,207,0.85,34,208,242,196,61,31,114,171,813
James Jones,SF,24,IND,75,24,1330,126,318,0.396,66,166,0.39799999999999996,60,152,0.395,0.5,53,62,0.855,39,135,174,57,31,28,43,123,371
Jumaine Jones,SF,25,LAL,76,23,1830,210,486,0.43200000000000005,102,261,0.391,108,225,0.48,0.537,55,75,0.733,107,291,398,65,44,24,49,165,577
Mark Jones,SF,29,ORL,10,0,116,9,31,0.29,0,4,0.0,9,27,0.33299999999999996,0.29,5,10,0.5,6,7,13,6,5,2,3,16,23
Chris Kaman,C,22,LAC,63,50,1632,246,495,0.49700000000000005,0,1,0.0,246,494,0.498,0.49700000000000005,80,121,0.6609999999999999,135,288,423,73,26,68,115,182,572
Jason Kapono,SF,23,CHA,81,14,1491,269,671,0.401,80,194,0.41200000000000003,189,477,0.396,0.461,70,85,0.8240000000000001,32,132,164,61,40,6,46,132,688
Mario Kasun,C,24,ORL,45,0,356,47,98,0.48,0,1,0.0,47,97,0.485,0.48,24,43,0.5579999999999999,52,76,128,8,8,13,26,86,118
Viktor Khryapa,SF,22,POR,32,5,523,54,124,0.435,4,11,0.364,50,113,0.442,0.452,23,42,0.5479999999999999,28,80,108,25,20,18,33,80,135
Jason Kidd*,PG,31,NJN,66,65,2435,340,855,0.39799999999999996,129,358,0.36,211,497,0.425,0.473,142,192,0.74,94,394,488,545,123,9,167,110,951
Andrei Kirilenko,PF,23,UTA,41,37,1349,207,420,0.493,23,77,0.299,184,343,0.536,0.52,203,259,0.784,89,166,255,132,67,136,90,101,640
Kerry Kittles,SG,30,LAC,11,0,243,28,73,0.384,7,21,0.33299999999999996,21,52,0.40399999999999997,0.43200000000000005,6,10,0.6,1,31,32,20,8,3,7,12,69
Brandin Knight,PG,23,HOU,1,0,3,0,1,0.0,0,0,0.0,0,1,0.0,0.0,0,0,0.0,0,0,0,1,0,0,0,0,0
Brevin Knight,PG,29,CHA,66,61,1944,248,587,0.42200000000000004,3,20,0.15,245,567,0.43200000000000005,0.425,167,196,0.852,21,149,170,591,131,5,147,192,666
Kyle Korver,SF,23,PHI,82,57,2667,317,759,0.418,226,558,0.405,91,201,0.45299999999999996,0.5670000000000001,82,96,0.8540000000000001,40,339,379,182,103,33,106,265,942
Nenad Krstić,PF,21,NJN,75,57,1965,281,570,0.493,0,2,0.0,281,568,0.495,0.493,185,255,0.725,161,240,401,77,32,63,112,280,747
Toni Kukoč,SF,36,MIL,53,6,1099,105,256,0.41,42,116,0.36200000000000004,63,140,0.45,0.49200000000000005,44,61,0.721,31,129,160,160,39,13,64,70,296
Ibo Kutluay,SG,30,SEA,5,0,12,0,1,0.0,0,0,0.0,0,1,0.0,0.0,0,0,0.0,0,1,1,0,0,0,2,1,0
Christian Laettner,PF,35,MIA,49,0,739,107,184,0.5820000000000001,1,7,0.14300000000000002,106,177,0.599,0.584,45,59,0.763,36,95,131,41,32,15,29,78,260
Raef LaFrentz,PF,28,BOS,80,80,2196,341,688,0.496,82,225,0.364,259,463,0.5589999999999999,0.555,120,148,0.8109999999999999,154,399,553,98,42,99,70,262,884
Maciej Lampe,C,19,TOT,37,0,380,49,132,0.371,2,4,0.5,47,128,0.36700000000000005,0.379,15,22,0.682,24,65,89,11,5,7,17,51,115
Voshon Lenard,SG,31,DEN,3,1,54,10,26,0.385,4,12,0.33299999999999996,6,14,0.429,0.462,5,8,0.625,0,6,6,6,1,0,2,2,29
Rashard Lewis,SF,25,SEA,71,71,2697,532,1151,0.462,173,432,0.4,359,719,0.499,0.537,220,283,0.777,110,278,388,94,75,62,123,158,1457
Randy Livingston,PG,29,UTA,17,4,227,22,52,0.423,5,8,0.625,17,44,0.386,0.47100000000000003,15,17,0.882,3,9,12,45,12,2,14,28,64
Shaun Livingston,PG,19,LAC,30,15,814,89,215,0.414,0,2,0.0,89,213,0.418,0.414,44,59,0.746,22,67,89,151,32,11,75,82,222
Raül López,PG,24,UTA,31,15,518,57,135,0.42200000000000004,20,45,0.444,37,90,0.41100000000000003,0.496,27,33,0.818,7,32,39,123,22,3,47,78,161
Tyronn Lue,PG,27,TOT,70,49,2007,295,654,0.451,55,155,0.355,240,499,0.48100000000000004,0.493,142,165,0.861,14,135,149,322,33,0,105,168,787
George Lynch,SF,34,NOH,44,27,933,68,189,0.36,11,37,0.297,57,152,0.375,0.389,17,23,0.7390000000000001,55,119,174,88,32,12,57,83,164
Mark Madsen,C,29,MIN,41,14,601,34,66,0.515,0,0,0.0,34,66,0.515,0.515,20,40,0.5,63,65,128,18,7,14,24,103,88
Corey Maggette,SG,25,LAC,66,60,2436,425,986,0.431,51,168,0.304,374,818,0.457,0.457,563,657,0.857,70,324,394,225,70,8,195,191,1464
Jamaal Magloire,C,26,NOH,23,22,703,98,227,0.43200000000000005,0,0,0.0,98,227,0.43200000000000005,0.43200000000000005,74,123,0.602,79,126,205,29,8,23,59,74,270
Stephon Marbury,PG,27,NYK,82,82,3281,604,1308,0.462,115,325,0.354,489,983,0.49700000000000005,0.506,458,549,0.8340000000000001,50,198,248,668,122,6,233,186,1781
Shawn Marion,PF,26,PHO,81,81,3146,613,1289,0.47600000000000003,114,341,0.33399999999999996,499,948,0.526,0.52,229,275,0.833,235,680,915,154,163,119,125,199,1569
Sean Marks,PF,29,SAS,23,0,244,27,80,0.33799999999999997,0,3,0.0,27,77,0.35100000000000003,0.33799999999999997,22,28,0.7859999999999999,18,38,56,8,3,11,14,29,76
Donyell Marshall,PF,31,TOR,65,2,1645,262,592,0.44299999999999995,151,363,0.41600000000000004,111,229,0.485,0.57,72,91,0.7909999999999999,95,333,428,81,57,46,42,136,747
Darrick Martin,PG,33,LAC,11,0,190,16,50,0.32,5,18,0.278,11,32,0.344,0.37,5,8,0.625,3,7,10,28,6,0,6,19,42
Kenyon Martin,PF,27,DEN,70,67,2272,444,907,0.49,0,12,0.0,444,895,0.496,0.49,199,308,0.6459999999999999,146,365,511,170,100,78,149,228,1087
Kevin Martin,PG,21,SAC,45,0,455,45,117,0.385,5,25,0.2,40,92,0.435,0.406,36,55,0.655,29,29,58,22,16,3,24,35,131
Desmond Mason,SF,27,MIL,80,71,2893,478,1079,0.44299999999999995,1,8,0.125,477,1071,0.445,0.44299999999999995,420,524,0.802,85,227,312,217,58,27,164,198,1377
Tony Massenburg,PF,37,SAS,61,6,699,74,182,0.40700000000000003,0,0,0.0,74,182,0.40700000000000003,0.40700000000000003,48,63,0.762,54,109,163,14,18,20,40,122,196
Walter McCarty,PF,30,TOT,72,0,906,95,235,0.40399999999999997,55,155,0.355,40,80,0.5,0.521,15,29,0.517,29,109,138,37,25,15,36,144,260
Jelani McCoy,C,27,ATL,10,0,88,7,13,0.5379999999999999,0,0,0.0,7,13,0.5379999999999999,0.5379999999999999,1,5,0.2,7,14,21,0,3,8,6,24,15
Antonio McDyess,PF,30,DET,77,8,1797,307,598,0.513,0,1,0.0,307,597,0.514,0.513,126,192,0.6559999999999999,177,305,482,71,46,52,93,204,740
Tracy McGrady*,SF,25,HOU,78,78,3182,715,1660,0.431,142,435,0.326,573,1225,0.46799999999999997,0.473,431,557,0.774,71,413,484,448,135,52,201,167,2003
Jeff McInnis,PG,30,CLE,76,69,2651,377,915,0.41200000000000003,91,264,0.345,286,651,0.439,0.462,130,160,0.813,32,125,157,391,56,1,117,177,975
Aaron McKie,SG,32,PHI,68,3,1118,61,142,0.43,20,62,0.32299999999999995,41,80,0.513,0.5,10,16,0.625,20,152,172,103,48,17,31,116,152
Keith McLeod,PG,25,UTA,53,47,1382,143,408,0.35,18,72,0.25,125,336,0.37200000000000005,0.373,112,146,0.767,20,93,113,236,63,12,99,138,416
Stanislav Medvedenko,PF,25,LAL,43,4,423,71,156,0.455,0,1,0.0,71,155,0.45799999999999996,0.455,23,28,0.821,31,48,79,13,9,2,13,64,165
Ron Mercer,SF,28,NJN,18,3,390,65,158,0.41100000000000003,0,3,0.0,65,155,0.419,0.41100000000000003,7,10,0.7,9,31,40,20,16,2,14,20,137
Chris Mihm,C,25,LAL,75,75,1870,280,552,0.507,0,2,0.0,280,550,0.509,0.507,175,258,0.6779999999999999,197,305,502,50,14,108,110,237,735
Darius Miles,SF,23,POR,63,22,1699,336,697,0.48200000000000004,8,23,0.348,328,674,0.48700000000000004,0.488,129,215,0.6,71,228,299,129,75,78,157,189,809
Darko Miličić,C,19,DET,37,2,254,25,76,0.32899999999999996,0,0,0.0,25,76,0.32899999999999996,0.32899999999999996,17,24,0.708,3,40,43,7,2,17,16,31,67
Andre Miller,PG,28,DEN,82,82,2852,427,895,0.47700000000000004,6,39,0.154,421,856,0.49200000000000005,0.48,253,302,0.838,100,238,338,569,121,8,220,204,1113
Anthony Miller,PF,33,ATL,2,0,9,2,3,0.667,0,0,0.0,2,3,0.667,0.667,0,0,0.0,0,1,1,1,1,0,1,2,4
Brad Miller,C,28,SAC,56,56,2089,319,609,0.524,5,19,0.263,314,590,0.532,0.528,233,287,0.812,139,382,521,220,69,68,82,181,876
Mike Miller,SF,24,MEM,76,51,2278,387,766,0.505,140,323,0.433,247,443,0.5579999999999999,0.597,108,150,0.72,36,264,300,220,54,23,127,197,1022
Reggie Miller*,SG,39,IND,66,66,2105,314,719,0.43700000000000006,96,298,0.322,218,421,0.518,0.503,250,268,0.9329999999999999,18,138,156,146,50,5,77,109,974
Yao Ming*,C,24,HOU,80,80,2447,538,975,0.552,0,0,0.0,538,975,0.552,0.552,389,497,0.7829999999999999,208,461,669,61,34,160,196,298,1465
Cuttino Mobley,SG,29,TOT,66,64,2388,408,932,0.43799999999999994,150,342,0.439,258,590,0.43700000000000006,0.518,168,205,0.82,45,184,229,188,74,30,133,152,1134
Nazr Mohammed,C,27,TOT,77,59,1933,289,602,0.48,0,1,0.0,289,601,0.48100000000000004,0.48,153,227,0.674,247,339,586,34,58,86,108,236,731
Jérôme Moïso,C-PF,26,TOT,20,1,120,9,18,0.5,0,1,0.0,9,17,0.529,0.5,10,13,0.769,10,27,37,1,3,6,7,13,28
Mikki Moore,PF,29,LAC,74,4,1178,144,287,0.502,1,5,0.2,143,282,0.507,0.503,107,136,0.787,97,149,246,47,19,32,63,173,396
Alonzo Mourning*,C-PF,34,TOT,37,17,702,100,212,0.47200000000000003,0,0,0.0,100,212,0.47200000000000003,0.47200000000000003,82,141,0.5820000000000001,53,145,198,18,8,74,57,82,282
Troy Murphy,PF,24,GSW,70,69,2375,392,947,0.414,59,148,0.39899999999999997,333,799,0.41700000000000004,0.445,233,319,0.73,251,505,756,97,53,33,108,190,1076
Lamond Murray,SF,31,TOR,62,1,918,132,310,0.426,46,105,0.43799999999999994,86,205,0.42,0.5,61,80,0.763,44,120,164,47,32,16,54,85,371
Ronald Murray,SG,25,SEA,49,6,883,131,363,0.361,24,95,0.253,107,268,0.39899999999999997,0.39399999999999996,59,80,0.738,15,83,98,65,30,11,57,59,345
Dikembe Mutombo*,C,38,HOU,80,2,1212,108,217,0.498,0,0,0.0,108,217,0.498,0.498,106,143,0.741,150,276,426,10,16,101,51,135,322
Mamadou N'Diaye,C,29,LAC,11,0,72,8,20,0.4,0,1,0.0,8,19,0.42100000000000004,0.4,4,7,0.5710000000000001,9,9,18,1,1,5,0,20,20
Boštjan Nachbar,PF-SF,24,TOT,71,6,1341,161,411,0.392,75,196,0.38299999999999995,86,215,0.4,0.483,97,117,0.8290000000000001,24,158,182,74,29,16,73,183,494
Lee Nailon,SF,29,NOH,68,51,2017,415,869,0.478,0,2,0.0,415,867,0.479,0.478,133,165,0.8059999999999999,128,170,298,109,36,16,110,190,963
Eduardo Nájera,PF,28,TOT,68,4,1185,145,322,0.45,6,21,0.28600000000000003,139,301,0.462,0.46,58,91,0.637,102,141,243,65,41,24,61,148,354
Steve Nash*,PG,30,PHO,75,75,2573,430,857,0.502,94,218,0.431,336,639,0.526,0.557,211,238,0.887,57,192,249,861,74,6,245,136,1165
Jameer Nelson,PG,22,ORL,79,21,1612,286,628,0.455,44,141,0.312,242,487,0.49700000000000005,0.49,73,107,0.682,52,141,193,237,78,3,117,199,689
Rasho Nesterović,C,28,SAS,70,70,1785,198,430,0.46,0,0,0.0,198,430,0.46,0.46,14,30,0.467,184,275,459,71,31,117,73,207,410
Ira Newble,SG,30,CLE,74,69,1832,182,424,0.429,19,53,0.358,163,371,0.439,0.452,55,69,0.797,78,142,220,91,50,18,61,144,438
Andrés Nocioni,SF,25,CHI,81,38,1892,241,601,0.401,25,97,0.258,216,504,0.429,0.42200000000000004,170,222,0.7659999999999999,69,317,386,122,37,34,135,208,677
Moochie Norris,PG,31,TOT,38,0,360,35,109,0.321,0,12,0.0,35,97,0.361,0.321,20,24,0.833,10,36,46,39,18,2,27,44,90
Dirk Nowitzki,PF,26,DAL,78,78,3020,663,1445,0.45899999999999996,91,228,0.39899999999999997,572,1217,0.47,0.49,615,708,0.8690000000000001,96,661,757,240,97,119,176,219,2032
Jermaine O'Neal,PF,26,IND,44,41,1530,386,854,0.452,1,6,0.16699999999999998,385,848,0.45399999999999996,0.45299999999999996,295,391,0.754,85,303,388,82,25,88,131,173,1068
Shaquille O'Neal*,C,32,MIA,73,73,2492,658,1095,0.601,0,0,0.0,658,1095,0.601,0.601,353,765,0.461,253,507,760,200,36,171,203,262,1669
Lamar Odom,PF,25,LAL,64,64,2320,366,774,0.473,36,117,0.308,330,657,0.502,0.496,207,298,0.695,134,519,653,238,42,65,161,211,975
Emeka Okafor,PF,22,CHA,73,73,2600,448,1003,0.447,0,1,0.0,448,1002,0.447,0.447,209,343,0.609,275,520,795,64,62,125,125,214,1105
Mehmet Okur,C,25,UTA,82,25,2304,354,756,0.46799999999999997,17,63,0.27,337,693,0.486,0.479,329,387,0.85,194,422,616,166,32,68,141,227,1054
Kevin Ollie,PG,32,PHI,26,0,158,11,31,0.355,0,0,0.0,11,31,0.355,0.355,6,9,0.667,3,16,19,19,5,0,6,16,28
Michael Olowokandi,C,29,MIN,62,34,1215,161,353,0.456,0,0,0.0,161,353,0.456,0.456,46,69,0.667,106,218,324,29,15,56,68,193,368
Greg Ostertag,C,31,SAC,56,3,556,37,84,0.44,0,2,0.0,37,82,0.451,0.44,13,38,0.342,55,112,167,37,7,40,24,88,87
Bo Outlaw,PF,33,PHO,39,0,214,12,34,0.353,0,0,0.0,12,34,0.353,0.353,5,9,0.556,16,37,53,13,6,12,8,29,29
Travis Outlaw,SF,20,POR,59,2,793,133,267,0.498,4,10,0.4,129,257,0.502,0.506,49,75,0.653,40,81,121,35,30,40,39,77,319
Zaza Pachulia,C,20,MIL,74,4,1397,160,354,0.452,0,1,0.0,160,353,0.45299999999999996,0.452,138,185,0.746,131,247,378,60,44,34,70,166,458
Scott Padgett,PF,28,HOU,66,0,942,98,233,0.42100000000000004,50,126,0.397,48,107,0.449,0.528,29,40,0.725,47,138,185,55,33,10,30,119,275
Milt Palacio,PG,26,TOR,80,4,1533,175,392,0.446,2,12,0.16699999999999998,173,380,0.455,0.449,115,155,0.742,26,108,134,279,48,13,104,126,467
Jannero Pargo,PG,25,CHI,32,0,453,82,213,0.385,23,66,0.348,59,147,0.401,0.439,17,23,0.7390000000000001,12,35,47,76,16,1,45,53,204
Smush Parker,PG,23,TOT,16,1,144,18,43,0.419,3,13,0.231,15,30,0.5,0.45299999999999996,9,13,0.6920000000000001,4,8,12,15,5,0,19,16,48
Tony Parker,PG,22,SAS,80,80,2735,539,1118,0.48200000000000004,43,156,0.276,496,962,0.516,0.501,210,323,0.65,47,251,298,491,98,4,215,167,1331
Ruben Patterson,SF,29,POR,70,36,1957,319,601,0.531,2,25,0.08,317,576,0.55,0.532,169,282,0.599,126,147,273,138,106,21,143,164,809
Sasha Pavlović,SG,21,CLE,65,9,862,120,276,0.435,30,78,0.385,90,198,0.455,0.489,44,64,0.688,15,56,71,49,29,4,47,121,314
Gary Payton*,PG,36,BOS,77,77,2541,339,725,0.46799999999999997,42,129,0.326,297,596,0.498,0.49700000000000005,153,201,0.7609999999999999,48,188,236,469,88,12,148,121,873
Anthony Peeler,SG,35,WAS,40,0,529,56,150,0.373,25,65,0.385,31,85,0.365,0.457,16,18,0.889,14,51,65,57,18,2,28,39,153
Kirk Penney,SG,24,LAC,4,0,12,1,3,0.33299999999999996,0,1,0.0,1,2,0.5,0.33299999999999996,0,0,0.0,0,1,1,1,0,0,2,0,2
Kendrick Perkins,C,20,BOS,60,3,548,56,119,0.47100000000000003,0,0,0.0,56,119,0.47100000000000003,0.47100000000000003,37,58,0.638,53,123,176,21,9,37,43,98,149
Wesley Person,SF,33,TOT,41,3,667,107,226,0.473,41,89,0.461,66,137,0.48200000000000004,0.564,9,13,0.6920000000000001,3,80,83,39,19,4,17,30,264
Morris Peterson,SG,27,TOR,82,61,2510,356,848,0.42,129,335,0.385,227,513,0.442,0.496,188,226,0.8320000000000001,71,269,340,169,91,18,93,219,1029
Eric Piatkowski,SG,34,CHI,68,11,841,111,258,0.43,57,134,0.425,54,124,0.435,0.541,45,56,0.804,15,64,79,51,29,1,37,67,324
Paul Pierce,SF,27,BOS,82,82,2960,556,1223,0.455,108,292,0.37,448,931,0.48100000000000004,0.499,549,668,0.8220000000000001,78,461,539,348,133,39,230,255,1769
Mickaël Piétrus,SF,22,GSW,67,3,1340,214,501,0.42700000000000005,67,195,0.344,147,306,0.48,0.494,141,202,0.698,65,124,189,82,46,18,92,139,636
Zoran Planinić,PG,22,NJN,43,8,515,78,174,0.44799999999999995,15,40,0.375,63,134,0.47,0.491,46,66,0.6970000000000001,19,50,69,44,25,0,41,76,217
Pavel Podkolzin,C,20,DAL,5,0,10,0,0,0.0,0,0,0.0,0,0,0.0,0.0,1,2,0.5,0,2,2,0,0,0,2,4,1
Scot Pollard,C,29,IND,49,17,865,79,167,0.473,0,0,0.0,79,167,0.473,0.473,33,49,0.6729999999999999,85,120,205,18,30,24,31,123,191
Mark Pope,PF,32,DEN,9,0,27,2,6,0.33299999999999996,0,0,0.0,2,6,0.33299999999999996,0.33299999999999996,0,0,0.0,5,3,8,1,1,2,1,5,4
James Posey,SF,28,MEM,50,18,1382,127,356,0.35700000000000004,55,178,0.309,72,178,0.40399999999999997,0.434,96,111,0.865,45,174,219,88,48,23,69,134,405
Vitaly Potapenko,C,29,SEA,33,1,335,45,87,0.517,0,1,0.0,45,86,0.523,0.517,27,31,0.871,30,48,78,9,7,3,12,53,117
Tayshaun Prince,SF,24,DET,82,82,3039,469,963,0.48700000000000004,47,138,0.341,422,825,0.512,0.511,221,274,0.807,133,302,435,247,56,71,135,161,1206
Laron Profit,SF,27,WAS,42,4,428,56,128,0.43799999999999994,8,28,0.28600000000000003,48,100,0.48,0.469,16,25,0.64,24,52,76,37,16,5,27,44,136
Joel Przybilla,C,25,POR,76,50,1858,199,333,0.598,0,0,0.0,199,333,0.598,0.598,90,174,0.517,178,410,588,74,24,163,98,239,488
Vladimir Radmanović,PF,24,SEA,63,0,1856,266,650,0.409,128,329,0.389,138,321,0.43,0.508,81,103,0.7859999999999999,52,237,289,86,57,31,80,172,741
Aleksandar Radojević,C,28,UTA,12,6,128,6,19,0.316,0,0,0.0,6,19,0.316,0.316,7,10,0.7,9,19,28,6,0,2,15,32,19
Peter John Ramos,C,19,WAS,6,0,20,5,10,0.5,0,0,0.0,5,10,0.5,0.5,1,2,0.5,1,3,4,0,0,1,3,4,11
Zach Randolph,PF,23,POR,46,37,1603,332,741,0.44799999999999995,0,6,0.0,332,735,0.452,0.44799999999999995,207,254,0.815,142,300,442,86,34,17,112,112,871
Theo Ratliff,C,31,POR,63,45,1731,115,257,0.447,0,0,0.0,115,257,0.447,0.447,74,107,0.6920000000000001,111,220,331,34,23,158,56,183,304
Željko Rebrača,C,32,LAC,58,2,928,133,234,0.568,0,0,0.0,133,234,0.568,0.568,73,85,0.8590000000000001,49,135,184,26,13,40,49,130,339
Michael Redd,SG,25,MIL,75,75,2848,625,1418,0.441,104,293,0.355,521,1125,0.46299999999999997,0.47700000000000004,369,432,0.8540000000000001,72,240,312,172,63,8,133,152,1723
Justin Reed,SF,23,BOS,23,0,121,15,29,0.517,0,3,0.0,15,26,0.5770000000000001,0.517,11,15,0.733,8,8,16,10,3,1,5,12,41
Jared Reiner,C,22,CHI,19,2,132,10,30,0.33299999999999996,0,0,0.0,10,30,0.33299999999999996,0.33299999999999996,1,4,0.25,13,25,38,1,3,7,9,35,21
Jason Richardson,SG,24,GSW,72,72,2724,610,1368,0.446,125,370,0.33799999999999997,485,998,0.486,0.49200000000000005,214,309,0.693,125,299,424,281,105,32,169,156,1559
Quentin Richardson,SG,24,PHO,79,78,2839,407,1045,0.389,226,631,0.358,181,414,0.43700000000000006,0.498,136,184,0.7390000000000001,91,388,479,158,96,27,102,197,1176
Luke Ridnour,PG,23,SEA,82,82,2571,299,739,0.405,67,178,0.376,232,561,0.414,0.45,159,180,0.883,55,149,204,483,94,23,149,185,824
Bernard Robinson,SG,24,CHA,31,1,328,36,81,0.444,3,8,0.375,33,73,0.452,0.46299999999999997,18,26,0.6920000000000001,14,34,48,30,11,4,20,42,93
Clifford Robinson,C-PF,38,TOT,71,29,1689,202,523,0.386,67,193,0.34700000000000003,135,330,0.409,0.45,62,97,0.639,54,155,209,104,62,53,66,181,533
Glenn Robinson,SF,32,SAS,9,0,157,34,77,0.442,2,6,0.33299999999999996,32,71,0.451,0.455,20,23,0.87,4,20,24,8,4,3,7,19,90
Rodney Rogers,SF-PF,33,TOT,58,33,1367,172,450,0.382,48,168,0.28600000000000003,124,282,0.44,0.436,52,70,0.743,61,185,246,86,41,20,86,172,444
Jalen Rose,SF,32,TOR,81,65,2710,527,1159,0.455,108,274,0.39399999999999996,419,885,0.473,0.501,333,390,0.8540000000000001,44,232,276,209,63,10,180,190,1495
Malik Rose,PF,30,TOT,76,5,1475,198,441,0.449,1,10,0.1,197,431,0.457,0.45,137,186,0.737,129,212,341,59,46,16,102,208,534
Quinton Ross,SG,23,LAC,78,19,1659,161,373,0.43200000000000005,1,4,0.25,160,369,0.434,0.433,74,110,0.6729999999999999,59,151,210,109,51,22,54,165,397
Michael Ruffin,C,28,WAS,79,7,1262,41,99,0.414,0,1,0.0,41,98,0.418,0.414,29,67,0.433,157,175,332,64,43,41,44,193,111
Kareem Rush,SG,24,TOT,48,22,968,157,406,0.387,51,137,0.37200000000000005,106,269,0.39399999999999996,0.45,37,48,0.7709999999999999,20,69,89,68,20,7,47,74,402
Bryon Russell,SF,34,DEN,70,2,1026,95,252,0.377,56,149,0.376,39,103,0.379,0.488,61,77,0.792,50,122,172,72,44,11,35,130,307
John Salmons,SG,25,PHI,58,8,993,85,210,0.405,31,91,0.341,54,119,0.45399999999999996,0.479,35,48,0.7290000000000001,12,109,121,114,40,13,51,92,236
Jamal Sampson,PF,21,CHA,23,0,329,28,62,0.452,0,0,0.0,28,62,0.452,0.452,23,39,0.59,36,86,122,8,4,17,17,53,79
Daniel Santiago,C,28,MIL,11,0,105,7,21,0.33299999999999996,0,0,0.0,7,21,0.33299999999999996,0.33299999999999996,8,11,0.727,6,13,19,1,3,4,4,28,22
Brian Scalabrine,PF,26,NJN,54,14,1167,132,332,0.39799999999999996,22,68,0.324,110,264,0.41700000000000004,0.431,53,69,0.768,83,161,244,88,34,18,66,111,339
Ansu Sesay,SF,28,GSW,16,0,128,17,42,0.405,2,8,0.25,15,34,0.441,0.429,13,24,0.542,18,20,38,12,2,3,8,16,49
Ha Seung-Jin,C,19,POR,19,0,104,10,23,0.435,0,0,0.0,10,23,0.435,0.435,6,11,0.545,6,12,18,2,1,5,12,21,26
Paul Shirley,PF,27,PHO,9,0,30,5,11,0.455,0,0,0.0,5,11,0.455,0.455,2,4,0.5,1,1,2,3,0,0,1,3,12
Bobby Simmons,SF,24,LAC,75,74,2799,474,1017,0.466,50,115,0.435,424,902,0.47,0.491,231,273,0.846,128,318,446,205,106,16,135,227,1229
Brian Skinner,C-PF,28,TOT,49,23,941,104,205,0.507,0,1,0.0,104,204,0.51,0.507,25,70,0.35700000000000004,107,173,280,43,31,49,40,102,233
Tamar Slay,SG,24,CHA,8,0,78,13,39,0.33299999999999996,2,12,0.16699999999999998,11,27,0.40700000000000003,0.359,0,2,0.0,6,8,14,3,5,0,8,20,28
Donta Smith,SG,21,ATL,38,0,433,44,113,0.389,6,22,0.273,38,91,0.418,0.41600000000000004,33,48,0.688,19,33,52,39,23,5,25,50,127
J.R. Smith,SG,19,NOH,76,56,1859,295,748,0.39399999999999996,81,281,0.28800000000000003,214,467,0.45799999999999996,0.449,111,161,0.6890000000000001,39,113,152,142,55,11,109,135,782
Jabari Smith,PF,27,NJN,45,2,648,62,148,0.419,1,2,0.5,61,146,0.418,0.42200000000000004,41,55,0.745,29,82,111,38,25,14,39,103,166
Joe Smith,PF,29,MIL,74,73,2265,319,621,0.514,0,1,0.0,319,620,0.515,0.514,175,228,0.768,179,362,541,67,43,38,79,222,813
Josh Smith,SF,19,ATL,74,59,2050,274,602,0.455,4,23,0.174,270,579,0.466,0.45799999999999996,163,237,0.688,147,310,457,127,59,144,135,157,715
Steve Smith,SG,35,TOT,50,1,750,102,248,0.41100000000000003,41,105,0.39,61,143,0.42700000000000005,0.494,69,80,0.863,15,50,65,71,14,7,27,82,314
Theron Smith,SF,24,CHA,33,5,510,44,136,0.324,3,12,0.25,41,124,0.331,0.335,14,16,0.875,39,77,116,28,6,4,27,58,105
Eric Snow,SG,31,CLE,81,15,1844,125,327,0.382,13,45,0.289,112,282,0.397,0.402,59,80,0.738,37,118,155,317,67,16,89,189,322
Kirk Snyder,SG,21,UTA,68,7,906,122,328,0.37200000000000005,30,85,0.353,92,243,0.379,0.418,64,96,0.667,50,71,121,36,26,19,58,116,338
Darius Songaila,PF,26,SAC,81,21,1668,257,488,0.527,0,3,0.0,257,485,0.53,0.527,94,111,0.847,125,219,344,114,51,18,70,206,608
Pape Sow,C,23,TOR,27,4,255,23,58,0.397,0,0,0.0,23,58,0.397,0.397,16,27,0.593,18,39,57,2,12,4,10,46,62
Latrell Sprewell,SF,34,MIN,80,79,2450,398,961,0.414,69,211,0.327,329,750,0.439,0.45,156,188,0.83,65,189,254,179,53,21,127,124,1021
Jerry Stackhouse,SG,30,DAL,56,7,1617,274,662,0.414,32,120,0.267,242,542,0.446,0.43799999999999994,253,298,0.8490000000000001,38,145,183,127,53,10,106,104,833
DeShawn Stevenson,SG,23,ORL,55,27,1089,174,426,0.408,25,67,0.373,149,359,0.415,0.43799999999999994,56,101,0.5539999999999999,38,64,102,69,16,9,57,73,429
Michael Stewart,PF,29,ATL,12,1,145,11,21,0.524,0,0,0.0,11,21,0.524,0.524,3,7,0.429,21,19,40,5,6,5,6,32,25
Peja Stojaković,SF,27,SAC,66,66,2534,451,1016,0.444,174,433,0.402,277,583,0.475,0.53,253,275,0.92,62,223,285,138,79,12,102,157,1329
Awvee Storey,SG,27,NJN,9,0,32,3,10,0.3,1,2,0.5,2,8,0.25,0.35,1,2,0.5,4,1,5,1,0,0,0,3,8
Damon Stoudamire,PG,31,POR,81,70,2762,457,1165,0.392,181,490,0.369,276,675,0.409,0.47,182,199,0.915,56,254,310,458,86,2,164,158,1277
Amar'e Stoudemire,C,22,PHO,80,80,2889,747,1336,0.5589999999999999,3,16,0.188,744,1320,0.564,0.56,583,795,0.733,219,494,713,131,77,130,189,278,2080
Erick Strickland,SG,31,MIL,62,5,1014,114,304,0.375,21,83,0.253,93,221,0.42100000000000004,0.41,52,64,0.813,11,92,103,115,30,1,64,103,301
Rod Strickland,PG,38,HOU,16,2,196,9,43,0.209,1,2,0.5,8,41,0.195,0.221,9,10,0.9,3,24,27,39,3,2,16,15,28
Bruno Šundov,C,24,NYK,21,0,73,11,37,0.297,1,3,0.33299999999999996,10,34,0.294,0.311,2,2,1.0,6,7,13,2,2,2,6,16,25
Bob Sura,PG,31,HOU,61,59,1922,215,504,0.42700000000000005,55,155,0.355,160,349,0.45799999999999996,0.48100000000000004,141,188,0.75,79,258,337,317,65,7,147,168,626
Mike Sweetney,C,22,NYK,77,28,1509,237,446,0.531,0,1,0.0,237,445,0.5329999999999999,0.531,176,235,0.7490000000000001,169,249,418,44,27,28,108,224,650
Robert Swift,C,19,SEA,16,0,72,5,11,0.455,0,0,0.0,5,11,0.455,0.455,5,9,0.556,1,4,5,2,1,7,4,16,15
Stromile Swift,PF,25,MEM,60,14,1279,219,488,0.449,0,4,0.0,219,484,0.452,0.449,166,219,0.758,92,181,273,43,41,92,90,182,604
Wally Szczerbiak,SF,27,MIN,81,37,2558,465,919,0.506,63,169,0.373,402,750,0.536,0.54,260,304,0.855,82,221,303,191,40,16,132,178,1253
Yuta Tabuse,PG,24,PHO,4,0,17,1,6,0.16699999999999998,1,1,1.0,0,5,0.0,0.25,4,4,1.0,2,2,4,3,0,0,1,1,7
Maurice Taylor,PF-C,28,TOT,65,16,1336,203,446,0.455,3,9,0.33299999999999996,200,437,0.45799999999999996,0.45899999999999996,63,103,0.612,67,190,257,67,27,20,94,180,472
Sebastian Telfair,PG,19,POR,68,26,1330,169,430,0.39299999999999996,17,69,0.24600000000000002,152,361,0.42100000000000004,0.413,105,133,0.789,10,94,104,224,35,4,125,120,460
Jason Terry,PG,27,DAL,80,57,2401,372,743,0.501,103,245,0.42,269,498,0.54,0.57,146,173,0.8440000000000001,38,150,188,429,109,15,147,177,993
Billy Thomas,SF,29,NJN,25,0,356,34,94,0.36200000000000004,17,56,0.304,17,38,0.447,0.452,7,9,0.778,7,29,36,17,14,1,9,29,92
Etan Thomas,C,26,WAS,47,10,976,128,255,0.502,0,0,0.0,128,255,0.502,0.502,76,144,0.528,85,159,244,20,17,51,50,133,332
James Thomas,PF,24,TOT,11,2,117,12,20,0.6,0,0,0.0,12,20,0.6,0.6,2,6,0.33299999999999996,17,20,37,4,4,4,7,13,26
John Thomas,C,29,MIN,44,8,521,42,86,0.488,0,0,0.0,42,86,0.488,0.488,27,46,0.5870000000000001,39,58,97,17,15,13,18,82,111
Kenny Thomas,PF,27,TOT,73,58,2167,367,781,0.47,1,5,0.2,366,776,0.47200000000000003,0.47100000000000003,173,227,0.762,184,351,535,152,67,17,131,227,908
Kurt Thomas,PF,32,NYK,80,80,2855,424,901,0.47100000000000003,2,4,0.5,422,897,0.47,0.47200000000000003,66,84,0.7859999999999999,170,661,831,160,70,79,99,310,916
Tim Thomas,SF,27,NYK,71,68,1940,315,718,0.439,85,208,0.409,230,510,0.451,0.498,136,173,0.7859999999999999,45,192,237,110,41,17,113,222,851
Jamaal Tinsley,PG,26,IND,40,40,1301,218,522,0.418,58,156,0.37200000000000005,160,366,0.43700000000000006,0.473,122,164,0.7440000000000001,26,134,160,257,81,12,134,112,616
Robert Traylor,C,27,CLE,74,6,1327,177,399,0.444,0,8,0.0,177,391,0.45299999999999996,0.444,55,102,0.539,136,196,332,61,54,50,73,215,409
Jake Tsakalidis,C,25,MEM,31,1,278,32,64,0.5,0,0,0.0,32,64,0.5,0.5,14,18,0.778,21,35,56,10,3,16,12,42,78
Nikoloz Tskitishvili,PF,21,TOT,35,0,220,22,74,0.297,2,17,0.11800000000000001,20,57,0.35100000000000003,0.311,4,7,0.5710000000000001,12,29,41,10,8,11,19,33,50
Hedo Türkoğlu,SF,25,ORL,67,11,1757,328,782,0.419,93,245,0.38,235,537,0.43799999999999994,0.479,188,225,0.836,62,171,233,153,41,18,119,140,937
Beno Udrih,PG,22,SAS,80,2,1149,173,390,0.444,58,142,0.408,115,248,0.46399999999999997,0.518,67,89,0.753,16,67,83,150,41,10,77,96,471
Nick Van Exel,SG,33,POR,53,34,1619,214,561,0.381,100,257,0.389,114,304,0.375,0.47100000000000003,58,74,0.784,20,141,161,227,44,0,92,70,586
Keith Van Horn,SF-PF,29,TOT,62,16,1502,257,564,0.456,54,142,0.38,203,422,0.48100000000000004,0.504,128,157,0.815,89,205,294,75,36,21,81,170,696
Anderson Varejão,PF,22,CLE,54,0,863,99,193,0.513,0,2,0.0,99,191,0.518,0.513,68,127,0.535,109,148,257,27,41,38,26,122,266
Jacque Vaughn,SG,29,NJN,71,34,1410,146,325,0.449,5,15,0.33299999999999996,141,310,0.455,0.457,76,91,0.835,17,90,107,135,41,1,62,138,373
Jake Voskuhl,C,27,PHO,38,1,360,27,59,0.45799999999999996,0,0,0.0,27,59,0.45799999999999996,0.45799999999999996,26,38,0.684,30,62,92,17,4,11,20,60,80
Jackson Vroman,C-PF,23,TOT,46,18,705,82,199,0.41200000000000003,0,3,0.0,82,196,0.418,0.41200000000000003,48,75,0.64,64,111,175,40,25,19,64,105,212
Sasha Vujačić,SG,20,LAL,35,3,403,33,117,0.282,17,63,0.27,16,54,0.29600000000000004,0.355,18,19,0.9470000000000001,13,49,62,51,12,2,15,41,101
Dwyane Wade,SG,23,MIA,77,77,2974,630,1318,0.478,13,45,0.289,617,1273,0.485,0.483,581,762,0.762,110,287,397,520,121,82,321,230,1854
Dajuan Wagner,SG,21,CLE,11,0,102,18,55,0.327,5,26,0.192,13,29,0.44799999999999995,0.373,3,4,0.75,0,2,2,13,5,0,9,15,44
Antoine Walker,PF,28,TOT,77,77,2955,581,1377,0.42200000000000004,110,341,0.32299999999999995,471,1036,0.455,0.462,201,373,0.539,182,513,695,265,89,58,253,217,1473
Samaki Walker,PF,28,WAS,14,0,134,11,31,0.355,0,0,0.0,11,31,0.355,0.355,2,3,0.667,8,10,18,4,3,7,8,25,24
Ben Wallace,C,30,DET,74,74,2671,295,651,0.45299999999999996,1,9,0.111,294,642,0.45799999999999996,0.45399999999999996,130,304,0.428,292,610,902,123,106,176,82,159,721
Gerald Wallace,SF,22,CHA,70,68,2147,286,637,0.449,17,62,0.27399999999999997,269,575,0.46799999999999997,0.462,191,289,0.6609999999999999,118,268,386,137,117,91,159,182,780
Rasheed Wallace,PF,30,DET,79,79,2687,467,1062,0.44,75,236,0.318,392,826,0.475,0.475,136,195,0.6970000000000001,174,470,644,142,65,115,127,236,1145
Luke Walton,SF,24,LAL,61,5,768,74,180,0.41100000000000003,16,61,0.262,58,119,0.48700000000000004,0.456,34,48,0.708,55,87,142,93,26,11,58,70,198
Charlie Ward,PG,34,HOU,14,13,360,24,77,0.312,16,51,0.314,8,26,0.308,0.41600000000000004,11,13,0.846,6,33,39,43,15,0,18,22,75
Earl Watson,PG,25,MEM,80,14,1808,236,554,0.426,52,163,0.319,184,391,0.47100000000000003,0.473,91,138,0.659,35,129,164,359,83,19,167,184,615
Clarence Weatherspoon,PF,34,HOU,40,18,525,47,114,0.41200000000000003,0,0,0.0,47,114,0.41200000000000003,0.41200000000000003,29,35,0.8290000000000001,35,87,122,17,9,6,15,74,123
Chris Webber,PF,31,TOT,67,67,2370,555,1283,0.433,15,44,0.341,540,1239,0.436,0.43799999999999994,181,228,0.794,130,482,612,318,94,53,182,214,1306
Bonzi Wells,SG,28,MEM,69,19,1489,272,617,0.441,36,104,0.34600000000000003,236,513,0.46,0.47,141,188,0.75,49,180,229,80,85,27,90,165,721
Jiří Welsch,SG-SF,25,TOT,71,32,1317,149,371,0.402,34,110,0.309,115,261,0.441,0.447,129,169,0.763,26,141,167,103,44,5,73,121,461
David Wesley,SG,34,TOT,80,79,2774,334,840,0.39799999999999996,118,315,0.375,216,525,0.41100000000000003,0.46799999999999997,162,189,0.857,38,190,228,265,96,9,113,215,948
David West,SF,24,NOH,30,8,552,75,172,0.436,2,5,0.4,73,167,0.43700000000000006,0.442,34,50,0.68,40,89,129,23,12,16,37,62,186
Delonte West,SG,21,BOS,39,7,507,66,155,0.426,24,67,0.358,42,88,0.47700000000000004,0.503,19,27,0.7040000000000001,14,51,65,53,21,8,24,69,175
Jahidi White,C,28,CHA,17,0,135,14,31,0.452,0,0,0.0,14,31,0.452,0.452,14,40,0.35,11,23,34,1,2,12,11,31,42
Rodney White,SF,24,TOT,58,2,677,121,289,0.419,24,60,0.4,97,229,0.424,0.46,27,44,0.614,24,65,89,44,32,11,37,64,293
Chris Wilcox,C,22,LAC,54,25,1005,169,329,0.514,0,0,0.0,169,329,0.514,0.514,88,144,0.611,63,165,228,38,26,24,77,129,426
Damien Wilkins,SF,25,SEA,29,7,520,73,168,0.435,16,59,0.271,57,109,0.523,0.48200000000000004,21,34,0.618,29,37,66,26,22,10,16,55,183
Mike Wilks,PG,25,SAS,48,0,278,32,77,0.41600000000000004,5,16,0.313,27,61,0.44299999999999995,0.44799999999999995,12,16,0.75,4,21,25,33,14,1,14,26,81
Aaron Williams,C,33,TOT,42,4,315,29,63,0.46,0,0,0.0,29,63,0.46,0.46,15,17,0.882,17,43,60,8,5,8,17,70,73
Eric Williams,SG,32,TOT,55,39,1322,142,330,0.43,28,73,0.384,114,257,0.444,0.473,112,161,0.696,44,128,172,92,38,4,60,147,424
Frank Williams,SG,24,CHI,9,0,71,3,20,0.15,0,4,0.0,3,16,0.188,0.15,0,0,0.0,2,4,6,11,2,3,3,9,6
Jason Williams,PG,29,MEM,71,68,1952,266,644,0.413,107,330,0.324,159,314,0.506,0.496,80,101,0.792,19,103,122,399,75,5,130,91,719
Jerome Williams,SF,31,NYK,79,4,1211,122,243,0.502,0,5,0.0,122,238,0.513,0.502,115,172,0.669,115,168,283,41,55,10,65,155,359
Mo Williams,PG,22,MIL,80,80,2254,323,737,0.43799999999999994,32,99,0.32299999999999995,291,638,0.456,0.46,136,160,0.85,50,194,244,484,74,11,196,221,814
Scott Williams,C,36,CLE,19,0,152,12,41,0.293,0,1,0.0,12,40,0.3,0.293,9,11,0.818,15,15,30,8,4,6,5,30,33
Corliss Williamson,PF,31,TOT,72,9,1527,273,584,0.467,0,2,0.0,273,582,0.469,0.467,195,244,0.799,104,155,259,78,38,15,86,218,741
Kevin Willis,C,42,ATL,29,5,344,35,90,0.389,0,2,0.0,35,88,0.39799999999999996,0.389,17,23,0.7390000000000001,29,47,76,9,8,7,15,53,87
Loren Woods,C,26,TOR,45,30,712,71,164,0.433,0,1,0.0,71,163,0.436,0.433,34,59,0.5760000000000001,81,139,220,17,8,39,37,78,176
Qyntel Woods,SF,23,MIA,3,0,40,5,12,0.41700000000000004,0,0,0.0,5,12,0.41700000000000004,0.41700000000000004,0,0,0.0,2,4,6,0,4,0,2,6,10
Metta World Peace,SF,25,IND,7,7,291,59,119,0.496,7,17,0.41200000000000003,52,102,0.51,0.525,47,51,0.922,8,37,45,22,12,6,17,27,172
Dorell Wright,SF,19,MIA,3,0,27,3,11,0.273,0,4,0.0,3,7,0.429,0.273,1,1,1.0,0,1,1,3,4,0,3,2,7
Lorenzen Wright,C,29,MEM,80,77,2287,320,683,0.469,0,3,0.0,320,680,0.47100000000000003,0.469,131,198,0.662,177,436,613,87,58,69,100,251,771
Wang Zhizhi,C,27,MIA,20,0,92,17,36,0.47200000000000003,2,3,0.667,15,33,0.455,0.5,7,12,0.583,6,12,18,5,3,2,5,9,43
