Player,Pos,Age,Tm,G,GS,MP,FG,FGA,FG%,3P,3PA,3P%,2P,2PA,2P%,eFG%,FT,FTA,FT%,ORB,DRB,TRB,AST,STL,BLK,TOV,PF,PTS
Jeff Adrien,PF,25,HOU,8,0,63,7,16,0.43799999999999994,0,0,0.0,7,16,0.43799999999999994,0.43799999999999994,7,12,0.583,5,17,22,1,0,2,2,13,21
Arron Afflalo,SG,26,DEN,62,62,2086,329,699,0.47100000000000003,88,221,0.39799999999999996,241,478,0.504,0.534,197,247,0.7979999999999999,40,157,197,149,36,13,85,134,943
Blake Ahearn,PG,27,UTA,4,0,30,4,14,0.28600000000000003,2,9,0.222,2,5,0.4,0.35700000000000004,0,0,0.0,0,2,2,1,0,0,5,4,10
Solomon Alabi,C,23,TOR,14,0,122,13,36,0.361,0,0,0.0,13,36,0.361,0.361,7,8,0.875,15,32,47,3,2,9,5,11,33
Cole Aldrich,C,23,OKC,26,0,173,22,42,0.524,0,0,0.0,22,42,0.524,0.524,13,14,0.929,13,35,48,3,8,16,9,22,57
LaMarcus Aldridge,PF,26,POR,55,55,1994,483,943,0.512,2,11,0.182,481,932,0.516,0.513,223,274,0.8140000000000001,150,292,442,134,51,45,111,153,1191
Lavoy Allen,PF,22,PHI,41,15,624,79,167,0.473,0,0,0.0,79,167,0.473,0.473,11,14,0.7859999999999999,47,124,171,34,13,18,20,73,169
Ray Allen*,SG,36,BOS,46,42,1565,226,493,0.45799999999999996,106,234,0.45299999999999996,120,259,0.46299999999999997,0.5660000000000001,97,106,0.915,14,128,142,109,49,8,68,83,655
Tony Allen,SG,30,MEM,58,57,1525,210,448,0.469,8,26,0.308,202,422,0.479,0.478,140,175,0.8,98,135,233,79,104,33,94,142,568
Morris Almond,SG,26,WAS,4,0,67,6,17,0.353,1,3,0.33299999999999996,5,14,0.35700000000000004,0.382,1,3,0.33299999999999996,1,7,8,2,7,0,1,6,14
Al-Farouq Aminu,SF,21,NOH,66,21,1477,150,365,0.41100000000000003,13,47,0.27699999999999997,137,318,0.431,0.429,86,114,0.754,95,213,308,66,59,34,91,136,399
Lou Amundson,PF,29,IND,60,0,753,89,207,0.43,0,0,0.0,89,207,0.43,0.43,35,82,0.42700000000000005,94,128,222,14,27,44,45,125,213
Chris Andersen,C,33,DEN,32,1,486,59,108,0.546,0,0,0.0,59,108,0.546,0.546,50,82,0.61,48,100,148,6,19,46,17,52,168
Alan Anderson,SF,29,TOR,17,12,461,55,142,0.387,24,61,0.39299999999999996,31,81,0.38299999999999995,0.47200000000000003,29,34,0.853,8,26,34,26,5,3,25,35,163
James Anderson,SG,22,SAS,51,2,603,66,174,0.379,19,68,0.27899999999999997,47,106,0.44299999999999995,0.434,39,52,0.75,16,63,79,41,8,2,30,35,190
Ryan Anderson,PF,23,ORL,61,61,1964,332,757,0.439,166,422,0.39299999999999996,166,335,0.496,0.5479999999999999,150,171,0.877,224,247,471,54,50,26,57,146,980
Carmelo Anthony,SF,27,NYK,55,55,1876,441,1025,0.43,68,203,0.335,373,822,0.45399999999999996,0.46299999999999997,295,367,0.804,88,256,344,200,62,24,144,156,1245
Joel Anthony,C,29,MIA,64,51,1349,85,152,0.5589999999999999,0,0,0.0,85,152,0.5589999999999999,0.5589999999999999,49,71,0.69,100,150,250,9,36,84,45,126,219
Gilbert Arenas,PG,30,MEM,17,0,211,26,64,0.406,13,39,0.33299999999999996,13,25,0.52,0.508,7,10,0.7,2,16,18,18,11,1,12,35,72
Trevor Ariza,SF,26,NOH,41,41,1350,168,403,0.41700000000000004,29,87,0.33299999999999996,139,316,0.44,0.45299999999999996,79,102,0.775,41,174,215,135,69,25,76,73,444
Ömer Aşık,C,25,CHI,66,2,971,79,156,0.506,0,0,0.0,79,156,0.506,0.506,47,103,0.456,127,223,350,32,30,68,68,121,205
D.J. Augustin,PG,24,CHA,48,46,1408,183,487,0.376,61,179,0.341,122,308,0.396,0.43799999999999994,105,120,0.875,24,85,109,307,36,1,110,65,532
Gustavo Ayón,PF,26,NOH,54,24,1088,140,261,0.536,0,1,0.0,140,260,0.5379999999999999,0.536,39,63,0.619,86,179,265,74,53,46,46,118,319
Jeff Ayres,C,24,IND,20,1,106,15,36,0.41700000000000004,0,0,0.0,15,36,0.41700000000000004,0.41700000000000004,4,7,0.5710000000000001,12,21,33,4,3,2,2,16,34
Kelenna Azubuike,SG,28,DAL,3,0,18,3,8,0.375,1,3,0.33299999999999996,2,5,0.4,0.43799999999999994,0,0,0.0,0,0,0,0,1,0,4,1,7
Luke Babbitt,SF,22,POR,40,4,537,71,173,0.41,43,100,0.43,28,73,0.384,0.535,17,20,0.85,16,79,95,16,10,4,27,46,202
Renaldo Balkman,SF,27,NYK,14,0,115,16,32,0.5,2,9,0.222,14,23,0.609,0.531,8,11,0.727,6,20,26,5,4,3,6,14,42
Leandro Barbosa,SG,29,TOT,64,0,1382,271,637,0.425,65,170,0.382,206,467,0.441,0.47600000000000003,101,124,0.815,33,95,128,96,56,7,94,135,708
J.J. Barea,PG,27,MIN,41,11,1032,167,418,0.4,53,143,0.371,114,275,0.415,0.46299999999999997,76,98,0.7759999999999999,14,100,114,232,21,0,103,61,463
Andrea Bargnani,C,26,TOR,31,31,1032,209,484,0.43200000000000005,34,115,0.29600000000000004,175,369,0.474,0.467,151,173,0.873,24,148,172,61,18,15,69,52,603
Matt Barnes,SF,31,LAL,63,16,1440,175,387,0.452,46,138,0.33299999999999996,129,249,0.518,0.512,95,128,0.742,97,247,344,126,35,48,73,152,491
Earl Barron,C,30,GSW,2,0,9,2,4,0.5,0,0,0.0,2,4,0.5,0.5,0,0,0.0,1,0,1,0,0,0,0,5,4
Brandon Bass,PF,26,BOS,59,39,1868,303,632,0.479,0,0,0.0,303,632,0.479,0.479,132,163,0.81,95,270,365,55,34,54,65,135,738
Tony Battie,C,35,PHI,27,11,295,19,51,0.373,0,1,0.0,19,50,0.38,0.373,4,4,1.0,8,59,67,16,4,6,4,26,42
Shane Battier,SF,33,MIA,65,10,1499,113,292,0.387,62,183,0.33899999999999997,51,109,0.46799999999999997,0.493,23,37,0.622,56,100,156,82,64,33,37,105,311
Nicolas Batum,SF,23,POR,59,34,1791,289,641,0.451,107,274,0.391,182,367,0.496,0.534,133,159,0.836,81,190,271,84,57,60,90,105,818
Jerryd Bayless,PG,23,TOR,31,11,705,117,276,0.424,44,104,0.423,73,172,0.424,0.504,75,88,0.852,8,58,66,118,24,4,53,70,353
Michael Beasley,SF,23,MIN,47,7,1087,221,497,0.445,38,101,0.376,183,396,0.462,0.483,61,95,0.642,39,168,207,45,18,19,80,83,541
Rodrigue Beaubois,PG,23,DAL,53,12,1151,188,445,0.42200000000000004,38,132,0.28800000000000003,150,313,0.479,0.465,58,69,0.841,19,132,151,152,56,28,70,98,472
Marco Belinelli,SG,25,NOH,66,55,1966,286,686,0.41700000000000004,107,284,0.377,179,402,0.445,0.495,101,129,0.7829999999999999,19,153,172,101,48,5,69,115,780
Raja Bell,SG,35,UTA,34,33,796,81,174,0.466,34,87,0.391,47,87,0.54,0.563,21,25,0.84,6,43,49,38,13,2,21,78,217
Keith Benson,C,23,GSW,3,0,9,0,1,0.0,0,0,0.0,0,1,0.0,0.0,0,0,0.0,2,1,3,0,0,0,0,0,0
Mike Bibby,PG,33,NYK,39,4,557,35,124,0.282,27,85,0.318,8,39,0.205,0.391,6,8,0.75,5,54,59,80,21,3,20,45,103
Andris Biedriņš,C,25,GSW,47,35,739,39,64,0.609,0,0,0.0,39,64,0.609,0.609,1,9,0.111,45,131,176,16,23,45,14,125,79
Chauncey Billups,SG,35,LAC,20,20,607,83,228,0.364,48,125,0.384,35,103,0.34,0.469,85,95,0.895,4,46,50,80,9,3,38,40,299
Bismack Biyombo,C,19,CHA,63,41,1455,129,278,0.46399999999999997,0,0,0.0,129,278,0.46399999999999997,0.46399999999999997,69,143,0.483,113,255,368,27,20,115,71,145,327
DeJuan Blair,PF,22,SAS,64,62,1363,269,504,0.534,0,1,0.0,269,503,0.535,0.534,73,119,0.613,154,197,351,78,59,12,92,168,611
Steve Blake,PG,31,LAL,53,5,1237,101,268,0.377,53,158,0.335,48,110,0.436,0.47600000000000003,21,27,0.778,9,76,85,175,39,2,72,75,276
Andray Blatche,PF,25,WAS,26,13,626,93,245,0.38,2,7,0.28600000000000003,91,238,0.382,0.384,33,49,0.6729999999999999,42,108,150,28,20,17,37,54,221
Eric Bledsoe,PG,22,LAC,40,1,464,49,126,0.389,6,30,0.2,43,96,0.44799999999999995,0.413,28,44,0.636,22,43,65,66,31,14,47,58,132
Keith Bogans,SF,31,NJN,5,1,94,8,21,0.381,3,12,0.25,5,9,0.556,0.452,2,5,0.4,5,6,11,3,2,0,3,15,21
Andrew Bogut,C,27,MIL,12,12,364,61,136,0.449,0,1,0.0,61,135,0.452,0.449,14,23,0.609,22,78,100,31,12,24,24,36,136
Matt Bonner,PF,31,SAS,65,2,1326,154,350,0.44,105,250,0.42,49,100,0.49,0.59,16,21,0.762,29,185,214,61,15,21,14,68,429
Trevor Booker,PF,24,WAS,50,32,1261,181,341,0.531,1,2,0.5,180,339,0.531,0.532,56,93,0.602,119,206,325,40,48,43,58,138,419
Carlos Boozer,PF,30,CHI,66,66,1948,448,842,0.532,0,1,0.0,448,841,0.5329999999999999,0.532,95,137,0.693,114,450,564,125,63,24,115,168,991
Chris Bosh,PF,27,MIA,57,57,2007,393,807,0.48700000000000004,10,35,0.28600000000000003,383,772,0.496,0.493,229,279,0.821,94,358,452,103,51,45,117,128,1025
Earl Boykins,PG,35,HOU,8,0,111,12,36,0.33299999999999996,2,9,0.222,10,27,0.37,0.361,13,15,0.867,0,11,11,17,1,0,7,5,39
Craig Brackins,PF,24,PHI,14,1,88,9,33,0.273,3,9,0.33299999999999996,6,24,0.25,0.318,1,2,0.5,5,10,15,8,0,1,4,6,22
Avery Bradley,PG,21,BOS,64,28,1368,200,402,0.498,22,54,0.40700000000000003,178,348,0.511,0.525,62,78,0.795,34,81,115,87,43,12,75,109,484
Elton Brand,C,32,PHI,60,60,1732,287,581,0.494,0,1,0.0,287,580,0.495,0.494,85,116,0.733,145,284,429,97,58,97,65,176,659
Corey Brewer,SF,25,DEN,59,17,1287,201,463,0.434,33,127,0.26,168,336,0.5,0.47,90,130,0.6920000000000001,43,107,150,88,72,17,56,113,525
Ronnie Brewer,SG,26,CHI,66,43,1635,190,445,0.42700000000000005,19,69,0.275,171,376,0.455,0.44799999999999995,56,100,0.56,72,159,231,137,72,21,59,64,455
Jon Brockman,PF,24,MIL,35,0,239,15,45,0.33299999999999996,0,1,0.0,15,44,0.341,0.33299999999999996,7,15,0.467,33,42,75,9,4,1,10,33,37
MarShon Brooks,SG,23,NJN,56,47,1648,274,640,0.428,47,150,0.313,227,490,0.46299999999999997,0.465,113,148,0.764,70,130,200,131,52,15,118,116,708
Derrick Brown,SF,24,CHA,65,17,1443,212,409,0.518,6,24,0.25,206,385,0.535,0.526,94,141,0.667,95,141,236,67,48,12,55,96,524
Kwame Brown,C,29,GSW,9,3,187,21,40,0.525,0,0,0.0,21,40,0.525,0.525,15,34,0.441,16,41,57,4,8,0,14,21,57
Shannon Brown,SG,26,PHO,59,19,1400,251,598,0.42,68,188,0.36200000000000004,183,410,0.446,0.47700000000000004,80,99,0.8079999999999999,38,119,157,69,44,15,64,66,650
Kobe Bryant,SG,33,LAL,58,58,2232,574,1336,0.43,87,287,0.303,487,1049,0.46399999999999997,0.462,381,451,0.845,66,247,313,264,69,18,204,105,1616
Chase Budinger,SF,23,HOU,58,9,1298,208,471,0.442,88,219,0.402,120,252,0.47600000000000003,0.535,54,70,0.7709999999999999,38,179,217,74,29,7,55,65,558
Alec Burks,SG,20,UTA,59,0,939,153,357,0.429,15,45,0.33299999999999996,138,312,0.442,0.45,104,143,0.727,57,75,132,55,27,5,51,84,425
Caron Butler,SF,31,LAC,63,63,1871,287,705,0.40700000000000003,92,257,0.358,195,448,0.435,0.47200000000000003,87,107,0.813,44,186,230,78,52,9,77,123,753
Jimmy Butler,SG,22,CHI,42,0,359,32,79,0.405,2,11,0.182,30,68,0.441,0.418,43,56,0.768,23,33,56,14,11,5,14,20,109
Rasual Butler,SF,32,TOR,34,14,453,41,133,0.308,21,77,0.273,20,56,0.35700000000000004,0.387,7,12,0.583,6,60,66,19,7,5,15,39,110
Derrick Byars,PF,27,SAS,2,0,37,3,11,0.273,0,6,0.0,3,5,0.6,0.273,4,4,1.0,6,5,11,1,2,0,0,2,10
Andrew Bynum,C,24,LAL,60,60,2112,444,796,0.5579999999999999,1,5,0.2,443,791,0.56,0.5579999999999999,234,338,0.6920000000000001,192,517,709,85,27,116,152,104,1123
Will Bynum,PG,29,DET,36,0,514,74,194,0.381,7,29,0.24100000000000002,67,165,0.406,0.39899999999999997,49,64,0.7659999999999999,10,46,56,66,23,3,54,61,204
José Calderón,PG,30,TOR,53,53,1799,218,477,0.457,59,159,0.371,159,318,0.5,0.519,60,68,0.882,19,141,160,468,47,3,104,94,555
Marcus Camby,C,37,TOT,59,53,1352,128,287,0.446,2,5,0.4,126,282,0.447,0.449,29,64,0.45299999999999996,157,373,530,107,50,85,57,126,287
Brian Cardinal,SF,34,DAL,44,0,277,14,55,0.255,10,49,0.204,4,6,0.667,0.345,5,6,0.833,4,30,34,16,8,2,8,38,43
DeMarre Carroll,SF-PF,25,TOT,24,9,348,43,105,0.41,7,19,0.368,36,86,0.419,0.44299999999999995,14,16,0.875,28,25,53,18,12,1,11,37,107
Matt Carroll,SG,31,CHA,53,2,596,52,157,0.331,8,43,0.18600000000000003,44,114,0.386,0.35700000000000004,30,38,0.789,8,50,58,38,16,7,24,52,142
Anthony Carter,PG,36,TOR,24,0,209,17,53,0.321,5,17,0.294,12,36,0.33299999999999996,0.368,8,10,0.8,5,28,33,34,8,4,17,20,47
Vince Carter,SG,35,DAL,61,40,1542,223,542,0.41100000000000003,74,205,0.361,149,337,0.442,0.48,95,115,0.826,32,173,205,139,56,25,84,134,615
Omri Casspi,SF,23,CLE,65,35,1341,166,412,0.40299999999999997,53,168,0.315,113,244,0.46299999999999997,0.467,74,108,0.685,63,165,228,66,37,21,64,115,459
Mario Chalmers,PG,25,MIA,64,64,1825,223,498,0.44799999999999995,101,260,0.38799999999999996,122,238,0.513,0.5489999999999999,80,101,0.792,16,155,171,222,97,11,142,166,627
Tyson Chandler,C,29,NYK,62,62,2061,241,355,0.679,0,2,0.0,241,353,0.6829999999999999,0.679,217,315,0.6890000000000001,212,400,612,56,56,89,102,186,699
Wilson Chandler,SF,24,DEN,8,6,215,31,79,0.392,3,12,0.25,28,67,0.418,0.41100000000000003,10,12,0.833,6,35,41,17,6,6,18,18,75
Josh Childress,SF,28,PHO,34,0,491,48,99,0.485,4,24,0.16699999999999998,44,75,0.5870000000000001,0.505,0,2,0.0,31,64,95,34,14,6,9,38,100
Earl Clark,PF,24,ORL,45,1,559,51,139,0.36700000000000005,0,0,0.0,51,139,0.36700000000000005,0.36700000000000005,21,29,0.7240000000000001,35,89,124,18,12,32,25,72,123
Norris Cole,PG,23,MIA,65,2,1260,177,450,0.39299999999999996,21,76,0.276,156,374,0.41700000000000004,0.41700000000000004,66,85,0.7759999999999999,21,70,91,133,44,2,105,124,441
Jason Collins,C,33,ATL,30,10,308,16,40,0.4,0,0,0.0,16,40,0.4,0.4,7,15,0.467,12,36,48,10,4,3,10,34,39
Darren Collison,PG,24,IND,60,56,1878,230,523,0.44,34,94,0.36200000000000004,196,429,0.457,0.47200000000000003,127,153,0.83,30,157,187,287,49,14,114,101,621
Nick Collison,PF,31,OKC,63,0,1307,120,201,0.597,0,1,0.0,120,200,0.6,0.597,44,62,0.71,119,155,274,82,33,28,61,153,284
Mike Conley,PG,24,MEM,62,61,2174,296,684,0.433,60,159,0.377,236,525,0.45,0.47700000000000004,136,158,0.861,22,134,156,404,136,11,125,133,788
Brian Cook,PF,31,TOT,32,0,276,31,98,0.316,10,50,0.2,21,48,0.43799999999999994,0.36700000000000005,9,10,0.9,10,53,63,10,6,5,11,48,81
Daequan Cook,SG,24,OKC,57,22,989,109,296,0.368,79,228,0.34600000000000003,30,68,0.441,0.502,14,22,0.636,12,110,122,15,22,11,16,69,311
DeMarcus Cousins,C,21,SAC,64,62,1950,448,999,0.44799999999999995,2,14,0.14300000000000002,446,985,0.45299999999999996,0.449,262,373,0.7020000000000001,265,438,703,102,93,75,170,257,1160
Jamal Crawford,PG,31,POR,60,6,1613,283,737,0.384,80,260,0.308,203,477,0.426,0.43799999999999994,191,206,0.927,16,102,118,191,55,14,111,74,837
Jordan Crawford,SG,23,WAS,64,32,1753,349,872,0.4,79,273,0.289,270,599,0.451,0.446,161,203,0.7929999999999999,44,124,168,190,59,5,141,111,938
Dante Cunningham,PF,24,MEM,64,5,1124,144,279,0.516,0,2,0.0,144,277,0.52,0.516,45,69,0.652,91,155,246,37,42,34,29,98,333
Eddy Curry,C,29,MIA,14,1,83,12,26,0.462,0,0,0.0,12,26,0.462,0.462,6,8,0.75,4,8,12,1,0,2,10,17,30
Stephen Curry,PG,23,GSW,26,23,732,145,296,0.49,55,121,0.455,90,175,0.514,0.583,38,47,0.809,15,73,88,138,39,8,65,62,383
Samuel Dalembert,C,30,HOU,65,45,1446,200,395,0.506,0,1,0.0,200,394,0.508,0.506,90,113,0.7959999999999999,158,298,456,33,37,111,82,162,490
Erick Dampier,C,36,ATL,15,0,83,1,8,0.125,0,0,0.0,1,8,0.125,0.125,0,0,0.0,10,15,25,4,1,4,3,9,2
Marquis Daniels,SG,31,BOS,38,0,484,52,143,0.364,0,10,0.0,52,133,0.391,0.364,17,23,0.7390000000000001,16,50,66,47,21,9,28,36,121
Baron Davis,PG,32,NYK,29,14,595,68,184,0.37,26,85,0.306,42,99,0.424,0.44,16,24,0.667,13,43,56,135,34,3,76,61,178
Ed Davis,PF,22,TOR,66,9,1534,172,335,0.513,0,1,0.0,172,334,0.515,0.513,71,106,0.67,134,304,438,60,40,63,67,156,415
Glen Davis,PF,26,ORL,61,13,1427,225,534,0.42100000000000004,2,14,0.14300000000000002,223,520,0.429,0.423,114,167,0.6829999999999999,107,224,331,47,43,19,75,106,566
Josh Davis,PF,31,MEM,15,0,130,10,27,0.37,4,13,0.308,6,14,0.429,0.444,4,8,0.5,16,11,27,6,7,1,3,19,28
Eric Dawson,C,27,SAS,4,0,39,7,12,0.583,0,0,0.0,7,12,0.583,0.583,1,2,0.5,5,5,10,0,1,2,3,6,15
Austin Daye,SF,23,DET,41,4,603,73,227,0.322,13,62,0.21,60,165,0.364,0.35,35,43,0.8140000000000001,14,77,91,33,22,21,40,62,194
Carlos Delfino,SF,29,MIL,54,53,1537,182,453,0.402,86,239,0.36,96,214,0.449,0.49700000000000005,38,48,0.792,20,188,208,123,79,10,66,99,488
Luol Deng,SF,26,CHI,54,54,2129,311,755,0.41200000000000003,79,215,0.36700000000000005,232,540,0.43,0.46399999999999997,127,165,0.77,77,273,350,157,56,36,96,81,828
Justin Dentmon,PG,26,TOT,6,0,91,10,28,0.35700000000000004,2,14,0.14300000000000002,8,14,0.5710000000000001,0.39299999999999996,4,6,0.667,0,8,8,10,2,0,7,10,26
DeMar DeRozan,SG,22,TOR,63,63,2206,381,903,0.42200000000000004,24,92,0.261,357,811,0.44,0.435,268,331,0.81,40,171,211,128,48,17,123,162,1054
Boris Diaw,PF,29,TOT,57,35,1424,156,351,0.444,31,99,0.313,125,252,0.496,0.489,22,35,0.629,70,210,280,205,34,25,112,125,365
Ike Diogu,PF,28,SAS,2,0,14,0,2,0.0,0,0,0.0,0,2,0.0,0.0,2,2,1.0,0,1,1,0,0,0,1,1,2
DeSagana Diop,C,30,CHA,27,9,325,15,42,0.35700000000000004,0,0,0.0,15,42,0.35700000000000004,0.35700000000000004,1,6,0.16699999999999998,33,52,85,23,6,13,19,36,31
Keyon Dooling,SG,31,BOS,46,2,662,66,163,0.405,27,81,0.33299999999999996,39,82,0.47600000000000003,0.488,23,31,0.742,3,36,39,51,13,2,34,57,182
Toney Douglas,PG,25,NYK,38,9,656,94,290,0.324,27,117,0.231,67,173,0.387,0.371,22,26,0.846,16,56,72,77,29,1,56,55,237
Goran Dragić,PG,25,HOU,66,28,1752,277,600,0.462,68,202,0.337,209,398,0.525,0.518,153,190,0.805,53,115,168,351,85,10,157,166,775
Jared Dudley,SG,26,PHO,65,60,2020,312,643,0.485,80,209,0.38299999999999995,232,434,0.535,0.547,119,164,0.726,95,206,301,112,49,19,72,107,823
Chris Duhon,PG,29,ORL,63,9,1226,85,203,0.419,50,119,0.42,35,84,0.41700000000000004,0.542,17,21,0.81,14,88,102,151,35,9,81,71,237
Tim Duncan,C,35,SAS,58,58,1634,361,733,0.49200000000000005,0,4,0.0,361,729,0.495,0.49200000000000005,173,249,0.695,110,410,520,132,38,88,97,98,895
Mike Dunleavy,SF,31,MIL,55,3,1445,239,504,0.474,83,208,0.39899999999999997,156,296,0.527,0.557,116,143,0.8109999999999999,29,175,204,117,28,8,58,87,677
Kevin Durant,SF,23,OKC,66,66,2546,643,1297,0.496,133,344,0.387,510,953,0.535,0.547,431,501,0.86,40,487,527,231,88,77,248,133,1850
Jerome Dyson,PG,24,NOH,9,1,180,19,48,0.396,1,8,0.125,18,40,0.45,0.406,28,36,0.778,2,17,19,18,11,2,20,19,67
Devin Ebanks,SG,22,LAL,24,12,396,37,89,0.41600000000000004,0,9,0.0,37,80,0.46299999999999997,0.41600000000000004,23,35,0.657,26,28,54,12,11,6,18,26,97
Wayne Ellington,SG,24,MIN,51,4,973,122,302,0.40399999999999997,35,108,0.324,87,194,0.44799999999999995,0.462,32,40,0.8,14,85,99,33,26,10,26,56,311
Monta Ellis,SG,26,TOT,58,58,2120,450,1040,0.433,62,201,0.308,388,839,0.462,0.46299999999999997,219,275,0.7959999999999999,20,180,200,346,85,18,177,136,1181
Francisco Elson,C,35,PHI,5,0,16,1,3,0.33299999999999996,0,0,0.0,1,3,0.33299999999999996,0.33299999999999996,0,0,0.0,0,1,1,1,1,1,1,0,2
Andre Emmett,SF,29,NJN,6,0,45,4,7,0.5710000000000001,0,1,0.0,4,6,0.667,0.5710000000000001,5,8,0.625,2,4,6,1,2,1,2,2,13
Semih Erden,C,25,CLE,28,9,333,39,74,0.527,0,0,0.0,39,74,0.527,0.527,21,41,0.512,20,52,72,9,10,5,16,60,99
Jeremy Evans,SF,24,UTA,29,0,217,27,42,0.643,0,1,0.0,27,41,0.659,0.643,8,16,0.5,19,31,50,13,6,24,5,23,62
Maurice Evans,SF,33,WAS,24,0,343,45,112,0.402,17,45,0.37799999999999995,28,67,0.418,0.478,10,13,0.769,8,16,24,9,14,0,10,36,117
Reggie Evans,PF,31,LAC,56,0,771,34,72,0.47200000000000003,0,0,0.0,34,72,0.47200000000000003,0.47200000000000003,36,71,0.507,100,171,271,17,31,6,44,118,104
Tyreke Evans,SG,22,SAC,63,61,2162,408,900,0.45299999999999996,20,99,0.20199999999999999,388,801,0.484,0.46399999999999997,201,258,0.779,64,225,289,283,84,29,171,136,1037
Christian Eyenga,SF,22,TOT,7,0,102,6,25,0.24,1,3,0.33299999999999996,5,22,0.22699999999999998,0.26,4,8,0.5,4,10,14,5,3,5,3,7,17
Kenneth Faried,PF,22,DEN,46,39,1037,181,309,0.586,0,0,0.0,181,309,0.586,0.586,109,164,0.665,142,210,352,36,34,47,54,116,471
Jordan Farmar,PG,25,NJN,39,5,831,147,315,0.467,55,125,0.44,92,190,0.484,0.5539999999999999,57,63,0.905,7,54,61,129,24,2,68,49,406
Derrick Favors,PF,20,UTA,65,9,1376,222,445,0.499,0,0,0.0,222,445,0.499,0.499,126,194,0.649,158,267,425,43,38,65,103,145,570
Raymond Felton,PG,27,POR,60,56,1906,261,642,0.40700000000000003,62,203,0.305,199,439,0.45299999999999996,0.455,100,124,0.8059999999999999,27,122,149,390,78,10,170,122,684
Rudy Fernández,SG,26,DEN,31,1,710,99,225,0.44,40,122,0.32799999999999996,59,103,0.573,0.529,30,43,0.698,9,56,65,75,31,3,40,37,268
Kyrylo Fesenko,C,25,IND,3,0,17,2,5,0.4,0,0,0.0,2,5,0.4,0.4,4,6,0.667,2,7,9,1,2,0,0,2,8
Landry Fields,SG,23,NYK,66,62,1894,236,513,0.46,31,121,0.256,205,392,0.523,0.49,77,137,0.562,59,219,278,169,79,17,102,99,580
Derek Fisher,PG,37,TOT,63,43,1508,129,348,0.371,35,109,0.321,94,239,0.39299999999999996,0.42100000000000004,57,67,0.851,12,109,121,170,51,4,73,117,350
Jonny Flynn,PG,22,TOT,29,1,416,46,131,0.35100000000000003,10,34,0.294,36,97,0.371,0.389,29,39,0.7440000000000001,8,31,39,96,6,2,36,23,131
Jeff Foote,C,24,NOH,4,0,39,2,6,0.33299999999999996,0,0,0.0,2,6,0.33299999999999996,0.33299999999999996,0,0,0.0,1,5,6,0,0,1,2,5,4
Gary Forbes,SG,26,TOR,48,2,713,112,271,0.413,29,83,0.349,83,188,0.441,0.467,66,91,0.725,27,75,102,54,24,4,54,56,319
T.J. Ford,PG,28,SAS,14,0,191,19,43,0.442,2,8,0.25,17,35,0.486,0.465,11,14,0.7859999999999999,3,15,18,45,9,2,23,23,51
Courtney Fortson,PG,23,TOT,10,0,95,11,32,0.344,3,13,0.231,8,19,0.42100000000000004,0.391,10,15,0.667,6,9,15,10,3,0,10,5,35
Jeff Foster,C,35,IND,11,0,141,9,18,0.5,1,1,1.0,8,17,0.47100000000000003,0.528,6,9,0.667,18,24,42,4,8,1,7,26,25
Randy Foye,SG,28,LAC,65,48,1682,256,644,0.39799999999999996,127,329,0.386,129,315,0.41,0.496,73,85,0.8590000000000001,25,113,138,146,46,24,73,130,712
Jimmer Fredette,PG,22,SAC,61,7,1135,172,446,0.386,78,216,0.361,94,230,0.409,0.473,40,48,0.833,17,56,73,108,30,3,67,73,462
Channing Frye,PF,28,PHO,64,59,1669,255,613,0.41600000000000004,91,263,0.34600000000000003,164,350,0.469,0.49,73,82,0.89,71,308,379,88,42,70,63,176,674
Dan Gadzuric,C,33,NYK,2,0,13,0,2,0.0,0,0,0.0,0,2,0.0,0.0,0,2,0.0,1,4,5,0,1,1,1,4,0
Sundiata Gaines,SG,25,NJN,57,12,793,102,271,0.376,28,82,0.341,74,189,0.392,0.428,59,96,0.615,27,81,108,126,55,2,52,58,291
Danilo Gallinari,SF,23,DEN,43,40,1351,193,466,0.414,60,183,0.32799999999999996,133,283,0.47,0.479,182,209,0.871,28,174,202,116,42,23,68,86,628
Francisco García,SF,30,SAC,49,3,798,86,229,0.376,38,131,0.29,48,98,0.49,0.45899999999999996,24,30,0.8,11,88,99,31,36,37,22,73,234
Kevin Garnett,C,35,BOS,60,60,1864,391,777,0.503,3,9,0.33299999999999996,388,768,0.505,0.505,162,189,0.857,66,428,494,175,56,61,107,141,947
Marc Gasol,C,27,MEM,65,65,2370,357,740,0.48200000000000004,1,12,0.083,356,728,0.489,0.483,237,317,0.748,120,459,579,204,62,121,121,201,952
Pau Gasol,PF,31,LAL,65,65,2430,459,917,0.501,7,27,0.259,452,890,0.508,0.504,204,261,0.782,183,495,678,237,37,88,142,127,1129
Rudy Gay,SF,25,MEM,65,65,2422,485,1067,0.455,54,173,0.312,431,894,0.48200000000000004,0.48,208,263,0.7909999999999999,130,287,417,147,95,55,161,138,1232
Alonzo Gee,SG,24,CLE,63,31,1827,227,551,0.41200000000000003,44,137,0.321,183,414,0.442,0.452,167,212,0.7879999999999999,101,221,322,113,83,17,114,149,665
Paul George,SG,21,IND,66,66,1958,281,639,0.44,90,234,0.385,191,405,0.47200000000000003,0.51,146,182,0.802,56,314,370,158,108,38,117,191,798
Daniel Gibson,SG,25,CLE,35,7,916,87,248,0.35100000000000003,55,139,0.396,32,109,0.294,0.462,34,43,0.7909999999999999,11,90,101,76,26,16,45,69,263
Taj Gibson,PF,26,CHI,63,0,1284,200,404,0.495,0,0,0.0,200,404,0.495,0.495,84,135,0.622,135,197,332,47,27,81,60,131,484
Manu Ginóbili,SG,34,SAS,34,7,792,150,285,0.526,52,126,0.413,98,159,0.616,0.618,88,101,0.871,18,98,116,151,24,12,64,56,440
Mickell Gladness,PF,25,TOT,26,7,252,25,59,0.424,0,0,0.0,25,59,0.424,0.424,6,12,0.5,14,44,58,5,4,20,7,32,56
Ryan Gomes,SF,29,LAC,32,2,425,31,95,0.326,4,29,0.138,27,66,0.409,0.34700000000000003,8,11,0.727,14,47,61,12,16,0,15,34,74
Drew Gooden,C,30,MIL,56,46,1469,287,657,0.43700000000000006,16,55,0.29100000000000004,271,602,0.45,0.449,176,208,0.846,130,233,363,144,46,34,109,112,766
Ben Gordon,SG,28,DET,52,21,1398,234,530,0.442,63,147,0.429,171,383,0.446,0.501,117,136,0.86,14,107,121,127,34,11,115,114,648
Eric Gordon,PG,23,NOH,9,9,310,63,140,0.45,10,40,0.25,53,100,0.53,0.486,49,65,0.754,2,23,25,31,13,4,24,20,185
Marcin Gortat,C,27,PHO,66,66,2114,427,769,0.555,0,2,0.0,427,767,0.557,0.555,163,251,0.649,185,474,659,59,48,99,90,142,1017
Andrew Goudelock,SG,23,LAL,40,0,419,68,174,0.391,28,75,0.373,40,99,0.40399999999999997,0.47100000000000003,11,12,0.917,5,26,31,20,4,0,21,32,175
Danny Granger,SF,28,IND,62,62,2062,391,941,0.41600000000000004,123,323,0.381,268,618,0.434,0.48100000000000004,254,291,0.873,79,228,307,109,62,40,110,144,1159
Aaron Gray,C,27,TOR,49,40,813,83,161,0.516,0,0,0.0,83,161,0.516,0.516,25,47,0.532,83,198,281,27,22,17,51,127,191
Danny Green,SG,24,SAS,66,38,1522,211,477,0.442,102,234,0.436,109,243,0.449,0.5489999999999999,79,100,0.79,54,174,228,86,58,46,67,107,603
Gerald Green,SF,26,NJN,31,2,781,154,320,0.48100000000000004,43,110,0.391,111,210,0.529,0.5479999999999999,49,65,0.754,15,93,108,34,28,17,55,80,400
Willie Green,SG,30,ATL,53,2,922,153,325,0.47100000000000003,50,113,0.442,103,212,0.486,0.5479999999999999,48,56,0.857,15,65,80,40,23,6,33,74,404
Donté Greene,PF,23,SAC,53,7,777,108,266,0.406,25,105,0.23800000000000002,83,161,0.516,0.45299999999999996,44,55,0.8,19,114,133,34,18,29,32,67,285
Blake Griffin,PF,22,LAC,66,66,2392,561,1022,0.5489999999999999,2,16,0.125,559,1006,0.556,0.55,244,468,0.521,218,499,717,210,54,48,150,216,1368
Hamed Haddadi,C,26,MEM,35,0,206,26,48,0.542,0,1,0.0,26,47,0.5529999999999999,0.542,18,26,0.6920000000000001,28,43,71,8,1,26,21,43,70
Jordan Hamilton,SF,21,DEN,26,2,258,48,111,0.43200000000000005,17,47,0.36200000000000004,31,64,0.484,0.509,2,5,0.4,11,51,62,20,4,3,16,15,115
Richard Hamilton,SG,33,CHI,28,28,697,140,310,0.452,17,46,0.37,123,264,0.466,0.479,29,37,0.784,20,46,66,84,12,1,49,56,326
Tyler Hansbrough,PF,26,IND,66,0,1442,194,479,0.405,0,1,0.0,194,478,0.406,0.405,226,278,0.813,113,177,290,30,54,9,65,159,614
Luke Harangody,PF,24,CLE,21,1,231,23,65,0.354,5,21,0.23800000000000002,18,44,0.409,0.392,9,12,0.75,20,33,53,6,6,3,4,17,60
James Harden,SG,22,OKC,62,2,1946,309,629,0.491,114,292,0.39,195,337,0.579,0.5820000000000001,312,369,0.846,30,222,252,229,62,15,137,150,1044
Justin Harper,PF,22,ORL,14,0,84,9,31,0.29,2,13,0.154,7,18,0.389,0.32299999999999995,0,1,0.0,3,9,12,2,2,3,6,5,20
Josh Harrellson,PF,22,NYK,37,4,540,63,149,0.423,20,59,0.33899999999999997,43,90,0.478,0.49,16,26,0.615,47,97,144,11,23,20,20,48,162
Al Harrington,PF,31,DEN,64,1,1761,345,773,0.446,101,303,0.33299999999999996,244,470,0.519,0.512,119,176,0.6759999999999999,72,318,390,88,58,12,112,181,910
Devin Harris,PG,28,UTA,63,63,1741,241,542,0.445,77,213,0.36200000000000004,164,329,0.498,0.516,156,209,0.746,12,100,112,316,64,13,122,136,715
Manny Harris,SG,22,CLE,26,5,456,60,150,0.4,12,36,0.33299999999999996,48,114,0.42100000000000004,0.44,41,59,0.695,11,59,70,31,13,6,27,28,173
Terrel Harris,SG,24,MIA,22,1,318,29,83,0.349,8,39,0.205,21,44,0.47700000000000004,0.39799999999999996,14,21,0.667,18,33,51,26,9,2,25,34,80
Tobias Harris,SF,19,MIL,42,9,479,79,169,0.467,6,23,0.261,73,146,0.5,0.485,44,54,0.815,30,71,101,22,13,7,31,45,208
Udonis Haslem,PF,31,MIA,64,10,1589,151,357,0.423,0,0,0.0,151,357,0.423,0.423,83,102,0.8140000000000001,117,353,470,42,35,24,60,142,385
Spencer Hawes,C,23,PHI,37,29,920,156,319,0.489,3,12,0.25,153,307,0.498,0.494,40,55,0.727,78,192,270,98,16,48,55,100,355
Chuck Hayes,C,28,SAC,54,9,1039,73,170,0.429,0,2,0.0,73,168,0.435,0.429,26,39,0.667,72,162,234,77,36,17,50,111,172
Gordon Hayward,SF,21,UTA,66,58,2015,267,586,0.456,55,159,0.34600000000000003,212,427,0.496,0.503,193,232,0.8320000000000001,59,171,230,207,53,41,109,106,782
Lazar Hayward,SF,25,OKC,26,0,141,13,38,0.342,4,14,0.28600000000000003,9,24,0.375,0.395,7,12,0.583,2,14,16,4,3,1,9,18,37
Brendan Haywood,C,32,DAL,54,54,1146,118,228,0.518,0,0,0.0,118,228,0.518,0.518,45,96,0.469,139,185,324,19,24,54,46,121,281
Gerald Henderson,SG,24,CHA,55,55,1831,332,723,0.45899999999999996,11,47,0.23399999999999999,321,676,0.475,0.467,155,204,0.76,64,161,225,126,49,20,100,128,830
Xavier Henry,SG,20,NOH,45,0,759,90,228,0.395,7,17,0.41200000000000003,83,211,0.39299999999999996,0.41,52,85,0.612,24,82,106,35,26,8,35,59,239
Roy Hibbert,C,25,IND,65,65,1937,332,668,0.49700000000000005,0,1,0.0,332,667,0.498,0.49700000000000005,170,239,0.711,213,359,572,108,32,128,128,195,834
J.J. Hickson,PF,23,TOT,54,19,1244,183,392,0.467,0,2,0.0,183,390,0.469,0.467,86,134,0.642,133,202,335,45,30,35,70,85,452
Cory Higgins,PG,22,CHA,38,0,423,52,160,0.325,4,20,0.2,48,140,0.34299999999999997,0.33799999999999997,42,60,0.7,7,28,35,36,5,6,39,40,150
Nenê Hilário,C,29,TOT,39,33,1110,211,393,0.537,0,4,0.0,211,389,0.542,0.537,113,168,0.6729999999999999,63,228,291,80,42,38,96,95,535
George Hill,PG,25,IND,50,9,1274,168,380,0.442,54,147,0.36700000000000005,114,233,0.489,0.513,91,117,0.778,31,120,151,145,42,17,52,98,481
Grant Hill*,SF,39,PHO,49,46,1378,201,451,0.446,14,53,0.264,187,398,0.47,0.461,83,109,0.7609999999999999,29,142,171,107,41,29,65,88,499
Jordan Hill,C,24,TOT,39,8,551,82,165,0.49700000000000005,0,3,0.0,82,162,0.506,0.49700000000000005,30,47,0.638,61,125,186,16,14,27,31,71,194
Kirk Hinrich,SG,31,ATL,48,31,1237,122,295,0.414,47,136,0.34600000000000003,75,159,0.47200000000000003,0.493,25,32,0.7809999999999999,11,90,101,132,38,11,58,100,316
Darington Hobson,SG,24,MIL,5,0,39,2,13,0.154,0,6,0.0,2,7,0.28600000000000003,0.154,0,0,0.0,0,3,3,6,0,0,2,1,4
Jrue Holiday,PG,21,PHI,65,65,2196,360,834,0.43200000000000005,65,171,0.38,295,663,0.445,0.47100000000000003,94,120,0.7829999999999999,57,155,212,290,103,18,135,137,879
Ryan Hollins,C,27,TOT,39,8,522,46,84,0.5479999999999999,0,0,0.0,46,84,0.5479999999999999,0.5479999999999999,39,75,0.52,34,48,82,9,5,17,35,78,131
Tyler Honeycutt,SF,21,SAC,15,0,88,8,24,0.33299999999999996,1,3,0.33299999999999996,7,21,0.33299999999999996,0.354,3,5,0.6,3,11,14,7,4,3,2,3,20
Al Horford,C,25,ATL,11,11,348,57,103,0.5529999999999999,0,1,0.0,57,102,0.5589999999999999,0.5529999999999999,22,30,0.733,26,51,77,24,10,14,16,21,136
Dennis Horner,PF,23,NJN,8,0,22,1,4,0.25,0,1,0.0,1,3,0.33299999999999996,0.25,3,4,0.75,2,3,5,0,0,0,1,1,5
Dwight Howard,C,26,ORL,54,54,2070,416,726,0.573,0,7,0.0,416,719,0.579,0.573,281,572,0.491,200,585,785,104,81,116,175,159,1113
Josh Howard,SF,31,UTA,43,18,991,144,361,0.39899999999999997,9,37,0.243,135,324,0.41700000000000004,0.41100000000000003,75,97,0.773,39,119,158,50,32,10,53,91,372
Juwan Howard,PF,38,MIA,28,0,190,17,55,0.309,0,0,0.0,17,55,0.309,0.309,8,10,0.8,18,29,47,10,4,1,20,18,42
Lester Hudson,PG,27,TOT,16,0,334,62,162,0.38299999999999995,16,64,0.25,46,98,0.469,0.43200000000000005,34,41,0.8290000000000001,7,39,46,36,14,3,32,26,174
Larry Hughes,PG,33,ORL,9,0,114,5,22,0.22699999999999998,1,7,0.14300000000000002,4,15,0.267,0.25,1,2,0.5,1,4,5,7,2,0,12,10,12
Kris Humphries,PF,26,NJN,62,62,2162,323,671,0.48100000000000004,0,0,0.0,323,671,0.48100000000000004,0.48100000000000004,209,278,0.752,233,448,681,90,50,74,119,173,855
Serge Ibaka,PF,22,OKC,66,66,1792,262,490,0.535,1,3,0.33299999999999996,261,487,0.536,0.536,78,118,0.6609999999999999,193,305,498,28,33,241,79,179,603
Andre Iguodala,SF,28,PHI,62,62,2209,287,632,0.45399999999999996,76,193,0.39399999999999996,211,439,0.48100000000000004,0.514,121,196,0.617,56,325,381,339,107,30,115,92,771
Ersan İlyasova,PF,24,MIL,60,41,1655,294,597,0.49200000000000005,51,112,0.455,243,485,0.501,0.535,143,183,0.7809999999999999,196,333,529,71,42,44,76,133,782
Kyrie Irving,PG,19,CLE,51,51,1558,350,747,0.469,73,183,0.39899999999999997,277,564,0.491,0.517,171,196,0.872,44,147,191,275,54,20,160,110,944
Royal Ivey,SG,30,OKC,34,0,354,26,73,0.35600000000000004,18,53,0.34,8,20,0.4,0.479,1,8,0.125,1,23,24,10,14,0,9,36,71
Jarrett Jack,PG,28,NOH,45,39,1530,266,583,0.456,39,112,0.348,227,471,0.48200000000000004,0.49,129,148,0.872,23,153,176,285,31,9,106,93,700
Reggie Jackson,PG,21,OKC,45,0,501,51,159,0.321,13,62,0.21,38,97,0.392,0.36200000000000004,25,29,0.862,14,39,53,71,25,1,36,31,140
Stephen Jackson,SF,33,TOT,47,14,1212,159,425,0.374,49,170,0.28800000000000003,110,255,0.431,0.43200000000000005,94,114,0.825,22,141,163,118,54,13,103,99,461
Damion James,SF,24,NJN,7,7,170,13,35,0.371,0,1,0.0,13,34,0.382,0.371,8,12,0.667,7,26,33,3,7,7,12,17,34
LeBron James,SF,27,MIA,62,62,2326,621,1169,0.531,54,149,0.36200000000000004,567,1020,0.556,0.5539999999999999,387,502,0.7709999999999999,94,398,492,387,115,50,213,96,1683
Mike James,PG,36,CHI,11,0,120,20,49,0.408,6,10,0.6,14,39,0.359,0.469,7,8,0.875,2,8,10,29,4,2,14,20,53
Antawn Jamison,PF,35,CLE,65,65,2151,421,1044,0.40299999999999997,91,267,0.341,330,777,0.425,0.447,185,271,0.6829999999999999,123,285,408,131,51,43,90,164,1118
Al Jefferson,C,27,UTA,61,61,2075,516,1048,0.49200000000000005,1,4,0.25,515,1044,0.493,0.493,137,177,0.774,133,452,585,134,47,101,62,155,1170
Richard Jefferson,SF,31,TOT,63,44,1748,203,488,0.41600000000000004,113,269,0.42,90,219,0.41100000000000003,0.532,59,85,0.6940000000000001,26,193,219,88,37,19,50,121,578
Jared Jeffries,PF,30,NYK,39,4,729,59,144,0.41,3,16,0.188,56,128,0.43799999999999994,0.42,49,72,0.6809999999999999,69,83,152,26,29,25,29,89,170
Charles Jenkins,PG,22,GSW,51,28,893,130,291,0.447,3,20,0.15,127,271,0.469,0.452,34,39,0.872,8,60,68,170,33,6,60,85,297
Brandon Jennings,PG,22,MIL,66,66,2331,469,1121,0.418,129,388,0.332,340,733,0.46399999999999997,0.47600000000000003,193,239,0.8079999999999999,49,177,226,365,104,22,146,114,1260
Jonas Jerebko,PF,24,DET,64,13,1468,212,453,0.46799999999999997,32,106,0.302,180,347,0.519,0.503,100,124,0.8059999999999999,96,212,308,43,41,21,66,162,556
Yi Jianlian,PF,24,DAL,30,0,203,31,82,0.37799999999999995,3,10,0.3,28,72,0.389,0.396,14,21,0.667,12,37,49,5,7,8,14,23,79
Amir Johnson,PF,24,TOR,64,43,1553,196,340,0.5760000000000001,2,5,0.4,194,335,0.579,0.579,58,84,0.69,149,259,408,79,33,69,94,209,452
Armon Johnson,PG,22,TOT,9,0,124,20,43,0.465,1,3,0.33299999999999996,19,40,0.475,0.47700000000000004,6,6,1.0,1,12,13,11,5,0,6,9,47
Carldell Johnson,PG,29,NOH,15,0,119,11,35,0.314,4,15,0.267,7,20,0.35,0.371,1,3,0.33299999999999996,1,8,9,22,8,0,7,11,27
Chris Johnson,C,26,TOT,27,0,175,20,41,0.488,0,0,0.0,20,41,0.488,0.488,15,19,0.789,15,25,40,2,6,9,15,33,55
Ivan Johnson,PF,27,ATL,56,0,934,141,275,0.513,2,6,0.33299999999999996,139,269,0.517,0.516,72,100,0.72,65,161,226,32,43,18,69,116,356
JaJuan Johnson,PF,22,BOS,36,0,298,54,121,0.446,0,0,0.0,54,121,0.446,0.446,6,9,0.667,20,38,58,6,5,14,14,25,114
James Johnson,SF,24,TOR,62,40,1561,233,518,0.45,19,60,0.317,214,458,0.467,0.46799999999999997,81,115,0.7040000000000001,74,218,292,122,71,84,101,177,566
Joe Johnson,SG,30,ATL,60,60,2127,423,931,0.45399999999999996,125,322,0.38799999999999996,298,609,0.489,0.521,158,186,0.8490000000000001,53,168,221,232,48,13,116,75,1129
Trey Johnson,SG,27,NOH,11,0,61,8,14,0.5710000000000001,0,0,0.0,8,14,0.5710000000000001,0.5710000000000001,5,5,1.0,3,9,12,4,1,0,5,10,21
Wesley Johnson,SF,24,MIN,65,64,1469,158,397,0.39799999999999996,53,169,0.314,105,228,0.461,0.465,24,34,0.706,24,153,177,59,35,48,60,115,393
Dahntay Jones,SF,31,IND,65,3,1052,115,281,0.409,33,77,0.429,82,204,0.402,0.46799999999999997,83,99,0.838,23,94,117,63,23,11,46,119,346
Dominique Jones,SG,23,DAL,33,1,268,29,73,0.397,1,8,0.125,28,65,0.431,0.40399999999999997,29,37,0.784,9,35,44,42,10,5,28,28,88
James Jones,SG,31,MIA,51,10,666,57,150,0.38,46,114,0.40399999999999997,11,36,0.306,0.5329999999999999,25,30,0.833,6,43,49,19,17,9,10,45,185
Solomon Jones,C-PF,27,TOT,21,1,292,24,61,0.39299999999999996,0,0,0.0,24,61,0.39299999999999996,0.39299999999999996,19,23,0.826,32,26,58,9,9,11,18,43,67
DeAndre Jordan,C,23,LAC,66,66,1798,206,326,0.632,0,1,0.0,206,325,0.634,0.632,74,141,0.525,202,344,546,17,30,134,74,189,486
Jerome Jordan,C,25,NYK,21,0,108,17,33,0.515,0,0,0.0,17,33,0.515,0.515,8,10,0.8,14,13,27,4,1,6,2,15,42
Cory Joseph,PG,20,SAS,29,1,266,22,70,0.314,3,15,0.2,19,55,0.345,0.336,11,17,0.647,5,20,25,34,7,3,12,16,58
Chris Kaman,C,29,NOH,47,33,1372,266,597,0.446,0,0,0.0,266,597,0.446,0.446,84,107,0.785,89,275,364,101,25,77,129,106,616
Enes Kanter,C,19,UTA,66,0,874,117,236,0.496,0,1,0.0,117,235,0.498,0.496,70,105,0.667,107,171,278,8,18,23,54,87,304
Jason Kapono,SG,30,LAL,27,0,269,21,55,0.382,8,27,0.29600000000000004,13,28,0.46399999999999997,0.455,4,4,1.0,2,12,14,11,3,0,6,21,54
D.J. Kennedy,SF,22,CLE,2,0,59,5,12,0.41700000000000004,2,4,0.5,3,8,0.375,0.5,0,2,0.0,1,6,7,3,2,0,3,7,12
Jason Kidd*,PG,38,DAL,48,48,1379,99,273,0.363,79,223,0.354,20,50,0.4,0.507,22,28,0.7859999999999999,15,183,198,264,82,10,91,83,299
Linas Kleiza,SF,27,TOR,49,3,1057,165,410,0.402,62,179,0.34600000000000003,103,231,0.446,0.478,81,100,0.81,42,157,199,46,23,4,64,119,473
Brandon Knight,PG,20,DET,66,60,2129,319,769,0.415,105,276,0.38,214,493,0.434,0.483,104,137,0.759,33,178,211,251,49,10,171,154,847
Kyle Korver,SG,30,CHI,65,7,1469,178,412,0.43200000000000005,118,271,0.435,60,141,0.426,0.575,55,66,0.833,26,133,159,112,36,15,53,110,529
Kosta Koufos,C,22,DEN,48,24,792,115,192,0.599,0,0,0.0,115,192,0.599,0.599,33,55,0.6,95,163,258,15,24,41,33,96,263
Carl Landry,PF,28,NOH,41,8,999,182,362,0.503,0,3,0.0,182,359,0.507,0.503,147,184,0.799,78,136,214,38,13,12,64,89,511
Ty Lawson,PG,24,DEN,61,61,2124,374,767,0.488,73,200,0.365,301,567,0.531,0.535,178,216,0.8240000000000001,54,173,227,401,82,6,149,94,999
Courtney Lee,SG,26,HOU,58,26,1757,251,580,0.433,87,217,0.401,164,363,0.452,0.508,71,86,0.826,26,133,159,88,68,22,64,106,660
David Lee,PF,28,GSW,57,57,2121,464,922,0.503,0,5,0.0,464,917,0.506,0.503,219,280,0.782,171,374,545,162,54,22,149,179,1147
Malcolm Lee,SG,21,MIN,19,0,243,23,59,0.39,2,10,0.2,21,49,0.429,0.40700000000000003,14,17,0.8240000000000001,9,17,26,31,8,4,17,22,62
Kawhi Leonard,SF,20,SAS,64,39,1534,199,404,0.493,41,109,0.376,158,295,0.536,0.5429999999999999,68,88,0.773,104,223,327,70,85,24,44,88,507
Travis Leslie,SG,21,LAC,10,0,45,5,14,0.35700000000000004,0,0,0.0,5,14,0.35700000000000004,0.35700000000000004,4,9,0.444,6,3,9,5,2,2,2,4,14
Jon Leuer,PF,22,MIL,46,12,555,97,191,0.508,3,9,0.33299999999999996,94,182,0.516,0.516,21,28,0.75,45,75,120,25,14,17,18,67,218
Rashard Lewis,SF,32,WAS,28,15,729,85,221,0.385,16,67,0.239,69,154,0.44799999999999995,0.42100000000000004,31,37,0.838,34,75,109,27,23,10,32,49,217
DeAndre Liggins,SF,23,ORL,17,0,115,12,25,0.48,0,4,0.0,12,21,0.5710000000000001,0.48,9,19,0.474,6,9,15,5,6,0,10,6,33
Jeremy Lin,PG,23,NYK,35,25,940,171,383,0.446,24,75,0.32,147,308,0.47700000000000004,0.478,146,183,0.7979999999999999,18,89,107,216,55,9,126,78,512
Shaun Livingston,SG,26,MIL,58,27,1092,127,271,0.469,2,3,0.667,125,268,0.466,0.47200000000000003,62,79,0.785,39,84,123,122,27,20,66,79,318
Brook Lopez,C,23,NJN,5,5,136,38,77,0.494,0,0,0.0,38,77,0.494,0.494,20,32,0.625,8,10,18,6,1,4,6,8,96
Robin Lopez,C,23,PHO,64,0,895,124,269,0.461,0,0,0.0,124,269,0.461,0.461,100,140,0.7140000000000001,90,119,209,20,18,60,43,128,348
Kevin Love,PF,23,MIN,55,55,2145,474,1059,0.44799999999999995,105,282,0.37200000000000005,369,777,0.475,0.49700000000000005,379,460,0.8240000000000001,226,508,734,111,47,28,128,152,1432
Kyle Lowry,PG,25,HOU,47,38,1510,210,513,0.409,79,211,0.374,131,302,0.434,0.486,171,198,0.8640000000000001,37,176,213,310,73,14,130,133,670
John Lucas III,PG,29,CHI,49,2,726,143,358,0.39899999999999997,55,140,0.39299999999999996,88,218,0.40399999999999997,0.47600000000000003,28,32,0.875,22,54,76,108,19,1,42,42,369
Shelvin Mack,PG,21,WAS,64,0,779,88,220,0.4,12,42,0.28600000000000003,76,178,0.42700000000000005,0.42700000000000005,42,59,0.7120000000000001,12,80,92,131,28,2,48,50,230
Vernon Macklin,C,25,DET,23,0,135,19,35,0.5429999999999999,0,0,0.0,19,35,0.5429999999999999,0.5429999999999999,8,14,0.5710000000000001,14,20,34,5,4,4,3,9,46
Corey Maggette,SF,32,CHA,32,28,881,139,373,0.373,24,66,0.364,115,307,0.375,0.405,178,208,0.856,21,104,125,39,23,1,59,83,480
Jamaal Magloire,C,33,TOR,34,1,374,17,45,0.37799999999999995,0,0,0.0,17,45,0.37799999999999995,0.37799999999999995,7,27,0.259,25,88,113,6,4,10,22,66,41
Ian Mahinmi,C,25,DAL,61,12,1139,130,238,0.546,0,1,0.0,130,237,0.5489999999999999,0.546,94,147,0.639,108,181,289,12,38,31,50,176,354
Shawn Marion,SF,33,DAL,63,63,1919,288,646,0.446,20,68,0.294,268,578,0.46399999999999997,0.461,74,93,0.7959999999999999,145,320,465,132,67,36,98,87,670
Cartier Martin,SF,27,WAS,17,2,391,59,134,0.44,29,75,0.387,30,59,0.508,0.5489999999999999,11,19,0.579,12,46,58,10,11,2,13,35,158
Kenyon Martin,PF,34,LAC,42,0,940,97,220,0.441,3,13,0.231,94,207,0.45399999999999996,0.44799999999999995,20,54,0.37,49,132,181,18,44,43,32,103,217
Kevin Martin,SG,28,HOU,40,40,1264,222,537,0.413,78,225,0.34700000000000003,144,312,0.462,0.486,160,179,0.894,13,93,106,110,28,3,70,70,682
Roger Mason,SG,31,WAS,52,0,697,103,258,0.39899999999999997,59,154,0.38299999999999995,44,104,0.423,0.514,21,27,0.778,7,62,69,47,13,5,32,33,286
Wesley Matthews,SG,25,POR,66,53,2228,314,763,0.41200000000000003,129,337,0.38299999999999995,185,426,0.434,0.496,147,171,0.86,56,168,224,113,96,15,73,148,904
Jason Maxiell,PF,28,DET,65,42,1466,183,383,0.478,0,2,0.0,183,381,0.48,0.478,58,106,0.547,126,207,333,41,32,50,71,151,424
Eric Maynor,PG,24,OKC,9,0,137,14,39,0.359,6,17,0.353,8,22,0.364,0.436,4,4,1.0,3,10,13,22,5,0,11,13,38
O.J. Mayo,SG,24,MEM,66,0,1771,300,736,0.408,100,275,0.364,200,461,0.434,0.47600000000000003,133,172,0.773,30,180,210,169,71,23,124,137,833
Luc Mbah a Moute,PF,25,MIL,43,22,1009,133,261,0.51,1,4,0.25,132,257,0.514,0.511,66,103,0.6409999999999999,77,150,227,29,40,22,39,93,333
JaVale McGee,C,24,TOT,61,45,1535,307,552,0.556,0,0,0.0,307,552,0.556,0.556,77,167,0.461,163,314,477,31,35,132,87,166,691
Tracy McGrady*,SF,32,ATL,52,0,837,101,231,0.43700000000000006,15,33,0.455,86,198,0.434,0.47,56,83,0.675,23,131,154,110,16,15,53,35,273
Dominic McGuire,PF,26,GSW,64,6,1127,94,210,0.44799999999999995,0,4,0.0,94,206,0.456,0.44799999999999995,39,53,0.736,73,173,246,110,44,36,56,104,227
Josh McRoberts,PF,24,LAL,50,6,718,56,118,0.475,3,7,0.429,53,111,0.47700000000000004,0.48700000000000004,23,36,0.639,61,110,171,51,15,18,31,74,138
Jodie Meeks,SG,24,PHI,66,50,1644,191,467,0.409,97,266,0.365,94,201,0.46799999999999997,0.513,77,85,0.9059999999999999,17,144,161,54,40,3,29,82,556
C.J. Miles,SG,24,UTA,56,14,1145,177,465,0.381,46,150,0.307,131,315,0.41600000000000004,0.43,108,136,0.794,27,89,116,69,46,18,53,122,508
Darko Miličić,C,26,MIN,29,23,472,59,130,0.45399999999999996,0,0,0.0,59,130,0.45399999999999996,0.45399999999999996,16,37,0.43200000000000005,35,62,97,17,9,25,32,59,134
Andre Miller,SG,35,DEN,66,7,1809,242,552,0.43799999999999994,18,83,0.217,224,469,0.478,0.455,137,169,0.8109999999999999,53,168,221,441,63,9,177,133,639
Brad Miller,C,35,MIN,15,1,146,9,27,0.33299999999999996,7,15,0.467,2,12,0.16699999999999998,0.46299999999999997,10,12,0.833,4,15,19,24,4,2,12,10,35
Mike Miller,SG,31,MIA,39,2,752,91,209,0.435,53,117,0.45299999999999996,38,92,0.413,0.562,2,5,0.4,22,106,128,42,14,6,30,58,237
Patty Mills,PG,23,SAS,16,3,261,63,130,0.485,24,56,0.429,39,74,0.527,0.5770000000000001,15,15,1.0,4,24,28,39,10,1,26,14,165
Paul Millsap,PF,26,UTA,64,62,2100,426,861,0.495,7,31,0.226,419,830,0.505,0.499,202,255,0.792,180,383,563,150,118,52,112,222,1061
Nazr Mohammed,C,34,OKC,63,1,692,79,169,0.467,0,1,0.0,79,168,0.47,0.467,13,23,0.565,59,111,170,14,20,37,26,101,171
Greg Monroe,C,21,DET,66,66,2082,407,781,0.521,0,1,0.0,407,780,0.522,0.521,201,272,0.7390000000000001,239,398,637,152,83,46,161,180,1015
Jamario Moon,SF,31,CHA,8,0,123,7,24,0.292,2,10,0.2,5,14,0.35700000000000004,0.33299999999999996,2,2,1.0,2,20,22,5,1,5,8,5,18
E'Twaun Moore,PG,22,BOS,38,0,331,43,113,0.381,17,45,0.37799999999999995,26,68,0.382,0.456,7,7,1.0,4,29,33,34,11,3,21,33,110
Mikki Moore,C,36,GSW,7,0,118,9,20,0.45,0,0,0.0,9,20,0.45,0.45,6,7,0.857,7,15,22,5,3,3,7,24,24
Darius Morris,PG,21,LAL,19,0,169,18,42,0.429,4,9,0.444,14,33,0.424,0.47600000000000003,6,9,0.667,2,14,16,21,2,0,19,16,46
Marcus Morris,PF,22,HOU,17,0,126,16,54,0.29600000000000004,2,17,0.11800000000000001,14,37,0.37799999999999995,0.315,6,8,0.75,5,11,16,3,2,2,4,12,40
Markieff Morris,PF,22,PHO,63,7,1227,174,436,0.39899999999999997,43,124,0.34700000000000003,131,312,0.42,0.44799999999999995,76,106,0.7170000000000001,69,210,279,65,41,42,70,179,467
Anthony Morrow,SG,26,NJN,62,18,1636,272,658,0.413,106,286,0.371,166,372,0.446,0.494,97,104,0.9329999999999999,31,96,127,61,46,9,70,86,747
Timofey Mozgov,C,25,DEN,44,35,687,100,190,0.526,0,0,0.0,100,190,0.526,0.526,39,57,0.684,53,126,179,22,15,42,53,86,239
Byron Mullens,C,22,CHA,65,25,1465,251,591,0.425,12,51,0.235,239,540,0.44299999999999995,0.435,92,112,0.821,96,231,327,57,21,52,74,137,606
Troy Murphy,PF,31,LAL,59,0,956,77,171,0.45,28,67,0.418,49,104,0.47100000000000003,0.532,6,9,0.667,40,151,191,51,15,16,26,98,188
Hamady N'Diaye,C,25,WAS,3,0,3,0,1,0.0,0,0,0.0,0,1,0.0,0.0,0,0,0.0,0,0,0,0,0,0,0,0,0
Eduardo Nájera,PF,35,CHA,22,0,270,24,64,0.375,8,29,0.276,16,35,0.457,0.43799999999999994,2,4,0.5,11,39,50,12,19,4,7,40,58
Steve Nash*,PG,37,PHO,62,62,1961,295,555,0.532,55,141,0.39,240,414,0.58,0.581,127,142,0.894,26,160,186,664,38,8,229,53,772
Gary Neal,SG,27,SAS,56,7,1206,212,486,0.436,83,198,0.419,129,288,0.44799999999999995,0.522,50,64,0.7809999999999999,12,106,118,117,27,2,60,75,557
Jameer Nelson,PG,29,ORL,57,57,1706,259,606,0.42700000000000005,87,231,0.377,172,375,0.45899999999999996,0.499,71,88,0.807,29,152,181,325,38,5,135,130,676
Joakim Noah,C,26,CHI,64,64,1945,249,490,0.508,0,1,0.0,249,489,0.509,0.508,154,206,0.748,242,387,629,160,41,92,92,162,652
Andrés Nocioni,SF,32,PHI,11,1,56,5,20,0.25,1,6,0.16699999999999998,4,14,0.28600000000000003,0.275,6,11,0.545,1,13,14,1,1,1,5,4,17
Steve Novak,PF,28,NYK,54,0,1020,161,337,0.478,133,282,0.47200000000000003,28,55,0.509,0.675,22,26,0.846,9,95,104,12,16,9,21,59,477
Dirk Nowitzki,PF,33,DAL,62,62,2079,473,1034,0.457,78,212,0.368,395,822,0.48100000000000004,0.495,318,355,0.8959999999999999,46,372,418,136,42,30,117,129,1342
Jermaine O'Neal,C,33,BOS,25,24,570,52,120,0.433,0,0,0.0,52,120,0.433,0.433,21,31,0.677,37,98,135,10,8,43,21,80,125
Lamar Odom,SF,32,DAL,50,4,1027,123,349,0.35200000000000004,28,111,0.252,95,238,0.39899999999999997,0.39299999999999996,58,98,0.5920000000000001,36,172,208,83,20,18,52,97,332
Emeka Okafor,C,29,NOH,27,27,781,114,214,0.5329999999999999,0,0,0.0,114,214,0.5329999999999999,0.5329999999999999,38,74,0.514,70,143,213,24,16,26,37,73,266
Mehmet Okur,C,32,NJN,17,14,454,52,139,0.374,23,72,0.319,29,67,0.433,0.457,3,5,0.6,22,59,81,30,9,5,25,45,130
Daniel Orton,PF,21,ORL,16,2,187,17,30,0.5670000000000001,0,1,0.0,17,29,0.586,0.5670000000000001,11,25,0.44,19,20,39,5,8,9,7,30,45
Travis Outlaw,SF,27,SAC,39,5,500,60,175,0.34299999999999997,16,60,0.267,44,115,0.38299999999999995,0.389,31,46,0.674,19,42,61,16,19,21,20,34,167
Larry Owens,SF,29,NJN,7,0,75,4,11,0.364,2,5,0.4,2,6,0.33299999999999996,0.455,3,4,0.75,2,11,13,4,0,1,2,10,13
Zaza Pachulia,C,27,ATL,58,44,1640,169,339,0.499,0,0,0.0,169,339,0.499,0.499,117,158,0.741,154,303,457,79,55,29,81,172,455
Jannero Pargo,PG,32,ATL,50,0,671,105,253,0.415,53,138,0.384,52,115,0.452,0.52,19,20,0.95,9,64,73,96,20,2,49,64,282
Jeremy Pargo,PG,25,MEM,44,5,424,50,150,0.33299999999999996,10,38,0.263,40,112,0.35700000000000004,0.36700000000000005,16,27,0.593,12,25,37,55,15,0,46,46,126
Anthony Parker,SF,36,CLE,51,51,1280,141,326,0.433,50,138,0.36200000000000004,91,188,0.484,0.509,35,56,0.625,10,128,138,120,38,7,50,65,367
Tony Parker,PG,29,SAS,60,60,1923,427,890,0.48,14,61,0.23,413,829,0.498,0.488,227,284,0.799,22,149,171,463,57,5,153,75,1095
Chandler Parsons,SF,23,HOU,63,57,1804,248,549,0.452,60,178,0.337,188,371,0.507,0.506,43,78,0.551,90,210,300,134,73,29,81,142,599
Patrick Patterson,PF,22,HOU,64,1,1483,225,511,0.44,0,3,0.0,225,508,0.44299999999999995,0.44,40,57,0.7020000000000001,112,174,286,53,27,36,49,113,490
Chris Paul,PG,26,LAC,60,60,2181,425,890,0.478,79,213,0.371,346,677,0.511,0.522,260,302,0.861,42,171,213,543,152,4,124,138,1189
Sasha Pavlović,SF,28,BOS,45,7,527,50,128,0.391,17,58,0.293,33,70,0.47100000000000003,0.457,3,8,0.375,4,68,72,18,20,15,20,54,120
Nikola Peković,C,26,MIN,47,35,1264,256,454,0.564,0,0,0.0,256,454,0.564,0.564,139,187,0.743,181,165,346,31,29,31,87,98,651
Kendrick Perkins,C,27,OKC,65,65,1744,128,262,0.489,0,0,0.0,128,262,0.489,0.489,73,112,0.652,120,306,426,78,25,73,118,189,329
Johan Petro,C,26,NJN,59,10,920,109,260,0.419,1,1,1.0,108,259,0.41700000000000004,0.42100000000000004,31,37,0.838,68,156,224,45,21,23,38,122,250
Paul Pierce,SF,34,BOS,61,61,2075,394,890,0.44299999999999995,100,273,0.366,294,617,0.47600000000000003,0.499,293,344,0.852,37,280,317,274,70,26,173,147,1181
Mickaël Piétrus,SG,29,BOS,42,6,921,104,270,0.385,61,182,0.335,43,88,0.489,0.498,20,31,0.645,18,112,130,25,21,10,33,81,289
Dexter Pittman,C,23,MIA,35,6,301,44,94,0.46799999999999997,0,0,0.0,44,94,0.46799999999999997,0.46799999999999997,18,28,0.643,27,44,71,9,8,8,17,73,106
Quincy Pondexter,SF,23,MEM,64,8,1002,108,239,0.452,22,73,0.301,86,166,0.518,0.498,33,53,0.623,55,71,126,27,27,5,30,90,271
A.J. Price,PG,25,IND,44,1,568,59,174,0.33899999999999997,26,88,0.295,33,86,0.384,0.414,28,35,0.8,13,48,61,86,20,2,32,30,172
Ronnie Price,PG,28,PHO,36,8,517,49,130,0.377,13,44,0.295,36,86,0.419,0.42700000000000005,20,25,0.8,18,38,56,67,34,3,46,72,131
Tayshaun Prince,SF,31,DET,63,63,2087,336,798,0.42100000000000004,37,104,0.35600000000000004,299,694,0.431,0.444,89,115,0.774,72,209,281,153,27,32,74,77,798
Joel Przybilla,C,32,POR,27,19,449,22,48,0.45799999999999996,0,0,0.0,22,48,0.45799999999999996,0.45799999999999996,11,18,0.611,29,109,138,6,4,16,22,66,55
Vladimir Radmanović,SF,31,ATL,49,3,755,74,197,0.376,50,135,0.37,24,62,0.387,0.503,22,29,0.759,34,109,143,54,21,15,35,62,220
Anthony Randolph,PF,22,MIN,34,5,517,94,200,0.47,0,1,0.0,94,199,0.47200000000000003,0.47,64,84,0.762,42,81,123,19,13,35,40,56,252
Zach Randolph,PF,30,MEM,28,8,735,132,285,0.46299999999999997,2,8,0.25,130,277,0.469,0.467,58,88,0.659,78,147,225,48,21,4,40,57,324
Michael Redd,SG,32,PHO,51,2,770,144,360,0.4,42,132,0.318,102,228,0.447,0.45799999999999996,88,111,0.7929999999999999,14,63,77,33,13,0,37,29,418
J.J. Redick,SG,27,ORL,65,22,1765,248,584,0.425,112,268,0.418,136,316,0.43,0.521,143,157,0.9109999999999999,18,132,150,164,27,6,68,92,751
Ryan Reid,PF,25,OKC,5,0,17,4,5,0.8,0,0,0.0,4,5,0.8,0.8,0,0,0.0,1,1,2,0,0,0,1,1,8
Jason Richardson,SG,31,ORL,54,54,1591,243,596,0.408,102,277,0.368,141,319,0.442,0.493,41,69,0.594,36,158,194,107,53,22,60,91,629
Quentin Richardson,SF,31,ORL,48,3,866,74,197,0.376,42,121,0.34700000000000003,32,76,0.42100000000000004,0.48200000000000004,25,30,0.833,15,108,123,38,28,6,29,74,215
Luke Ridnour,SG,30,MIN,53,53,1750,242,550,0.44,49,152,0.322,193,398,0.485,0.485,106,119,0.8909999999999999,19,122,141,252,56,16,96,136,639
Nate Robinson,PG,27,GSW,51,9,1192,205,484,0.424,66,181,0.365,139,303,0.45899999999999996,0.49200000000000005,94,113,0.8320000000000001,15,85,100,231,59,2,75,118,570
Rajon Rondo,PG,25,BOS,53,53,1957,256,572,0.44799999999999995,10,42,0.23800000000000002,246,530,0.46399999999999997,0.456,108,181,0.597,62,195,257,620,95,3,193,99,630
Derrick Rose,PG,23,CHI,39,39,1375,302,695,0.435,54,173,0.312,248,522,0.475,0.473,194,239,0.812,26,105,131,307,35,28,119,52,852
Ricky Rubio,PG,21,MIN,41,31,1404,139,389,0.35700000000000004,32,94,0.34,107,295,0.363,0.39799999999999996,126,157,0.8029999999999999,21,150,171,336,91,8,131,97,436
Brandon Rush,SF,26,GSW,65,1,1717,235,469,0.501,99,219,0.452,136,250,0.544,0.607,65,82,0.7929999999999999,33,218,251,88,35,58,68,64,634
Walker Russell,PG,29,DET,28,0,357,33,95,0.34700000000000003,4,13,0.308,29,82,0.354,0.368,14,22,0.636,7,19,26,58,18,1,33,29,84
John Salmons,SF,32,SAC,46,32,1250,141,345,0.409,33,112,0.295,108,233,0.46399999999999997,0.457,29,45,0.644,20,114,134,93,37,7,45,77,344
Samardo Samuels,C,23,CLE,54,0,825,105,231,0.455,0,0,0.0,105,231,0.455,0.455,82,117,0.701,63,117,180,20,20,20,56,113,292
Larry Sanders,PF,23,MIL,52,0,643,84,184,0.457,0,2,0.0,84,182,0.462,0.457,18,38,0.474,62,98,160,33,32,76,43,133,186
Brian Scalabrine,PF,33,CHI,28,0,122,14,30,0.467,1,7,0.14300000000000002,13,23,0.565,0.483,3,6,0.5,8,13,21,15,5,6,9,9,32
Luis Scola,PF,31,HOU,66,66,2067,436,888,0.491,0,3,0.0,436,885,0.493,0.491,153,198,0.773,122,306,428,140,35,24,153,214,1025
Thabo Sefolosha,SG,27,OKC,42,42,914,67,155,0.43200000000000005,31,71,0.43700000000000006,36,84,0.429,0.532,38,43,0.884,21,107,128,47,37,17,40,78,203
Josh Selby,PG,20,MEM,28,0,237,25,72,0.34700000000000003,2,15,0.133,23,57,0.40399999999999997,0.361,11,14,0.7859999999999999,2,13,15,30,7,0,29,17,63
Kevin Séraphin,C,22,WAS,57,21,1176,203,382,0.531,0,1,0.0,203,381,0.5329999999999999,0.531,47,70,0.6709999999999999,103,177,280,33,19,76,66,133,453
Ramon Sessions,PG,25,TOT,64,23,1707,242,565,0.428,43,97,0.44299999999999995,199,468,0.425,0.466,194,248,0.782,33,181,214,354,44,3,141,100,721
Iman Shumpert,PG,21,NYK,59,35,1705,214,534,0.401,48,157,0.306,166,377,0.44,0.446,87,109,0.7979999999999999,42,144,186,164,101,8,111,173,563
Xavier Silas,SG,24,PHI,2,0,39,4,15,0.267,1,6,0.16699999999999998,3,9,0.33299999999999996,0.3,2,3,0.667,2,2,4,3,0,0,3,5,11
Bobby Simmons,SF,31,LAC,28,0,418,28,90,0.311,20,60,0.33299999999999996,8,30,0.267,0.42200000000000004,4,7,0.5710000000000001,17,38,55,11,15,3,10,41,80
Chris Singleton,SF,22,WAS,66,51,1431,116,312,0.37200000000000005,44,127,0.34600000000000003,72,185,0.389,0.442,30,44,0.682,43,190,233,49,70,30,38,176,306
James Singleton,PF,30,WAS,12,0,262,41,75,0.547,2,9,0.222,39,66,0.591,0.56,14,15,0.9329999999999999,25,56,81,15,9,8,10,27,98
Brian Skinner,C,35,MEM,1,0,4,0,1,0.0,0,0,0.0,0,1,0.0,0.0,0,0,0.0,0,0,0,0,0,0,0,1,0
Donald Sloan,PG,24,TOT,33,11,669,79,198,0.39899999999999997,2,25,0.08,77,173,0.445,0.40399999999999997,23,30,0.767,18,49,67,105,13,3,49,37,183
Craig Smith,PF,28,POR,47,0,464,59,117,0.504,0,1,0.0,59,116,0.509,0.504,38,53,0.7170000000000001,33,77,110,19,16,5,24,55,156
Greg Smith,C,21,HOU,8,0,69,7,11,0.636,0,0,0.0,7,11,0.636,0.636,0,0,0.0,5,15,20,1,2,5,1,17,14
Ish Smith,PG,23,TOT,26,1,234,31,81,0.38299999999999995,3,9,0.33299999999999996,28,72,0.389,0.401,7,10,0.7,7,28,35,41,15,2,13,15,72
J.R. Smith,SG,26,NYK,35,1,967,165,405,0.40700000000000003,67,193,0.34700000000000003,98,212,0.462,0.49,39,55,0.7090000000000001,29,107,136,84,54,6,46,87,436
Jason Smith,PF,25,NOH,40,29,947,181,348,0.52,1,9,0.111,180,339,0.531,0.522,33,47,0.7020000000000001,72,124,196,34,21,41,40,102,396
Jerry Smith,PG,24,NJN,5,0,46,3,14,0.214,1,6,0.16699999999999998,2,8,0.25,0.25,0,0,0.0,2,5,7,4,5,0,0,5,7
Josh Smith,PF,26,ATL,66,66,2329,504,1101,0.45799999999999996,28,109,0.257,476,992,0.48,0.47,203,322,0.63,136,496,632,257,93,115,164,172,1239
Nolan Smith,PG,23,POR,44,4,541,67,180,0.37200000000000005,13,45,0.289,54,135,0.4,0.408,20,28,0.7140000000000001,17,39,56,62,18,3,42,55,167
Marreese Speights,PF,24,MEM,60,54,1345,221,488,0.45299999999999996,0,3,0.0,221,485,0.456,0.45299999999999996,84,109,0.7709999999999999,133,241,374,48,21,29,74,147,526
Tiago Splitter,C,27,SAS,59,2,1121,212,343,0.618,0,0,0.0,212,343,0.618,0.618,125,181,0.691,93,213,306,65,21,47,87,134,549
Jerry Stackhouse,SF,37,ATL,30,0,273,37,100,0.37,13,38,0.342,24,62,0.387,0.435,21,23,0.9129999999999999,6,17,23,14,10,3,13,12,108
Lance Stephenson,SG,21,IND,42,1,442,47,125,0.376,4,30,0.133,43,95,0.45299999999999996,0.392,8,17,0.47100000000000003,12,41,53,46,21,5,36,30,106
DeShawn Stevenson,SF,30,NJN,51,30,960,49,172,0.285,41,145,0.28300000000000003,8,27,0.29600000000000004,0.40399999999999997,9,16,0.563,7,94,101,41,19,4,19,59,148
Greg Stiemsma,C,26,BOS,55,3,766,66,121,0.545,0,0,0.0,66,121,0.545,0.545,29,41,0.7070000000000001,48,129,177,28,37,85,33,144,161
Julyan Stone,SG,23,DEN,22,2,179,13,31,0.419,2,11,0.182,11,20,0.55,0.452,8,11,0.727,5,20,25,37,8,6,11,18,36
Amar'e Stoudemire,PF,29,NYK,47,47,1543,316,654,0.483,5,21,0.23800000000000002,311,633,0.491,0.48700000000000004,186,243,0.765,106,261,367,52,38,45,112,138,823
Rodney Stuckey,SG,25,DET,55,48,1644,256,597,0.429,33,104,0.317,223,493,0.452,0.456,267,320,0.8340000000000001,38,104,142,210,44,10,106,124,812
DaJuan Summers,SF,24,NOH,15,6,209,28,65,0.431,5,16,0.313,23,49,0.469,0.469,7,9,0.778,8,15,23,10,7,0,8,31,68
Jeff Teague,PG,23,ATL,66,66,2183,320,672,0.47600000000000003,51,149,0.342,269,523,0.514,0.514,140,185,0.757,21,138,159,321,106,37,134,145,831
Sebastian Telfair,PG,26,PHO,60,1,895,141,342,0.41200000000000003,33,105,0.314,108,237,0.456,0.461,53,67,0.7909999999999999,20,71,91,138,41,12,68,120,368
Jason Terry,SG,34,DAL,63,1,2000,357,830,0.43,138,365,0.37799999999999995,219,465,0.47100000000000003,0.513,98,111,0.883,16,133,149,226,73,11,127,69,950
Hasheem Thabeet,C,24,TOT,20,3,139,11,21,0.524,0,0,0.0,11,21,0.524,0.524,13,20,0.65,16,26,42,0,1,10,8,20,35
Isaiah Thomas,PG,22,SAC,65,37,1656,256,571,0.44799999999999995,83,219,0.379,173,352,0.491,0.521,154,185,0.8320000000000001,48,120,168,266,53,8,105,121,749
Kurt Thomas,C,39,POR,53,3,803,73,157,0.465,0,0,0.0,73,157,0.465,0.465,14,20,0.7,39,149,188,46,24,31,31,123,160
Lance Thomas,PF,23,NOH,42,10,630,57,126,0.452,0,1,0.0,57,125,0.456,0.452,52,62,0.8390000000000001,49,77,126,12,10,7,24,78,166
Malcolm Thomas,PF,23,SAS,3,0,15,0,3,0.0,0,0,0.0,0,3,0.0,0.0,1,2,0.5,1,2,3,1,1,1,0,0,1
Tyrus Thomas,PF,25,CHA,54,30,1013,120,327,0.36700000000000005,1,3,0.33299999999999996,119,324,0.36700000000000005,0.369,63,83,0.759,49,151,200,35,36,60,53,144,304
Trey Thompkins,C,21,LAC,24,0,119,24,61,0.39299999999999996,4,13,0.308,20,48,0.41700000000000004,0.426,5,7,0.7140000000000001,4,20,24,3,3,3,6,10,57
Jason Thompson,PF,25,SAC,64,47,1657,237,443,0.535,0,2,0.0,237,441,0.537,0.535,109,181,0.602,166,277,443,79,43,44,68,149,583
Klay Thompson,SG,21,GSW,66,29,1608,318,718,0.44299999999999995,111,268,0.414,207,450,0.46,0.52,79,91,0.868,24,137,161,133,49,20,103,155,826
Mychel Thompson,SG,23,CLE,5,3,95,7,24,0.292,4,11,0.364,3,13,0.231,0.375,0,0,0.0,0,5,5,7,2,1,5,8,18
Tristan Thompson,PF,20,CLE,60,25,1424,194,442,0.439,0,2,0.0,194,440,0.441,0.439,106,192,0.552,187,202,389,27,27,62,81,134,494
Marcus Thornton,SG,24,SAC,51,51,1780,352,803,0.43799999999999994,107,310,0.345,245,493,0.49700000000000005,0.505,141,163,0.865,84,104,188,98,71,12,84,111,952
Jamaal Tinsley,PG,33,UTA,37,1,507,57,141,0.40399999999999997,10,37,0.27,47,104,0.452,0.44,13,17,0.765,6,39,45,123,17,8,52,47,137
Anthony Tolliver,SF,26,MIN,51,0,882,71,182,0.39,25,101,0.248,46,81,0.568,0.45899999999999996,41,55,0.745,50,103,153,22,18,19,35,86,208
Ronny Turiaf,C,29,TOT,17,5,279,19,33,0.5760000000000001,0,1,0.0,19,32,0.594,0.5760000000000001,13,22,0.591,20,50,70,10,14,17,14,39,51
Hedo Türkoğlu,SF,32,ORL,53,53,1653,209,504,0.415,91,258,0.353,118,246,0.48,0.505,67,95,0.705,24,175,199,233,45,17,142,139,576
Evan Turner,SF,23,PHI,65,20,1713,263,590,0.446,11,49,0.22399999999999998,252,541,0.466,0.455,73,108,0.6759999999999999,27,349,376,180,40,20,105,117,610
Jeremy Tyler,C,20,GSW,42,23,568,88,209,0.42100000000000004,0,1,0.0,88,208,0.423,0.42100000000000004,29,52,0.5579999999999999,54,86,140,16,16,20,36,84,205
Edwin Ubiles,SF,25,WAS,4,0,52,5,18,0.278,1,5,0.2,4,13,0.308,0.306,3,3,1.0,2,8,10,1,1,1,1,1,14
Ekpe Udoh,C,24,TOT,61,11,1290,127,295,0.431,0,2,0.0,127,293,0.433,0.431,86,114,0.754,100,154,254,57,40,102,53,174,340
Beno Udrih,SG,29,MIL,59,0,1080,146,332,0.44,17,59,0.28800000000000003,129,273,0.473,0.465,39,55,0.7090000000000001,26,76,102,227,37,1,77,69,348
Ben Uzoh,PG,23,TOT,18,8,370,35,99,0.354,0,1,0.0,35,98,0.35700000000000004,0.354,11,19,0.579,19,48,67,61,17,3,19,31,81
Anderson Varejão,C,29,CLE,25,25,785,114,222,0.514,0,4,0.0,114,218,0.523,0.514,43,64,0.672,109,178,287,43,35,17,45,62,271
Greivis Vásquez,SG,25,NOH,66,26,1706,225,523,0.43,43,135,0.319,182,388,0.469,0.47100000000000003,96,117,0.821,23,150,173,359,60,8,148,126,589
Jan Veselý,PF,21,WAS,57,20,1078,117,218,0.537,0,1,0.0,117,217,0.539,0.537,33,62,0.532,101,148,249,47,39,32,60,156,267
Charlie Villanueva,PF,27,DET,13,0,180,35,91,0.385,15,45,0.33299999999999996,20,46,0.435,0.467,6,7,0.857,9,39,48,6,7,5,7,25,91
Nikola Vučević,C,21,PHI,51,15,812,131,291,0.45,3,8,0.375,128,283,0.452,0.455,18,34,0.529,88,158,246,31,20,34,33,111,283
Dwyane Wade,SG,30,MIA,49,49,1625,416,837,0.49700000000000005,15,56,0.268,401,781,0.513,0.506,235,297,0.7909999999999999,73,164,237,225,82,63,129,110,1082
Von Wafer,SG,26,ORL,33,1,469,71,157,0.452,14,39,0.359,57,118,0.483,0.49700000000000005,38,54,0.7040000000000001,6,39,45,29,10,3,35,26,194
Henry Walker,SG,24,NYK,32,8,620,68,171,0.39799999999999996,36,113,0.319,32,58,0.552,0.503,17,20,0.85,9,71,80,37,19,7,35,84,189
Kemba Walker,PG,21,CHA,66,25,1792,281,767,0.366,69,226,0.305,212,541,0.392,0.41100000000000003,168,213,0.789,30,204,234,289,60,20,119,79,799
John Wall,PG,21,WAS,66,66,2386,378,894,0.423,3,42,0.071,375,852,0.44,0.424,317,402,0.789,48,252,300,530,95,57,255,137,1076
Ben Wallace,C,37,DET,62,11,980,34,86,0.395,1,4,0.25,33,82,0.402,0.401,16,47,0.34,81,188,269,43,47,51,34,60,85
Gerald Wallace,SF,29,TOT,58,58,2076,287,632,0.45399999999999996,46,150,0.307,241,482,0.5,0.491,180,225,0.8,87,299,386,164,85,36,111,145,800
Luke Walton,PF-SF,31,TOT,30,0,364,24,65,0.369,7,20,0.35,17,45,0.37799999999999995,0.423,0,0,0.0,13,36,49,35,5,1,27,41,55
Hakim Warrick,PF,29,PHO,35,0,503,74,180,0.41100000000000003,1,10,0.1,73,170,0.429,0.414,76,99,0.768,31,61,92,30,8,3,36,35,225
Darryl Watkins,C,27,NOH,5,0,98,7,14,0.5,0,0,0.0,7,14,0.5,0.5,9,18,0.5,8,19,27,3,5,4,8,14,23
C.J. Watson,PG,27,CHI,49,25,1159,161,437,0.368,68,173,0.39299999999999996,93,264,0.35200000000000004,0.446,84,104,0.8079999999999999,21,84,105,200,45,8,97,103,474
Earl Watson,PG,32,UTA,50,2,1033,54,160,0.33799999999999997,10,52,0.192,44,108,0.40700000000000003,0.369,31,46,0.674,30,91,121,217,54,22,85,105,149
Martell Webster,SF,25,MIN,47,26,1140,115,272,0.423,37,109,0.33899999999999997,78,163,0.479,0.491,57,72,0.792,42,126,168,40,31,17,46,86,324
David West,PF,31,IND,66,66,1925,349,716,0.48700000000000004,2,9,0.222,347,707,0.491,0.489,142,176,0.807,118,315,433,140,52,46,93,160,842
Delonte West,PG,28,DAL,44,33,1060,166,360,0.461,27,76,0.355,139,284,0.489,0.499,62,70,0.8859999999999999,13,88,101,139,58,11,76,67,421
Russell Westbrook,PG,23,OKC,66,66,2331,578,1266,0.457,62,196,0.316,516,1070,0.48200000000000004,0.48100000000000004,340,413,0.823,96,205,301,362,112,21,239,147,1558
D.J. White,PF,25,CHA,58,11,1098,174,353,0.493,1,1,1.0,173,352,0.491,0.494,43,61,0.705,50,159,209,47,17,23,43,94,392
Hassan Whiteside,C,22,SAC,18,0,109,12,27,0.444,0,0,0.0,12,27,0.444,0.444,5,12,0.41700000000000004,16,23,39,0,3,15,5,12,29
Chris Wilcox,C,29,BOS,28,4,481,64,107,0.598,0,0,0.0,64,107,0.598,0.598,24,39,0.615,38,84,122,12,11,9,30,64,152
Damien Wilkins,SF,32,DET,60,2,922,76,193,0.39399999999999996,7,23,0.304,69,170,0.406,0.41200000000000003,34,54,0.63,22,78,100,44,29,13,30,85,193
Deron Williams,PG,27,NJN,55,55,1999,391,961,0.40700000000000003,115,342,0.336,276,619,0.446,0.467,257,305,0.843,23,160,183,481,67,20,219,121,1154
Derrick Williams,PF,20,MIN,66,15,1418,205,498,0.41200000000000003,37,138,0.268,168,360,0.467,0.449,136,195,0.6970000000000001,77,234,311,38,30,31,77,95,583
Elliot Williams,SG,22,POR,24,0,149,37,74,0.5,8,27,0.29600000000000004,29,47,0.617,0.5539999999999999,6,18,0.33299999999999996,7,12,19,6,6,3,5,18,88
Jordan Williams,C,21,NJN,43,5,635,77,152,0.507,0,0,0.0,77,152,0.507,0.507,43,66,0.652,66,90,156,11,21,15,23,61,197
Lou Williams,PG,25,PHI,64,0,1682,318,782,0.40700000000000003,83,229,0.36200000000000004,235,553,0.425,0.46,237,292,0.812,30,125,155,221,53,18,71,90,956
Marvin Williams,SF,25,ATL,57,37,1500,203,470,0.43200000000000005,58,149,0.389,145,321,0.452,0.494,115,146,0.7879999999999999,76,218,294,71,47,18,39,84,579
Mo Williams,SG,29,LAC,52,1,1472,260,611,0.426,93,239,0.389,167,372,0.449,0.502,72,80,0.9,23,76,99,160,51,7,86,103,685
Reggie Williams,SF,25,CHA,33,13,747,106,255,0.41600000000000004,33,107,0.308,73,148,0.493,0.48,29,40,0.725,27,66,93,60,20,3,33,34,274
Sean Williams,C,25,TOT,11,0,107,14,22,0.636,0,0,0.0,14,22,0.636,0.636,12,13,0.9229999999999999,13,12,25,5,4,8,10,18,40
Shawne Williams,SF,25,NJN,25,6,514,42,147,0.28600000000000003,21,87,0.24100000000000002,21,60,0.35,0.35700000000000004,8,11,0.727,20,48,68,16,10,11,13,44,113
Shelden Williams,C,28,NJN,58,35,1276,96,201,0.478,0,0,0.0,96,201,0.478,0.478,76,104,0.731,141,209,350,35,47,39,66,149,268
Terrence Williams,SG,24,TOT,30,0,550,85,198,0.429,16,46,0.348,69,152,0.45399999999999996,0.47,27,46,0.5870000000000001,13,89,102,65,20,7,43,35,213
Metta World Peace,SF,32,LAL,64,45,1720,183,465,0.39399999999999996,56,189,0.29600000000000004,127,276,0.46,0.45399999999999996,71,115,0.617,71,147,218,140,69,27,69,137,493
Brandan Wright,C,24,DAL,49,0,791,144,233,0.618,0,1,0.0,144,232,0.621,0.618,52,82,0.634,62,112,174,13,22,63,21,61,340
Chris Wright,SF,23,GSW,24,1,186,23,45,0.511,0,0,0.0,23,45,0.511,0.511,24,31,0.774,19,26,45,4,7,13,8,22,70
Dorell Wright,SF,26,GSW,61,61,1650,222,526,0.42200000000000004,105,292,0.36,117,234,0.5,0.522,80,98,0.816,60,218,278,94,58,26,51,97,629
Nick Young,SG,26,TOT,62,35,1729,316,784,0.40299999999999997,103,282,0.365,213,502,0.424,0.469,144,169,0.852,31,102,133,56,44,17,83,141,879
Sam Young,SF,26,TOT,35,2,375,45,127,0.354,5,17,0.294,40,110,0.364,0.374,19,26,0.731,20,42,62,15,17,6,16,23,114
Thaddeus Young,PF,23,PHI,63,1,1755,348,687,0.507,1,4,0.25,347,683,0.508,0.507,111,144,0.7709999999999999,137,188,325,74,64,41,55,127,808
