Player,Pos,Age,Tm,G,GS,MP,FG,FGA,FG%,3P,3PA,3P%,2P,2PA,2P%,eFG%,FT,FTA,FT%,ORB,DRB,TRB,AST,STL,BLK,TOV,PF,PTS
Jeff Adrien,PF,24,GSW,23,0,196,23,54,0.426,0,0,0.0,23,54,0.426,0.426,11,19,0.579,23,35,58,10,4,5,9,28,57
Arron Afflalo,SG,25,DEN,69,69,2324,312,627,0.498,105,248,0.423,207,379,0.546,0.581,138,163,0.847,45,206,251,168,34,31,71,153,867
Maurice Ager,SG,26,MIN,4,0,29,6,11,0.545,3,4,0.75,3,7,0.429,0.682,0,0,0.0,0,2,2,1,1,0,4,4,15
Alexis Ajinça,C,22,TOT,34,2,340,59,133,0.444,12,34,0.353,47,99,0.475,0.489,13,18,0.722,17,61,78,10,11,19,18,73,143
Solomon Alabi,C,22,TOR,12,0,59,3,15,0.2,0,0,0.0,3,15,0.2,0.2,0,2,0.0,7,7,14,2,2,2,3,5,6
Cole Aldrich,C,22,OKC,18,0,142,8,15,0.5329999999999999,0,0,0.0,8,15,0.5329999999999999,0.5329999999999999,2,4,0.5,13,22,35,4,5,7,8,30,18
LaMarcus Aldridge,PF,25,POR,81,81,3211,707,1415,0.5,4,23,0.174,703,1392,0.505,0.501,351,444,0.7909999999999999,278,431,709,170,82,94,153,220,1769
Malik Allen,PF,32,ORL,18,0,178,11,31,0.355,0,0,0.0,11,31,0.355,0.355,1,2,0.5,12,20,32,4,1,4,3,30,23
Ray Allen*,SG,35,BOS,80,80,2890,480,978,0.491,168,378,0.444,312,600,0.52,0.5770000000000001,193,219,0.8809999999999999,51,223,274,219,77,16,117,147,1321
Tony Allen,SG,29,MEM,72,31,1494,251,492,0.51,4,23,0.174,247,469,0.527,0.514,137,182,0.753,70,123,193,104,129,44,86,161,643
Al-Farouq Aminu,SF,20,LAC,81,14,1452,160,406,0.39399999999999996,45,143,0.315,115,263,0.43700000000000006,0.45,92,119,0.773,75,192,267,60,59,25,103,121,457
Lou Amundson,PF,28,GSW,46,7,691,83,183,0.45399999999999996,0,0,0.0,83,183,0.45399999999999996,0.45399999999999996,34,87,0.391,81,104,185,17,14,33,24,87,200
Chris Andersen,C,32,DEN,45,0,732,82,137,0.599,0,1,0.0,82,136,0.603,0.599,86,135,0.637,75,144,219,20,23,58,25,79,250
David Andersen,PF,30,TOT,40,0,373,56,121,0.46299999999999997,8,23,0.348,48,98,0.49,0.496,14,22,0.636,20,64,84,13,5,9,22,40,134
James Anderson,SF,21,SAS,26,2,286,31,81,0.38299999999999995,18,46,0.391,13,35,0.371,0.494,14,18,0.778,2,21,23,18,3,6,13,24,94
Ryan Anderson,PF,22,ORL,64,14,1424,226,525,0.43,134,341,0.39299999999999996,92,184,0.5,0.5579999999999999,95,117,0.812,129,226,355,52,30,38,49,137,681
Carmelo Anthony,SF,26,TOT,77,77,2751,684,1503,0.455,95,251,0.37799999999999995,589,1252,0.47,0.48700000000000004,507,605,0.838,118,445,563,221,68,46,206,224,1970
Joel Anthony,C,28,MIA,75,11,1463,53,99,0.535,0,0,0.0,53,99,0.535,0.535,47,73,0.644,104,162,266,24,10,93,36,194,153
Gilbert Arenas,PG,29,TOT,70,16,1796,269,734,0.366,97,327,0.297,172,407,0.423,0.433,120,153,0.784,22,167,189,274,74,21,177,188,755
Trevor Ariza,SF,25,NOH,75,75,2600,303,762,0.39799999999999996,82,271,0.303,221,491,0.45,0.451,138,197,0.701,61,347,408,162,120,31,118,180,826
Hilton Armstrong,C,26,TOT,53,2,488,37,76,0.48700000000000004,2,4,0.5,35,72,0.486,0.5,16,33,0.485,42,89,131,14,18,21,28,84,92
Carlos Arroyo,PG,31,TOT,64,43,1185,120,273,0.44,31,69,0.449,89,204,0.436,0.496,39,47,0.83,20,83,103,125,21,1,60,71,310
Darrell Arthur,PF,22,MEM,80,9,1609,310,624,0.49700000000000005,0,6,0.0,310,618,0.502,0.49700000000000005,109,134,0.813,115,227,342,53,52,63,88,228,729
Ömer Aşık,C,24,CHI,82,0,989,78,141,0.5529999999999999,0,0,0.0,78,141,0.5529999999999999,0.5529999999999999,73,145,0.503,112,194,306,32,20,56,64,153,229
D.J. Augustin,PG,23,CHA,82,82,2757,399,958,0.41600000000000004,111,333,0.33299999999999996,288,625,0.461,0.474,269,297,0.9059999999999999,38,187,225,498,54,3,155,152,1178
Luke Babbitt,SF,21,POR,24,0,137,15,55,0.273,3,16,0.188,12,39,0.308,0.3,3,9,0.33299999999999996,6,24,30,6,2,2,8,15,36
Renaldo Balkman,SF,26,TOT,8,0,62,6,13,0.462,1,2,0.5,5,11,0.455,0.5,3,4,0.75,2,5,7,2,4,2,1,15,16
Marcus Banks,PG,29,TOR,3,0,22,0,2,0.0,0,0,0.0,0,2,0.0,0.0,6,8,0.75,0,1,1,3,1,0,2,4,6
Leandro Barbosa,SG,28,TOR,58,0,1395,294,653,0.45,72,213,0.33799999999999997,222,440,0.505,0.505,109,137,0.7959999999999999,14,85,99,119,50,6,84,112,769
J.J. Barea,PG,26,DAL,81,2,1669,285,649,0.439,66,189,0.349,219,460,0.47600000000000003,0.49,133,157,0.847,29,130,159,317,30,1,136,136,769
Andrea Bargnani,C,25,TOR,66,66,2353,525,1173,0.44799999999999995,77,223,0.345,448,950,0.47200000000000003,0.48,287,350,0.82,74,269,343,119,34,46,152,160,1414
Matt Barnes,SF,30,LAL,53,0,1020,131,279,0.47,34,107,0.318,97,172,0.564,0.53,60,77,0.779,73,155,228,71,39,22,58,127,356
Earl Barron,C,29,TOT,21,7,305,32,99,0.32299999999999995,0,0,0.0,32,99,0.32299999999999995,0.32299999999999995,15,24,0.625,32,44,76,11,8,6,16,46,79
Brandon Bass,PF,25,ORL,76,51,1980,332,645,0.515,0,2,0.0,332,643,0.516,0.515,190,233,0.815,134,290,424,57,27,52,97,159,854
Tony Battie,C,34,PHI,38,0,377,45,96,0.469,2,3,0.667,43,93,0.462,0.479,8,14,0.5710000000000001,17,82,99,12,5,15,12,59,100
Shane Battier,SF,32,TOT,82,59,2375,229,509,0.45,102,267,0.382,127,242,0.525,0.55,64,93,0.688,90,283,373,185,69,81,79,158,624
Nicolas Batum,SF,22,POR,80,67,2522,367,807,0.455,118,342,0.345,249,465,0.535,0.528,138,164,0.841,109,252,361,123,68,49,83,194,990
Jerryd Bayless,PG,22,TOT,71,14,1496,218,517,0.42200000000000004,49,146,0.336,169,371,0.456,0.469,166,206,0.8059999999999999,26,139,165,266,38,5,127,149,651
Michael Beasley,SF,22,MIN,73,73,2361,561,1246,0.45,60,164,0.366,501,1082,0.46299999999999997,0.474,219,291,0.753,118,291,409,158,54,52,195,222,1401
Rodrigue Beaubois,PG,22,DAL,28,26,496,94,223,0.42200000000000004,25,83,0.301,69,140,0.493,0.478,23,30,0.767,7,45,52,64,20,8,47,76,236
Marco Belinelli,SG,24,NOH,80,69,1957,302,691,0.43700000000000006,134,324,0.414,168,367,0.45799999999999996,0.534,98,125,0.784,17,134,151,92,38,6,77,146,836
Charlie Bell,SG,31,GSW,19,0,171,12,43,0.27899999999999997,6,21,0.28600000000000003,6,22,0.273,0.349,2,4,0.5,6,12,18,13,6,1,6,13,32
Raja Bell,SG,34,UTA,68,63,2097,191,467,0.409,68,193,0.35200000000000004,123,274,0.449,0.48200000000000004,91,102,0.892,31,145,176,118,56,14,63,169,541
Mike Bibby,PG,32,TOT,80,68,2285,248,576,0.431,153,348,0.44,95,228,0.41700000000000004,0.563,39,62,0.629,17,178,195,265,50,9,101,175,688
Andris Biedriņš,C,24,GSW,59,55,1397,142,266,0.534,0,0,0.0,142,266,0.534,0.534,10,31,0.32299999999999995,145,281,426,60,52,52,57,198,294
Chauncey Billups,PG,34,TOT,72,72,2310,339,794,0.42700000000000005,146,363,0.402,193,431,0.44799999999999995,0.519,384,419,0.9159999999999999,25,165,190,387,71,14,177,146,1208
DeJuan Blair,PF,21,SAS,81,65,1734,292,583,0.501,0,2,0.0,292,581,0.503,0.501,90,137,0.657,215,350,565,77,95,42,113,213,674
Steve Blake,PG,30,LAL,79,0,1581,110,306,0.359,73,193,0.37799999999999995,37,113,0.327,0.479,26,30,0.867,19,137,156,170,40,3,73,99,319
Andray Blatche,PF,24,WAS,64,63,2172,426,957,0.445,4,18,0.222,422,939,0.449,0.447,220,283,0.777,183,343,526,144,98,51,172,182,1076
Eric Bledsoe,PG,21,LAC,81,25,1841,206,486,0.424,32,116,0.276,174,370,0.47,0.457,99,133,0.7440000000000001,68,155,223,289,92,26,194,130,543
Keith Bogans,SG,30,CHI,82,82,1461,124,307,0.40399999999999997,90,237,0.38,34,70,0.486,0.55,21,32,0.6559999999999999,19,129,148,101,38,9,41,113,359
Andrew Bogut,C,26,MIL,65,65,2297,367,742,0.495,0,4,0.0,367,738,0.49700000000000005,0.495,96,217,0.442,199,521,720,131,47,168,125,217,830
Matt Bonner,PF,30,SAS,66,1,1432,172,371,0.46399999999999997,105,230,0.457,67,141,0.475,0.605,32,43,0.7440000000000001,60,179,239,60,26,21,27,110,481
Trevor Booker,PF,23,WAS,65,14,1063,139,253,0.5489999999999999,0,1,0.0,139,252,0.552,0.5489999999999999,68,101,0.6729999999999999,98,153,251,35,29,42,38,115,346
Carlos Boozer,C,29,CHI,59,59,1882,431,845,0.51,0,0,0.0,431,845,0.51,0.51,171,244,0.701,130,435,565,145,45,18,149,186,1033
Chris Bosh,PF,26,MIA,77,77,2795,524,1056,0.496,6,25,0.24,518,1031,0.502,0.499,384,471,0.815,141,500,641,144,59,49,138,172,1438
Earl Boykins,PG,34,MIL,57,0,862,156,352,0.44299999999999995,27,71,0.38,129,281,0.45899999999999996,0.48200000000000004,69,82,0.841,15,40,55,141,38,3,52,43,408
Craig Brackins,PF,23,PHI,3,0,33,4,16,0.25,0,5,0.0,4,11,0.364,0.25,0,0,0.0,2,2,4,1,1,0,0,3,8
Avery Bradley,PG,20,BOS,31,0,162,23,67,0.34299999999999997,0,5,0.0,23,62,0.371,0.34299999999999997,6,12,0.5,4,13,17,12,9,0,16,20,52
Elton Brand,PF,31,PHI,81,81,2809,502,981,0.512,0,1,0.0,502,980,0.512,0.512,213,273,0.78,237,439,676,120,92,106,101,244,1217
Corey Brewer,SF-SG,24,TOT,69,24,1510,193,488,0.395,30,112,0.268,163,376,0.434,0.426,136,192,0.708,57,118,175,89,100,16,87,159,552
Ronnie Brewer,SG,25,CHI,81,1,1781,205,427,0.48,6,27,0.222,199,400,0.498,0.48700000000000004,87,133,0.654,55,207,262,140,106,22,55,82,503
Jon Brockman,C,23,MIL,63,6,677,48,94,0.511,0,0,0.0,48,94,0.511,0.511,40,59,0.6779999999999999,74,110,184,18,14,3,24,119,136
Aaron Brooks,PG,26,TOT,59,12,1284,220,587,0.375,70,236,0.297,150,351,0.42700000000000005,0.434,124,140,0.8859999999999999,20,58,78,233,34,3,99,115,634
Derrick Brown,SF,23,TOT,49,1,576,74,131,0.565,5,10,0.5,69,121,0.57,0.584,32,60,0.5329999999999999,41,58,99,33,20,10,35,59,185
Kwame Brown,C,28,CHA,66,50,1714,194,375,0.517,0,0,0.0,194,375,0.517,0.517,136,231,0.589,147,303,450,43,26,39,69,174,524
Shannon Brown,SG,25,LAL,82,0,1568,273,643,0.425,74,212,0.349,199,431,0.462,0.48200000000000004,92,101,0.9109999999999999,35,122,157,96,67,16,75,124,712
Kobe Bryant,SG,32,LAL,82,82,2779,740,1639,0.451,115,356,0.32299999999999995,625,1283,0.48700000000000004,0.48700000000000004,483,583,0.828,83,336,419,388,99,12,243,172,2078
Chase Budinger,SF,22,HOU,78,22,1738,279,656,0.425,89,274,0.325,190,382,0.49700000000000005,0.493,118,138,0.855,52,229,281,127,41,18,67,114,765
Caron Butler,SF,30,DAL,29,29,867,170,378,0.45,28,65,0.431,142,313,0.45399999999999996,0.48700000000000004,68,88,0.773,22,96,118,46,28,8,49,59,436
Rasual Butler,SG,31,TOT,47,2,770,79,237,0.33299999999999996,46,136,0.33799999999999997,33,101,0.327,0.43,18,27,0.667,10,67,77,27,8,15,24,37,222
Andrew Bynum,C,23,LAL,54,47,1500,237,413,0.574,0,0,0.0,237,413,0.574,0.574,138,209,0.66,170,338,508,73,19,106,74,140,612
Will Bynum,PG,28,DET,61,5,1125,182,406,0.44799999999999995,16,50,0.32,166,356,0.466,0.46799999999999997,102,122,0.836,15,59,74,195,52,4,83,113,482
José Calderón,PG,29,TOR,68,55,2102,262,596,0.44,57,156,0.365,205,440,0.466,0.48700000000000004,88,103,0.8540000000000001,30,172,202,605,81,7,148,143,669
Marcus Camby,C,36,POR,59,51,1540,117,294,0.39799999999999996,0,1,0.0,117,293,0.39899999999999997,0.39799999999999996,43,70,0.614,182,424,606,121,40,92,62,140,277
Derrick Caracter,C,22,LAL,41,0,215,32,66,0.485,0,0,0.0,32,66,0.485,0.485,17,23,0.7390000000000001,19,24,43,7,4,10,19,47,81
Brian Cardinal,SF,33,DAL,56,4,618,43,100,0.43,42,87,0.483,1,13,0.077,0.64,17,18,0.9440000000000001,10,49,59,40,24,7,17,82,145
Rodney Carney,SF,26,TOT,27,1,336,46,110,0.418,17,38,0.447,29,72,0.40299999999999997,0.495,18,27,0.667,13,35,48,11,12,5,16,33,127
DeMarre Carroll,PF,24,TOT,12,0,50,4,12,0.33299999999999996,0,0,0.0,4,12,0.33299999999999996,0.33299999999999996,2,2,1.0,2,6,8,4,1,1,0,5,10
Matt Carroll,SG,30,CHA,54,1,582,89,199,0.447,17,46,0.37,72,153,0.47100000000000003,0.49,40,52,0.769,12,56,68,23,17,6,23,43,235
Anthony Carter,PG,35,TOT,33,0,463,45,106,0.425,12,40,0.3,33,66,0.5,0.48100000000000004,8,8,1.0,7,44,51,69,27,6,39,49,110
Vince Carter,SG,34,TOT,73,63,2051,389,891,0.43700000000000006,116,321,0.361,273,570,0.479,0.502,128,173,0.74,54,221,275,146,67,20,90,193,1022
Omri Casspi,SF,22,SAC,71,27,1702,225,546,0.41200000000000003,92,247,0.37200000000000005,133,299,0.445,0.496,68,101,0.6729999999999999,74,233,307,74,54,13,68,115,610
Mario Chalmers,PG,24,MIA,70,28,1579,155,388,0.39899999999999997,83,231,0.359,72,157,0.45899999999999996,0.506,54,62,0.871,12,134,146,177,76,7,91,158,447
Tyson Chandler,C,28,DAL,74,74,2059,266,407,0.654,0,0,0.0,266,407,0.654,0.654,216,295,0.732,206,486,692,32,36,80,88,240,748
Wilson Chandler,SF,23,TOT,72,49,2401,429,953,0.45,112,320,0.35,317,633,0.501,0.509,130,161,0.807,75,333,408,120,48,94,104,199,1100
Josh Childress,SG,27,PHO,54,3,894,121,214,0.565,1,16,0.063,120,198,0.606,0.568,29,59,0.49200000000000005,69,86,155,42,33,23,44,68,272
Earl Clark,SF,23,TOT,42,0,464,68,158,0.43,0,5,0.0,68,153,0.444,0.43,27,47,0.574,37,64,101,9,8,18,28,45,163
Jarron Collins,C,32,TOT,28,0,181,6,21,0.28600000000000003,0,0,0.0,6,21,0.28600000000000003,0.28600000000000003,7,10,0.7,14,10,24,2,4,1,7,29,19
Jason Collins,C,32,ATL,49,28,593,34,71,0.479,1,1,1.0,33,70,0.47100000000000003,0.486,27,41,0.659,30,72,102,22,9,9,26,97,96
Sherron Collins,PG,23,CHA,20,0,66,7,25,0.28,2,10,0.2,5,15,0.33299999999999996,0.32,1,1,1.0,0,5,5,8,2,0,4,2,17
Darren Collison,PG,23,IND,79,79,2360,398,870,0.457,41,124,0.331,357,746,0.479,0.48100000000000004,202,232,0.871,40,185,225,403,87,14,194,109,1039
Nick Collison,C,30,OKC,71,2,1524,137,242,0.5660000000000001,0,0,0.0,137,242,0.5660000000000001,0.5660000000000001,55,73,0.753,119,197,316,69,42,31,55,210,329
Mike Conley,PG,23,MEM,81,81,2872,423,953,0.444,80,217,0.369,343,736,0.466,0.486,181,247,0.733,32,215,247,528,144,18,176,182,1107
Brian Cook,PF,30,LAC,40,0,447,72,170,0.424,34,79,0.43,38,91,0.418,0.524,15,24,0.625,19,77,96,15,12,11,25,75,193
Daequan Cook,SG,23,OKC,43,0,598,79,181,0.436,65,154,0.42200000000000004,14,27,0.519,0.616,16,20,0.8,8,64,72,20,14,1,17,51,239
Marcus Cousin,C,24,UTA,4,0,18,2,3,0.667,0,0,0.0,2,3,0.667,0.667,0,0,0.0,0,3,3,0,0,1,1,1,4
DeMarcus Cousins,C,20,SAC,81,62,2309,432,1004,0.43,3,18,0.16699999999999998,429,986,0.435,0.43200000000000005,276,402,0.687,217,482,699,204,85,68,268,332,1143
Jamal Crawford,SG,30,ATL,76,0,2297,368,874,0.42100000000000004,119,349,0.341,249,525,0.474,0.489,222,260,0.8540000000000001,22,108,130,241,57,14,145,97,1077
Jordan Crawford,SG,22,TOT,42,18,1027,192,500,0.384,33,128,0.258,159,372,0.42700000000000005,0.41700000000000004,73,84,0.8690000000000001,31,74,105,117,39,3,83,63,490
Dante Cunningham,PF,23,TOT,78,18,1637,218,472,0.462,1,13,0.077,217,459,0.473,0.46299999999999997,45,62,0.726,96,181,277,43,54,43,51,177,482
Stephen Curry,PG,22,GSW,74,74,2489,505,1053,0.48,151,342,0.442,354,711,0.498,0.551,212,227,0.934,52,234,286,432,109,20,226,233,1373
Samuel Dalembert,C,29,SAC,80,46,1938,268,567,0.473,0,2,0.0,268,565,0.474,0.473,108,148,0.73,212,445,657,67,36,116,132,225,644
Erick Dampier,C,35,MIA,51,22,815,52,89,0.584,0,1,0.0,52,88,0.591,0.584,24,44,0.545,53,124,177,22,14,47,32,82,128
Antonio Daniels,PG,35,PHI,4,0,35,2,5,0.4,0,2,0.0,2,3,0.667,0.4,2,2,1.0,0,5,5,2,0,0,1,0,6
Marquis Daniels,SF,30,BOS,49,0,938,114,232,0.491,4,21,0.19,110,211,0.521,0.5,39,57,0.684,24,89,113,64,39,22,38,63,271
Baron Davis,PG,31,TOT,58,44,1649,289,693,0.41700000000000004,81,239,0.33899999999999997,208,454,0.45799999999999996,0.475,101,131,0.7709999999999999,35,121,156,391,78,28,146,143,760
Ed Davis,PF,21,TOR,65,17,1602,215,373,0.5760000000000001,0,0,0.0,215,373,0.5760000000000001,0.5760000000000001,71,128,0.555,168,294,462,40,39,67,48,183,501
Glen Davis,C,25,BOS,78,13,2298,359,801,0.44799999999999995,2,15,0.133,357,786,0.45399999999999996,0.449,195,265,0.736,101,324,425,92,78,30,85,231,915
Austin Daye,SF,22,DET,72,16,1446,193,471,0.41,69,172,0.401,124,299,0.415,0.483,82,108,0.759,64,210,274,78,39,39,59,165,537
Carlos Delfino,SF,28,MIL,49,40,1590,200,513,0.39,105,284,0.37,95,229,0.415,0.49200000000000005,60,75,0.8,24,176,200,112,76,8,57,72,565
Luol Deng,SF,25,CHI,82,82,3208,531,1155,0.46,115,333,0.345,416,822,0.506,0.51,253,336,0.753,116,360,476,230,78,48,156,162,1430
DeMar DeRozan,SG,21,TOR,82,82,2851,539,1154,0.467,5,52,0.096,534,1102,0.485,0.469,327,402,0.813,75,240,315,148,85,31,144,217,1410
Boris Diaw,PF,28,CHA,82,82,2778,381,774,0.49200000000000005,78,226,0.345,303,548,0.5529999999999999,0.5429999999999999,84,123,0.6829999999999999,105,309,414,337,74,46,166,190,924
Ike Diogu,PF,27,LAC,36,0,470,83,148,0.561,0,0,0.0,83,148,0.561,0.561,41,62,0.6609999999999999,41,74,115,2,3,3,22,72,207
DeSagana Diop,C,29,CHA,16,0,181,8,24,0.33299999999999996,0,0,0.0,8,24,0.33299999999999996,0.33299999999999996,4,11,0.364,12,28,40,7,4,15,11,26,20
Keyon Dooling,PG,30,MIL,80,22,1757,206,519,0.397,81,234,0.34600000000000003,125,285,0.439,0.475,78,94,0.83,12,105,117,243,54,4,91,119,571
Joey Dorsey,C,27,TOR,43,9,522,52,99,0.525,0,0,0.0,52,99,0.525,0.525,31,65,0.47700000000000004,79,111,190,27,24,17,39,78,135
Toney Douglas,SG,24,NYK,81,9,1971,314,755,0.41600000000000004,143,383,0.373,171,372,0.46,0.511,85,107,0.794,65,179,244,244,89,4,89,177,856
Chris Douglas-Roberts,SF,24,MIL,44,12,884,117,273,0.429,15,46,0.326,102,227,0.449,0.456,74,89,0.831,7,81,88,50,29,13,35,73,323
Zabian Dowdell,PG,26,PHO,24,0,292,51,125,0.408,3,10,0.3,48,115,0.41700000000000004,0.42,16,17,0.941,5,15,20,51,20,2,29,30,121
Goran Dragić,PG,24,TOT,70,5,1234,192,441,0.435,56,155,0.361,136,286,0.47600000000000003,0.499,83,133,0.624,36,106,142,204,50,10,117,125,523
Jared Dudley,SF,25,PHO,82,15,2140,300,629,0.47700000000000004,105,253,0.415,195,376,0.519,0.56,162,218,0.743,111,207,318,108,87,20,77,139,867
Chris Duhon,PG,28,ORL,51,5,774,49,129,0.38,13,52,0.25,36,77,0.46799999999999997,0.43,14,25,0.56,9,43,52,118,16,2,61,30,125
Tim Duncan,C,34,SAS,76,76,2156,419,838,0.5,0,4,0.0,419,834,0.502,0.5,184,257,0.716,169,509,678,203,50,146,122,119,1022
Mike Dunleavy,SG,30,IND,61,44,1683,240,520,0.462,102,254,0.402,138,266,0.519,0.56,100,125,0.8,28,248,276,105,40,30,69,107,682
Ronald Dupree,SF,30,TOR,3,0,13,1,4,0.25,0,1,0.0,1,3,0.33299999999999996,0.25,0,0,0.0,0,3,3,1,0,0,0,2,2
Kevin Durant,SF,22,OKC,78,78,3038,711,1538,0.462,145,414,0.35,566,1124,0.504,0.509,594,675,0.88,57,476,533,214,88,76,218,159,2161
Devin Ebanks,SG,21,LAL,20,0,118,21,51,0.41200000000000003,2,5,0.4,19,46,0.413,0.431,18,23,0.7829999999999999,15,12,27,2,4,5,6,7,62
Wayne Ellington,SG,23,MIN,62,8,1181,160,397,0.40299999999999997,48,121,0.397,112,276,0.406,0.46299999999999997,42,53,0.792,26,82,108,72,28,3,53,85,410
Monta Ellis,SG,25,GSW,80,80,3227,726,1611,0.451,137,379,0.361,589,1232,0.478,0.493,340,431,0.789,44,237,281,450,168,23,252,203,1929
Francisco Elson,C,34,UTA,62,1,610,54,113,0.478,0,0,0.0,54,113,0.478,0.478,26,31,0.8390000000000001,35,80,115,33,21,14,32,84,134
Melvin Ely,C,32,DEN,30,2,366,28,51,0.5489999999999999,0,0,0.0,28,51,0.5489999999999999,0.5489999999999999,13,21,0.619,27,47,74,14,4,11,14,50,69
Semih Erden,C,24,TOT,41,8,595,62,111,0.5589999999999999,0,0,0.0,62,111,0.5589999999999999,0.5589999999999999,39,60,0.65,37,81,118,20,15,24,34,104,163
Jeremy Evans,SF,23,UTA,49,3,463,76,115,0.6609999999999999,0,1,0.0,76,114,0.667,0.6609999999999999,26,37,0.703,36,61,97,24,17,17,19,50,178
Maurice Evans,SF,32,TOT,73,24,1549,177,424,0.41700000000000004,55,167,0.32899999999999996,122,257,0.475,0.48200000000000004,52,58,0.897,52,104,156,45,34,14,33,129,461
Reggie Evans,PF,30,TOR,30,18,798,42,103,0.408,0,1,0.0,42,102,0.41200000000000003,0.408,48,88,0.545,119,226,345,38,29,6,39,89,132
Tyreke Evans,SG,21,SAC,57,53,2107,382,933,0.409,43,148,0.29100000000000004,339,785,0.43200000000000005,0.43200000000000005,205,266,0.7709999999999999,46,229,275,319,85,30,184,143,1012
Patrick Ewing,SF,26,NOH,7,0,19,0,5,0.0,0,2,0.0,0,3,0.0,0.0,3,4,0.75,1,1,2,2,0,1,1,1,3
Christian Eyenga,SF,21,CLE,44,18,947,130,306,0.425,25,91,0.275,105,215,0.488,0.466,18,28,0.643,27,96,123,35,34,28,47,78,303
Jordan Farmar,PG,24,NJN,73,18,1796,255,651,0.392,109,304,0.359,146,347,0.42100000000000004,0.475,82,100,0.82,24,149,173,368,62,6,139,128,701
Derrick Favors,PF,19,TOT,78,27,1535,215,416,0.517,0,0,0.0,215,416,0.517,0.517,103,173,0.595,171,241,412,39,29,68,77,246,533
Raymond Felton,PG-SG,26,TOT,75,54,2737,427,1005,0.425,116,329,0.353,311,676,0.46,0.483,194,241,0.805,48,221,269,625,125,11,221,150,1164
Rudy Fernández,SG,25,POR,78,3,1821,213,575,0.37,116,361,0.321,97,214,0.45299999999999996,0.47100000000000003,126,146,0.863,37,135,172,193,87,14,88,134,668
Kyrylo Fesenko,C,24,UTA,53,1,456,44,100,0.44,0,1,0.0,44,99,0.444,0.44,18,46,0.391,34,74,108,18,4,16,25,90,106
Landry Fields,SG,22,NYK,82,81,2541,299,602,0.49700000000000005,86,219,0.39299999999999996,213,383,0.556,0.568,113,147,0.769,105,416,521,155,80,17,107,114,797
Derek Fisher,PG,36,LAL,82,82,2297,206,529,0.389,63,159,0.396,143,370,0.386,0.449,83,103,0.8059999999999999,14,138,152,224,99,8,70,192,558
Jonny Flynn,PG,21,MIN,53,8,983,108,296,0.365,31,100,0.31,77,196,0.39299999999999996,0.41700000000000004,32,42,0.762,12,65,77,182,34,3,113,58,279
Gary Forbes,SF,25,DEN,63,11,791,124,273,0.45399999999999996,19,58,0.32799999999999996,105,215,0.488,0.489,59,87,0.6779999999999999,28,88,116,49,23,6,46,77,326
T.J. Ford,PG,27,IND,41,3,773,91,236,0.386,6,32,0.188,85,204,0.41700000000000004,0.39799999999999996,35,48,0.7290000000000001,17,64,81,141,35,8,63,69,223
Jeff Foster,C,34,IND,56,3,940,80,167,0.479,0,3,0.0,80,164,0.488,0.479,27,48,0.563,160,190,350,46,24,31,26,127,187
Randy Foye,SG,27,LAC,63,24,1551,206,531,0.38799999999999996,71,217,0.327,135,314,0.43,0.455,133,149,0.893,13,90,103,170,47,21,95,122,616
Channing Frye,PF,27,PHO,77,64,2541,358,829,0.43200000000000005,171,439,0.39,187,390,0.479,0.535,89,107,0.8320000000000001,65,448,513,96,46,79,73,272,976
Dan Gadzuric,C-PF,32,TOT,42,9,463,54,129,0.419,0,1,0.0,54,128,0.42200000000000004,0.419,10,27,0.37,71,64,135,14,13,29,29,91,118
Sundiata Gaines,PG,24,TOT,24,0,301,42,105,0.4,9,38,0.237,33,67,0.493,0.44299999999999995,18,36,0.5,13,25,38,42,16,1,27,25,111
Danilo Gallinari,PF-SF,22,TOT,62,60,2104,265,640,0.414,103,293,0.35200000000000004,162,347,0.467,0.495,337,391,0.862,59,246,305,104,51,27,83,144,970
Francisco García,SF,29,SAC,58,34,1386,207,475,0.436,81,224,0.36200000000000004,126,251,0.502,0.521,65,76,0.855,24,109,133,71,51,49,45,126,560
Kevin Garnett,PF,34,BOS,71,71,2220,434,822,0.528,1,5,0.2,433,817,0.53,0.529,187,217,0.862,83,548,631,171,95,57,115,148,1056
Marc Gasol,C,26,MEM,81,81,2586,364,691,0.527,3,7,0.429,361,684,0.528,0.529,220,294,0.748,154,415,569,200,74,136,146,265,951
Pau Gasol,C,30,LAL,82,82,3037,593,1120,0.529,1,3,0.33299999999999996,592,1117,0.53,0.53,354,430,0.823,268,568,836,273,48,130,142,203,1541
Rudy Gay,SF,24,MEM,54,54,2152,409,869,0.47100000000000003,57,144,0.396,352,725,0.486,0.503,194,241,0.805,82,254,336,153,91,58,135,131,1069
Alonzo Gee,SG,23,TOT,56,34,1118,121,264,0.45799999999999996,17,51,0.33299999999999996,104,213,0.488,0.491,72,92,0.7829999999999999,62,120,182,38,40,18,55,94,331
Paul George,SG,20,IND,61,19,1265,179,395,0.45299999999999996,41,138,0.297,138,257,0.537,0.505,77,101,0.762,37,187,224,65,62,26,70,127,476
Daniel Gibson,SG,24,CLE,67,15,1865,264,660,0.4,118,293,0.40299999999999997,146,367,0.39799999999999996,0.489,134,163,0.8220000000000001,24,153,177,201,48,21,80,154,780
Taj Gibson,PF,25,CHI,80,19,1742,234,502,0.466,1,8,0.125,233,494,0.47200000000000003,0.467,100,148,0.6759999999999999,162,296,458,58,39,106,71,203,569
Manu Ginóbili,SG,33,SAS,80,79,2426,441,1018,0.433,154,441,0.349,287,577,0.49700000000000005,0.509,357,410,0.871,42,253,295,393,123,28,174,163,1393
Ryan Gomes,SF,28,LAC,76,62,2095,207,505,0.41,72,211,0.341,135,294,0.45899999999999996,0.48100000000000004,61,85,0.718,61,193,254,118,62,12,55,159,547
Drew Gooden,PF,29,MIL,35,18,860,156,362,0.431,3,20,0.15,153,342,0.447,0.435,81,102,0.794,73,165,238,47,21,18,46,98,396
Ben Gordon,SG,27,DET,82,27,2131,339,770,0.44,107,266,0.402,232,504,0.46,0.51,136,160,0.85,41,154,195,171,48,16,141,178,921
Eric Gordon,SG,22,LAC,56,56,2112,427,949,0.45,106,291,0.364,321,658,0.488,0.506,287,348,0.825,45,119,164,244,71,18,151,115,1247
Marcin Gortat,C,26,TOT,80,14,2032,338,603,0.561,1,4,0.25,337,599,0.563,0.561,140,193,0.725,148,483,631,70,36,91,81,188,817
Joey Graham,SF,28,CLE,39,8,586,82,179,0.45799999999999996,9,30,0.3,73,149,0.49,0.483,29,36,0.8059999999999999,8,76,84,18,6,7,28,73,202
Stephen Graham,SG,28,NJN,59,28,959,81,200,0.405,5,21,0.23800000000000002,76,179,0.425,0.418,31,38,0.816,17,106,123,40,14,1,38,106,198
Danny Granger,SF,27,IND,79,79,2763,535,1260,0.425,157,407,0.386,378,853,0.44299999999999995,0.48700000000000004,395,466,0.848,87,338,425,203,89,62,206,213,1622
Aaron Gray,C,26,NOH,41,6,531,56,99,0.5660000000000001,0,0,0.0,56,99,0.5660000000000001,0.5660000000000001,17,34,0.5,59,112,171,16,11,12,32,96,129
Danny Green,SG,23,SAS,8,0,92,17,35,0.486,7,19,0.368,10,16,0.625,0.586,0,0,0.0,3,12,15,2,2,1,5,7,41
Jeff Green,PF-SF,24,TOT,75,51,2427,368,820,0.449,64,211,0.303,304,609,0.499,0.488,198,244,0.8109999999999999,73,287,360,108,53,37,99,210,998
Willie Green,SG,29,NOH,77,13,1674,270,609,0.44299999999999995,54,155,0.348,216,454,0.47600000000000003,0.488,78,100,0.78,22,139,161,74,36,13,67,143,672
Donté Greene,SF,22,SAC,69,21,1127,156,386,0.40399999999999997,45,154,0.292,111,232,0.478,0.462,43,65,0.662,49,98,147,48,36,20,60,88,400
Orien Greene,SG,28,NJN,3,0,5,1,2,0.5,0,0,0.0,1,2,0.5,0.5,1,2,0.5,0,0,0,1,1,0,0,0,3
Blake Griffin,PF,21,LAC,82,82,3112,696,1376,0.506,7,24,0.292,689,1352,0.51,0.508,446,695,0.642,270,719,989,312,63,45,223,252,1845
Hamed Haddadi,C,25,MEM,31,0,168,30,58,0.517,0,1,0.0,30,57,0.526,0.517,15,23,0.652,24,44,68,5,2,13,11,29,75
Richard Hamilton,SG,32,DET,55,39,1498,288,671,0.429,55,144,0.382,233,527,0.442,0.47,146,172,0.8490000000000001,24,102,126,171,39,4,88,95,777
Tyler Hansbrough,PF,25,IND,70,29,1535,285,613,0.465,0,2,0.0,285,611,0.466,0.465,197,253,0.779,145,221,366,41,37,15,76,160,767
Luke Harangody,PF,23,TOT,49,0,640,79,206,0.38299999999999995,16,66,0.242,63,140,0.45,0.42200000000000004,19,26,0.731,40,103,143,30,15,17,16,80,193
James Harden,SG,21,OKC,82,5,2189,298,684,0.436,113,324,0.349,185,360,0.514,0.518,289,343,0.843,42,213,255,176,92,24,106,207,998
Al Harrington,PF,30,DEN,73,3,1665,281,675,0.41600000000000004,117,328,0.35700000000000004,164,347,0.473,0.503,86,117,0.735,76,256,332,101,39,10,106,202,765
Devin Harris,PG,27,TOT,71,70,2254,343,813,0.42200000000000004,58,180,0.322,285,633,0.45,0.45799999999999996,335,402,0.833,17,152,169,503,70,7,207,163,1079
Manny Harris,SG,21,CLE,54,15,933,108,289,0.374,34,92,0.37,74,197,0.376,0.433,71,93,0.763,36,104,140,85,31,7,63,65,321
Mike Harris,PF,27,HOU,4,0,16,3,6,0.5,0,0,0.0,3,6,0.5,0.5,2,4,0.5,2,3,5,1,0,1,1,2,8
Udonis Haslem,PF,30,MIA,13,0,345,44,86,0.512,0,0,0.0,44,86,0.512,0.512,16,20,0.8,29,77,106,6,7,3,14,39,104
Spencer Hawes,C,22,PHI,81,81,1718,264,568,0.465,9,37,0.243,255,531,0.48,0.473,47,88,0.534,129,336,465,121,29,71,97,201,584
Chuck Hayes,C,27,HOU,74,63,2079,244,463,0.527,0,2,0.0,244,461,0.529,0.527,94,142,0.662,219,380,599,202,79,49,86,200,582
Gordon Hayward,SF,20,UTA,72,17,1218,142,293,0.485,35,74,0.473,107,219,0.489,0.544,69,97,0.711,41,98,139,81,30,19,70,106,388
Lazar Hayward,SF,24,MIN,42,0,419,55,154,0.35700000000000004,17,60,0.28300000000000003,38,94,0.40399999999999997,0.41200000000000003,33,42,0.7859999999999999,23,47,70,28,12,7,19,44,160
Brendan Haywood,C,31,DAL,72,8,1331,128,223,0.574,0,1,0.0,128,222,0.5770000000000001,0.574,64,177,0.36200000000000004,129,247,376,19,16,74,51,146,320
Luther Head,PG,28,SAC,36,14,586,68,164,0.415,25,64,0.391,43,100,0.43,0.491,39,50,0.78,16,44,60,70,10,9,32,43,200
Gerald Henderson,SG,23,CHA,68,30,1661,259,570,0.45399999999999996,7,36,0.19399999999999998,252,534,0.47200000000000003,0.461,128,163,0.785,49,158,207,101,50,32,64,118,653
Xavier Henry,SG,19,MEM,38,16,527,65,160,0.406,2,17,0.11800000000000001,63,143,0.441,0.413,33,52,0.635,9,28,37,18,11,3,13,48,165
Roy Hibbert,C,24,IND,81,80,2244,410,890,0.461,0,4,0.0,410,886,0.46299999999999997,0.461,205,275,0.745,182,428,610,166,33,142,185,256,1025
J.J. Hickson,C,22,CLE,80,66,2256,429,936,0.45799999999999996,0,5,0.0,429,931,0.461,0.45799999999999996,247,367,0.6729999999999999,217,478,695,91,48,54,173,215,1105
Nenê Hilário,C,28,DEN,75,75,2291,402,654,0.615,1,5,0.2,401,649,0.618,0.615,286,402,0.711,145,426,571,149,84,73,134,238,1091
George Hill,PG,24,SAS,76,5,2148,287,633,0.45299999999999996,77,204,0.377,210,429,0.49,0.514,233,270,0.863,24,175,199,193,66,21,99,153,884
Grant Hill*,SF,38,PHO,80,80,2409,399,825,0.484,45,114,0.395,354,711,0.498,0.511,213,257,0.8290000000000001,77,261,338,200,64,35,134,184,1056
Jordan Hill,C,23,HOU,72,11,1125,173,352,0.491,0,2,0.0,173,350,0.494,0.491,60,85,0.706,128,178,306,29,14,52,62,157,406
Kirk Hinrich,SG-PG,30,TOT,72,51,2157,278,623,0.446,75,188,0.39899999999999997,203,435,0.467,0.506,106,126,0.841,21,161,182,288,75,17,121,185,737
Jrue Holiday,PG,20,PHI,82,82,2901,446,999,0.446,81,222,0.365,365,777,0.47,0.48700000000000004,172,209,0.823,68,264,332,531,120,29,218,203,1145
Ryan Hollins,C,26,CLE,70,16,1182,131,219,0.598,0,0,0.0,131,219,0.598,0.598,111,163,0.6809999999999999,70,116,186,26,22,42,67,199,373
Al Horford,C,24,ATL,77,77,2704,513,921,0.557,2,4,0.5,511,917,0.557,0.5579999999999999,150,188,0.7979999999999999,182,536,718,266,59,80,119,193,1178
Eddie House,SG,32,MIA,56,1,978,128,321,0.39899999999999997,68,175,0.389,60,146,0.41100000000000003,0.505,38,40,0.95,9,83,92,62,32,3,29,68,362
Dwight Howard,C,25,ORL,78,78,2935,619,1044,0.593,0,7,0.0,619,1037,0.597,0.593,546,916,0.596,309,789,1098,107,107,186,279,258,1784
Josh Howard,SF,30,WAS,18,10,409,58,162,0.358,7,29,0.24100000000000002,51,133,0.38299999999999995,0.38,29,47,0.617,18,56,74,24,13,5,20,34,152
Juwan Howard,PF,37,MIA,57,0,592,55,125,0.44,0,0,0.0,55,125,0.44,0.44,29,35,0.8290000000000001,36,86,122,23,10,4,25,61,139
Lester Hudson,PG,26,WAS,11,0,73,6,24,0.25,4,15,0.267,2,9,0.222,0.33299999999999996,2,4,0.5,1,4,5,17,4,1,7,10,18
Kris Humphries,PF,25,NJN,74,44,2061,307,583,0.527,0,1,0.0,307,582,0.527,0.527,127,191,0.665,225,546,771,84,33,80,103,168,741
Serge Ibaka,PF,21,OKC,82,44,2216,335,617,0.5429999999999999,0,1,0.0,335,616,0.544,0.5429999999999999,138,184,0.75,214,408,622,22,31,198,71,267,808
Andre Iguodala,SF,27,PHI,67,67,2469,338,759,0.445,61,181,0.337,277,578,0.479,0.486,208,300,0.693,61,326,387,422,101,38,138,109,945
Zydrunas Ilgauskas,C,35,MIA,72,51,1145,162,319,0.508,0,1,0.0,162,318,0.509,0.508,36,46,0.7829999999999999,108,179,287,26,23,58,52,185,360
Didier Ilunga-Mbenga,C,30,NOH,41,0,330,23,49,0.469,0,0,0.0,23,49,0.469,0.469,13,18,0.722,35,51,86,6,6,27,21,52,59
Ersan İlyasova,PF,23,MIL,60,34,1505,221,507,0.436,36,121,0.298,185,386,0.479,0.47100000000000003,93,104,0.894,105,260,365,56,51,24,63,159,571
Royal Ivey,SG,29,OKC,25,0,155,16,38,0.42100000000000004,7,16,0.43799999999999994,9,22,0.409,0.513,2,2,1.0,2,14,16,7,6,1,5,17,41
Jarrett Jack,SG-PG,27,TOT,83,15,1722,260,637,0.408,33,108,0.306,227,529,0.429,0.434,182,214,0.85,20,153,173,242,54,6,110,102,735
Darnell Jackson,PF,25,SAC,59,2,486,77,158,0.48700000000000004,3,11,0.273,74,147,0.503,0.49700000000000005,30,49,0.612,49,45,94,14,12,3,23,61,187
Stephen Jackson,SG,32,CHA,67,67,2405,435,1059,0.41100000000000003,121,359,0.337,314,700,0.449,0.46799999999999997,249,305,0.816,53,251,304,241,80,28,209,161,1240
Damion James,SF,23,NJN,25,9,403,46,103,0.447,0,3,0.0,46,100,0.46,0.447,18,28,0.643,17,68,85,20,16,12,25,36,110
LeBron James,SF,26,MIA,79,79,3063,758,1485,0.51,92,279,0.33,666,1206,0.552,0.541,503,663,0.759,80,510,590,554,124,50,284,163,2111
Antawn Jamison,PF,34,CLE,56,38,1842,374,876,0.42700000000000005,91,263,0.34600000000000003,283,613,0.462,0.479,171,234,0.731,86,289,375,93,50,30,77,137,1010
Othyus Jeffers,SG,25,TOT,17,1,322,31,65,0.47700000000000004,1,4,0.25,30,61,0.49200000000000005,0.485,30,46,0.652,25,42,67,20,17,0,14,32,93
Al Jefferson,C,26,UTA,82,82,2940,654,1319,0.496,0,0,0.0,654,1319,0.496,0.496,220,289,0.7609999999999999,235,559,794,149,46,153,105,238,1528
Richard Jefferson,SF,30,SAS,81,81,2459,304,642,0.474,135,307,0.44,169,335,0.504,0.579,148,195,0.759,54,256,310,107,38,34,93,164,891
Jared Jeffries,PF,29,TOT,42,9,601,30,86,0.349,2,9,0.222,28,77,0.364,0.36,12,29,0.414,62,54,116,36,31,17,21,75,74
Brandon Jennings,PG,21,MIL,63,61,2169,361,926,0.39,98,303,0.32299999999999995,263,623,0.42200000000000004,0.44299999999999995,199,246,0.809,42,192,234,305,95,21,146,131,1019
Eugene Jeter,PG,27,SAC,62,1,858,106,259,0.409,6,30,0.2,100,229,0.43700000000000006,0.42100000000000004,37,41,0.902,9,61,70,162,29,2,51,54,255
Yi Jianlian,PF,23,WAS,63,11,1112,145,347,0.418,3,13,0.231,142,334,0.425,0.42200000000000004,62,91,0.6809999999999999,79,169,248,25,27,32,51,115,355
Amir Johnson,PF,23,TOR,72,54,1853,281,495,0.568,0,1,0.0,281,494,0.569,0.568,126,160,0.7879999999999999,189,272,461,81,53,88,69,263,688
Armon Johnson,PG,21,POR,38,0,277,46,101,0.455,5,12,0.41700000000000004,41,89,0.461,0.48,13,22,0.591,11,25,36,45,5,1,38,31,110
Chris Johnson,C,25,TOT,14,1,138,9,21,0.429,0,0,0.0,9,21,0.429,0.429,15,20,0.75,12,20,32,3,3,9,10,21,33
James Johnson,SF,23,TOT,38,25,822,108,237,0.456,8,34,0.235,100,203,0.493,0.473,47,71,0.662,37,105,142,89,33,37,64,95,271
Joe Johnson,SG,29,ATL,72,72,2554,514,1161,0.44299999999999995,89,300,0.297,425,861,0.494,0.48100000000000004,195,243,0.802,59,232,291,338,47,7,146,131,1312
Trey Johnson,SG,26,TOT,8,0,94,12,33,0.364,1,3,0.33299999999999996,11,30,0.36700000000000005,0.379,9,10,0.9,2,5,7,11,1,1,5,12,34
Wesley Johnson,SG,23,MIN,79,63,2069,271,682,0.397,103,289,0.35600000000000004,168,393,0.42700000000000005,0.473,64,92,0.696,51,189,240,148,58,54,95,163,709
Dahntay Jones,SG,30,IND,45,2,589,100,214,0.467,14,39,0.359,86,175,0.491,0.5,69,90,0.767,4,61,65,33,20,7,31,70,283
Dominique Jones,SG,22,DAL,18,0,135,14,45,0.311,0,4,0.0,14,41,0.341,0.311,14,17,0.8240000000000001,6,19,25,19,5,3,10,7,42
James Jones,SF,30,MIA,81,8,1549,146,346,0.42200000000000004,123,287,0.429,23,59,0.39,0.6,60,72,0.833,23,137,160,43,29,19,21,129,475
Solomon Jones,C,26,IND,39,0,528,49,121,0.405,0,1,0.0,49,120,0.408,0.405,41,62,0.6609999999999999,45,68,113,30,12,22,35,94,139
DeAndre Jordan,C,22,LAC,80,66,2047,234,341,0.6859999999999999,0,1,0.0,234,340,0.688,0.6859999999999999,98,217,0.452,207,368,575,42,41,142,101,255,566
Chris Kaman,C,28,LAC,32,15,838,177,376,0.47100000000000003,0,0,0.0,177,376,0.47100000000000003,0.47100000000000003,43,57,0.754,51,174,225,46,16,48,58,75,397
Jason Kapono,SF,29,PHI,24,2,112,7,28,0.25,1,8,0.125,6,20,0.3,0.268,1,2,0.5,3,8,11,4,2,1,2,4,16
Jason Kidd*,PG,37,DAL,80,80,2653,215,596,0.361,133,391,0.34,82,205,0.4,0.47200000000000003,67,77,0.87,35,316,351,655,134,29,179,119,630
Andrei Kirilenko,SF,29,UTA,64,62,1999,253,542,0.467,36,98,0.36700000000000005,217,444,0.489,0.5,208,270,0.77,100,227,327,192,81,74,117,113,750
Linas Kleiza,SF,26,TOR,39,23,1032,178,406,0.43799999999999994,39,131,0.298,139,275,0.505,0.486,41,65,0.631,37,140,177,40,19,7,65,99,436
Kyle Korver,SG,29,CHI,82,0,1649,242,557,0.434,120,289,0.415,122,268,0.455,0.542,77,87,0.885,12,138,150,124,35,20,60,156,681
Kosta Koufos,C,21,TOT,50,2,434,68,150,0.45299999999999996,0,2,0.0,68,148,0.45899999999999996,0.45299999999999996,24,43,0.5579999999999999,57,73,130,7,10,25,31,59,160
Nenad Krstić,C,27,TOT,71,67,1571,231,452,0.511,0,0,0.0,231,452,0.511,0.511,113,146,0.774,124,211,335,27,26,25,56,184,575
Carl Landry,PF,27,TOT,76,26,2008,345,687,0.502,0,4,0.0,345,683,0.505,0.502,213,288,0.74,165,182,347,63,40,32,109,196,903
Acie Law,PG,26,TOT,51,0,726,81,186,0.435,6,36,0.16699999999999998,75,150,0.5,0.452,47,64,0.7340000000000001,12,51,63,84,32,0,43,61,215
Gani Lawal,PF,22,PHO,1,0,2,0,0,0.0,0,0,0.0,0,0,0.0,0.0,0,0,0.0,0,0,0,0,0,0,0,1,0
Ty Lawson,PG,23,DEN,80,31,2103,346,688,0.503,69,171,0.40399999999999997,277,517,0.536,0.5529999999999999,172,225,0.764,67,142,209,377,80,4,137,133,933
Courtney Lee,SG,25,HOU,81,1,1723,253,576,0.439,71,174,0.408,182,402,0.45299999999999996,0.501,95,120,0.792,51,158,209,100,58,18,68,102,672
David Lee,PF,27,GSW,73,73,2634,496,978,0.507,1,3,0.33299999999999996,495,975,0.508,0.508,210,267,0.787,217,497,714,233,74,31,170,211,1203
Rashard Lewis,SF-PF,31,TOT,57,52,1824,252,582,0.433,87,244,0.35700000000000004,165,338,0.488,0.508,77,96,0.802,71,219,290,92,52,30,87,159,668
Jeremy Lin,PG,22,GSW,29,0,285,28,72,0.389,1,5,0.2,27,67,0.40299999999999997,0.396,19,25,0.76,12,22,34,42,33,9,18,31,76
Shaun Livingston,PG,25,CHA,73,0,1261,185,397,0.466,1,4,0.25,184,393,0.46799999999999997,0.467,108,125,0.8640000000000001,29,120,149,164,47,29,88,109,479
Brook Lopez,C,22,NJN,82,82,2889,644,1309,0.49200000000000005,0,1,0.0,644,1308,0.49200000000000005,0.49200000000000005,385,489,0.787,197,291,488,129,47,120,176,240,1673
Robin Lopez,C,22,PHO,67,56,991,179,357,0.501,0,0,0.0,179,357,0.501,0.501,74,100,0.74,82,134,216,8,18,45,48,143,432
Kevin Love,PF,22,MIN,73,73,2611,482,1026,0.47,88,211,0.41700000000000004,394,815,0.483,0.513,424,499,0.85,330,782,1112,184,45,28,155,148,1476
Kyle Lowry,PG,24,HOU,75,71,2563,345,809,0.426,129,343,0.376,216,466,0.46399999999999997,0.506,192,251,0.765,89,220,309,500,102,23,158,207,1011
John Lucas III,PG,28,CHI,2,0,10,1,3,0.33299999999999996,0,1,0.0,1,2,0.5,0.33299999999999996,0,2,0.0,0,0,0,1,0,0,0,0,2
Corey Maggette,SF,31,MIL,67,18,1401,253,559,0.45299999999999996,28,78,0.359,225,481,0.46799999999999997,0.478,271,325,0.8340000000000001,44,197,241,84,21,5,127,175,805
Jamaal Magloire,C,32,MIA,18,0,158,13,22,0.591,0,0,0.0,13,22,0.591,0.591,9,18,0.5,17,44,61,3,4,2,5,26,35
Ian Mahinmi,C,24,DAL,56,0,488,55,98,0.561,0,2,0.0,55,96,0.573,0.561,63,82,0.768,43,77,120,8,14,15,25,105,173
Shawn Marion,SF,32,DAL,80,27,2253,434,834,0.52,5,33,0.152,429,801,0.536,0.523,126,164,0.768,168,383,551,110,68,50,130,144,999
Sean Marks,C,35,POR,29,0,208,19,44,0.43200000000000005,2,2,1.0,17,42,0.405,0.455,5,8,0.625,16,24,40,4,3,5,11,44,45
Cartier Martin,SF,26,WAS,52,1,542,71,182,0.39,39,99,0.39399999999999996,32,83,0.386,0.49700000000000005,28,40,0.7,20,54,74,18,18,6,16,52,209
Kenyon Martin,PF,33,DEN,48,48,1233,185,362,0.511,2,9,0.222,183,353,0.518,0.514,42,72,0.583,67,230,297,109,43,35,59,136,414
Kevin Martin,SG,27,HOU,80,80,2603,553,1267,0.436,176,459,0.38299999999999995,377,808,0.467,0.506,594,669,0.888,28,230,258,198,80,15,184,155,1876
Roger Mason,SG,30,NYK,26,0,319,26,77,0.33799999999999997,16,44,0.364,10,33,0.303,0.442,7,10,0.7,5,38,43,20,6,2,6,25,75
Wesley Matthews,SG,24,POR,82,69,2758,440,979,0.449,154,378,0.40700000000000003,286,601,0.47600000000000003,0.528,266,315,0.8440000000000001,48,210,258,164,102,9,138,195,1300
Jason Maxiell,PF,27,DET,57,14,930,93,189,0.49200000000000005,0,0,0.0,93,189,0.49200000000000005,0.49200000000000005,51,99,0.515,66,107,173,17,24,21,44,92,237
Eric Maynor,PG,23,OKC,82,0,1200,134,333,0.402,37,96,0.385,97,237,0.409,0.45799999999999996,43,59,0.7290000000000001,25,96,121,238,35,6,77,96,348
O.J. Mayo,SG,23,MEM,71,17,1869,304,747,0.40700000000000003,96,264,0.364,208,483,0.431,0.47100000000000003,99,131,0.7559999999999999,35,135,170,145,73,26,99,127,803
Luc Mbah a Moute,PF,24,MIL,79,52,2093,198,428,0.46299999999999997,0,7,0.0,198,421,0.47,0.46299999999999997,133,188,0.7070000000000001,169,251,420,68,72,28,77,180,529
Antonio McDyess,PF,36,SAS,73,16,1387,169,344,0.491,0,1,0.0,169,343,0.493,0.491,52,77,0.675,122,273,395,84,36,39,72,163,390
JaVale McGee,C,23,WAS,79,75,2193,332,604,0.55,0,3,0.0,332,601,0.552,0.55,134,230,0.583,223,411,634,38,41,193,102,232,798
Tracy McGrady*,SG,31,DET,72,39,1686,227,514,0.442,30,88,0.341,197,426,0.462,0.47100000000000003,90,129,0.698,49,202,251,252,66,34,102,101,574
Dominic McGuire,SF,25,CHA,52,8,760,72,182,0.396,0,2,0.0,72,180,0.4,0.396,30,39,0.769,63,136,199,43,10,33,25,94,174
Josh McRoberts,PF,23,IND,72,51,1597,211,386,0.547,23,60,0.38299999999999995,188,326,0.5770000000000001,0.5760000000000001,88,119,0.7390000000000001,109,273,382,150,47,57,93,165,533
Jodie Meeks,SG,23,PHI,74,64,2062,242,570,0.425,138,348,0.397,104,222,0.46799999999999997,0.546,152,170,0.894,21,150,171,78,63,4,60,97,774
Pops Mensah-Bonsu,PF,27,NOH,7,0,35,1,3,0.33299999999999996,0,0,0.0,1,3,0.33299999999999996,0.33299999999999996,0,0,0.0,3,8,11,2,0,0,2,11,2
C.J. Miles,SF,23,UTA,78,19,1969,366,899,0.40700000000000003,109,339,0.322,257,560,0.45899999999999996,0.46799999999999997,159,196,0.8109999999999999,54,201,255,135,74,38,93,221,1000
Darko Miličić,C,25,MIN,69,69,1686,271,578,0.469,0,0,0.0,271,578,0.469,0.469,64,115,0.557,133,227,360,104,54,140,151,229,606
Andre Miller,PG,34,POR,81,81,2650,388,844,0.46,4,37,0.10800000000000001,384,807,0.47600000000000003,0.462,249,292,0.853,97,205,302,566,114,12,197,171,1029
Brad Miller,C,34,HOU,60,5,1015,132,296,0.446,40,107,0.374,92,189,0.48700000000000004,0.514,78,94,0.83,44,178,222,145,28,21,54,98,382
Mike Miller,SG,30,MIA,41,2,838,81,202,0.401,43,118,0.364,38,84,0.452,0.507,23,34,0.6759999999999999,38,146,184,51,20,2,41,88,228
Patty Mills,PG,22,POR,64,0,783,135,328,0.41200000000000003,47,133,0.353,88,195,0.451,0.483,36,47,0.7659999999999999,19,32,51,109,27,1,62,63,353
Paul Millsap,PF,25,UTA,76,76,2605,525,988,0.531,9,23,0.391,516,965,0.535,0.536,256,338,0.757,164,415,579,187,103,69,145,272,1315
Yao Ming*,C,30,HOU,5,5,91,18,37,0.486,0,0,0.0,18,37,0.486,0.486,15,16,0.938,7,20,27,4,0,8,7,13,51
Nazr Mohammed,C,33,TOT,75,37,1280,234,448,0.522,0,1,0.0,234,447,0.523,0.522,67,112,0.598,140,228,368,23,30,56,70,184,535
Greg Monroe,C,20,DET,80,48,2222,303,550,0.551,0,1,0.0,303,549,0.552,0.551,145,233,0.622,248,353,601,105,93,45,81,196,751
Jamario Moon,SF,30,TOT,59,20,1042,101,248,0.40700000000000003,38,123,0.309,63,125,0.504,0.484,15,17,0.882,23,142,165,52,28,33,22,65,255
Anthony Morrow,SG,25,NJN,58,47,1856,279,620,0.45,110,260,0.423,169,360,0.469,0.539,96,107,0.897,37,135,172,68,19,7,54,135,764
Timofey Mozgov,C,24,TOT,45,14,524,63,133,0.474,0,0,0.0,63,133,0.474,0.474,37,52,0.7120000000000001,46,75,121,15,15,25,35,84,163
Byron Mullens,PF,21,OKC,13,0,85,9,28,0.321,0,0,0.0,9,28,0.321,0.321,7,14,0.5,6,18,24,0,2,3,8,11,25
Troy Murphy,PF,30,TOT,35,4,466,42,114,0.368,5,33,0.152,37,81,0.457,0.39,20,30,0.667,22,91,113,23,15,3,20,47,109
Hamady N'Diaye,C,24,WAS,16,0,80,4,5,0.8,0,0,0.0,4,5,0.8,0.8,6,12,0.5,2,5,7,0,2,5,3,18,14
Eduardo Nájera,PF,34,CHA,31,0,372,26,72,0.361,11,34,0.324,15,38,0.395,0.43799999999999994,6,11,0.545,14,30,44,20,11,6,13,52,69
Steve Nash*,PG,36,PHO,75,75,2497,399,811,0.49200000000000005,81,205,0.395,318,606,0.525,0.542,227,249,0.912,40,220,260,855,48,4,265,87,1106
Gary Neal,SG,26,SAS,80,1,1685,285,632,0.451,129,308,0.419,156,324,0.48100000000000004,0.5529999999999999,84,104,0.8079999999999999,21,175,196,96,27,4,78,148,783
Jameer Nelson,PG,28,ORL,76,76,2319,374,838,0.446,119,297,0.401,255,541,0.47100000000000003,0.517,130,162,0.802,37,189,226,456,75,3,194,209,997
Joakim Noah,C,25,CHI,48,48,1576,211,402,0.525,0,1,0.0,211,401,0.526,0.525,139,188,0.7390000000000001,182,316,498,107,48,72,90,156,561
Andrés Nocioni,SF,31,PHI,54,17,931,118,277,0.426,42,118,0.35600000000000004,76,159,0.478,0.502,49,61,0.8029999999999999,19,150,169,45,14,15,47,100,327
Steve Novak,SF,27,TOT,30,0,215,35,67,0.522,26,46,0.565,9,21,0.429,0.716,8,8,1.0,4,24,28,3,1,5,4,14,104
Dirk Nowitzki,PF,32,DAL,73,73,2504,610,1179,0.517,66,168,0.39299999999999996,544,1011,0.5379999999999999,0.545,395,443,0.892,50,463,513,190,38,47,137,172,1681
Jermaine O'Neal,C,32,BOS,24,10,431,50,109,0.45899999999999996,0,1,0.0,50,108,0.46299999999999997,0.45899999999999996,29,43,0.674,25,63,88,12,2,30,27,65,129
Shaquille O'Neal*,C,38,BOS,37,36,752,134,201,0.667,0,0,0.0,134,201,0.667,0.667,73,131,0.557,48,130,178,26,16,42,56,120,341
Fabricio Oberto,C,35,POR,5,0,45,3,5,0.6,0,0,0.0,3,5,0.6,0.6,1,2,0.5,3,4,7,0,0,0,3,10,7
Lamar Odom,PF,31,LAL,82,35,2639,473,893,0.53,68,178,0.382,405,715,0.5660000000000001,0.568,166,246,0.675,175,535,710,249,47,61,139,200,1180
Emeka Okafor,C,28,NOH,72,72,2287,300,524,0.573,0,1,0.0,300,523,0.574,0.573,145,258,0.562,230,454,684,42,40,127,119,230,745
Mehmet Okur,C,31,UTA,13,0,168,22,62,0.355,5,16,0.313,17,46,0.37,0.395,15,20,0.75,9,21,30,19,4,4,7,18,64
Travis Outlaw,SF,26,NJN,82,55,2358,274,731,0.375,76,252,0.302,198,479,0.413,0.42700000000000005,132,171,0.772,54,271,325,84,34,36,71,148,756
Larry Owens,SF,28,TOT,12,0,143,15,32,0.469,6,13,0.462,9,19,0.474,0.563,4,9,0.444,1,14,15,8,9,5,5,18,40
Zaza Pachulia,C,26,ATL,79,7,1244,107,232,0.461,0,0,0.0,107,232,0.461,0.461,135,179,0.754,119,214,333,58,34,22,69,184,349
Anthony Parker,SF,35,CLE,72,65,2091,220,552,0.39899999999999997,86,227,0.379,134,325,0.41200000000000003,0.47600000000000003,74,95,0.779,33,185,218,218,67,10,80,109,600
Tony Parker,PG,28,SAS,78,78,2528,555,1069,0.519,25,70,0.35700000000000004,530,999,0.531,0.531,233,303,0.769,30,208,238,513,90,3,200,135,1368
Patrick Patterson,PF,21,HOU,52,6,868,149,267,0.5579999999999999,0,2,0.0,149,265,0.562,0.5579999999999999,30,42,0.7140000000000001,86,114,200,41,17,37,31,77,328
Chris Paul,PG,25,NOH,80,80,2880,430,928,0.46299999999999997,71,183,0.38799999999999996,359,745,0.48200000000000004,0.502,337,384,0.878,38,289,327,782,188,5,177,196,1268
Sasha Pavlović,SG-SF,27,TOT,31,7,362,29,72,0.40299999999999997,12,31,0.387,17,41,0.415,0.486,6,10,0.6,1,31,32,16,10,7,12,34,76
Nikola Peković,C,25,MIN,65,11,887,136,263,0.517,0,0,0.0,136,263,0.517,0.517,87,114,0.763,90,103,193,27,18,35,91,181,359
Kendrick Perkins,C,26,TOT,29,24,742,67,130,0.515,0,0,0.0,67,130,0.515,0.515,40,72,0.556,62,170,232,26,9,26,56,91,174
Morris Peterson,SG,33,OKC,4,0,23,2,5,0.4,0,1,0.0,2,4,0.5,0.4,0,0,0.0,0,3,3,1,0,0,0,5,4
Johan Petro,C,25,NJN,77,1,893,129,290,0.445,0,4,0.0,129,286,0.451,0.445,15,28,0.536,62,150,212,44,34,34,46,178,273
Paul Pierce,SF,33,BOS,80,80,2774,507,1021,0.49700000000000005,111,297,0.374,396,724,0.547,0.551,386,449,0.86,34,396,430,260,80,51,171,231,1511
Mickaël Piétrus,SG-SF,28,TOT,57,4,1107,143,365,0.392,85,236,0.36,58,129,0.45,0.508,39,57,0.684,15,111,126,33,29,21,39,101,410
Dexter Pittman,C,22,MIA,2,0,11,1,3,0.33299999999999996,0,0,0.0,1,3,0.33299999999999996,0.33299999999999996,0,0,0.0,1,2,3,0,0,0,2,2,2
Quincy Pondexter,SF,22,NOH,66,6,734,73,180,0.406,18,50,0.36,55,130,0.423,0.456,24,34,0.706,23,65,88,28,17,10,16,63,188
James Posey,SF,34,IND,49,0,839,81,241,0.336,67,212,0.316,14,29,0.483,0.475,11,15,0.733,10,137,147,34,24,6,24,103,240
Leon Powe,C-PF,27,TOT,30,3,328,59,119,0.496,0,2,0.0,59,117,0.504,0.496,40,72,0.556,24,39,63,7,10,4,12,44,158
Josh Powell,PF,28,ATL,54,0,653,94,208,0.452,0,1,0.0,94,207,0.45399999999999996,0.452,36,45,0.8,49,86,135,22,5,5,53,78,224
A.J. Price,PG,24,IND,50,0,795,114,320,0.35600000000000004,41,149,0.275,73,171,0.42700000000000005,0.42,54,81,0.667,16,56,72,111,29,1,53,61,323
Ronnie Price,SG,27,UTA,59,0,717,74,210,0.35200000000000004,20,69,0.29,54,141,0.38299999999999995,0.4,29,39,0.7440000000000001,22,39,61,56,42,5,55,106,197
Tayshaun Prince,SF,30,DET,78,78,2562,473,1001,0.473,34,98,0.34700000000000003,439,903,0.486,0.49,118,168,0.7020000000000001,78,251,329,215,30,41,82,90,1098
Joel Przybilla,C,31,TOT,36,9,519,25,44,0.568,0,0,0.0,25,44,0.568,0.568,14,27,0.519,37,108,145,13,5,15,29,79,64
Chris Quinn,PG,27,SAS,41,0,292,33,91,0.363,11,37,0.297,22,54,0.40700000000000003,0.423,4,8,0.5,3,22,25,42,5,1,12,29,81
Vladimir Radmanović,PF,30,GSW,74,6,1169,137,318,0.431,70,173,0.405,67,145,0.462,0.541,30,34,0.882,64,148,212,79,44,44,57,157,374
Anthony Randolph,C-PF,21,TOT,40,3,590,123,264,0.466,1,4,0.25,122,260,0.469,0.46799999999999997,58,86,0.674,43,117,160,33,22,24,53,62,305
Zach Randolph,PF,29,MEM,75,74,2724,598,1188,0.503,8,43,0.18600000000000003,590,1145,0.515,0.507,300,396,0.758,326,588,914,163,63,25,151,175,1504
Theo Ratliff,C,37,LAL,10,0,71,1,6,0.16699999999999998,0,0,0.0,1,6,0.16699999999999998,0.16699999999999998,0,2,0.0,6,7,13,3,2,5,3,7,2
Andy Rautins,SG,24,NYK,5,0,24,3,7,0.429,1,4,0.25,2,3,0.667,0.5,1,2,0.5,0,1,1,3,1,0,7,0,8
Michael Redd,SG,31,MIL,10,0,134,18,45,0.4,4,17,0.235,14,28,0.5,0.444,4,4,1.0,0,8,8,12,2,1,4,4,44
J.J. Redick,SG,26,ORL,59,5,1513,197,447,0.441,87,219,0.397,110,228,0.48200000000000004,0.5379999999999999,112,128,0.875,6,107,113,102,29,3,53,80,593
Jason Richardson,SG,30,TOT,80,80,2715,472,1056,0.447,189,479,0.395,283,577,0.49,0.536,116,159,0.73,67,264,331,147,93,13,95,162,1249
Quentin Richardson,SF,30,ORL,57,19,955,87,255,0.341,42,146,0.28800000000000003,45,109,0.413,0.424,33,44,0.75,39,139,178,38,25,5,33,74,249
Luke Ridnour,PG,29,MIN,71,66,2159,319,681,0.46799999999999997,81,184,0.44,238,497,0.479,0.528,121,137,0.883,37,162,199,384,89,10,158,146,840
Nate Robinson,PG,26,TOT,59,11,1013,150,376,0.39899999999999997,65,200,0.325,85,176,0.483,0.485,36,44,0.818,15,75,90,111,29,4,68,115,401
Rajon Rondo,PG,24,BOS,68,68,2527,318,670,0.475,10,43,0.233,308,627,0.491,0.48200000000000004,75,132,0.568,87,210,297,760,153,11,234,120,721
Derrick Rose,PG,22,CHI,81,81,3026,711,1597,0.445,128,385,0.332,583,1212,0.48100000000000004,0.485,476,555,0.858,81,249,330,623,85,51,278,136,2026
Quinton Ross,SF,29,NJN,36,4,353,26,59,0.441,0,3,0.0,26,56,0.46399999999999997,0.441,5,14,0.35700000000000004,10,20,30,10,3,6,7,40,57
Brandon Roy,SG,26,POR,47,23,1310,209,523,0.4,38,114,0.33299999999999996,171,409,0.418,0.436,117,138,0.848,28,93,121,129,37,12,55,76,573
Brandon Rush,SG,25,IND,67,21,1754,217,515,0.42100000000000004,93,223,0.41700000000000004,124,292,0.425,0.512,80,106,0.755,33,184,217,62,41,35,69,107,607
John Salmons,SG,31,MIL,73,70,2554,373,898,0.415,83,219,0.379,290,679,0.42700000000000005,0.462,195,240,0.813,27,239,266,252,72,28,137,157,1024
Samardo Samuels,PF,22,CLE,37,10,701,110,241,0.456,0,3,0.0,110,238,0.462,0.456,68,110,0.618,75,83,158,17,15,18,53,88,288
Larry Sanders,C,22,MIL,60,12,872,116,268,0.433,0,0,0.0,116,268,0.433,0.433,28,50,0.56,59,119,178,16,22,72,38,117,260
Brian Scalabrine,PF,32,CHI,18,0,88,10,19,0.526,0,5,0.0,10,14,0.7140000000000001,0.526,0,0,0.0,1,7,8,6,3,4,5,18,20
Luis Scola,PF,30,HOU,74,74,2412,569,1129,0.504,0,3,0.0,569,1126,0.505,0.504,214,290,0.738,147,459,606,185,48,44,147,227,1352
Thabo Sefolosha,SG,26,OKC,79,79,2049,157,333,0.47100000000000003,28,102,0.275,129,231,0.5579999999999999,0.514,59,79,0.747,65,281,346,111,97,38,55,171,401
Kevin Séraphin,PF,21,WAS,58,1,635,66,147,0.449,0,0,0.0,66,147,0.449,0.449,22,31,0.71,80,72,152,10,17,28,42,126,154
Ramon Sessions,PG,24,CLE,81,38,2133,362,776,0.466,3,15,0.2,359,761,0.47200000000000003,0.46799999999999997,348,423,0.823,46,209,255,419,60,8,178,93,1075
Mustafa Shakur,PG,26,WAS,22,0,159,21,59,0.35600000000000004,1,10,0.1,20,49,0.408,0.364,8,15,0.5329999999999999,7,15,22,25,5,3,18,15,51
Garret Siler,C,24,PHO,21,0,101,17,31,0.5479999999999999,0,0,0.0,17,31,0.5479999999999999,0.5479999999999999,11,22,0.5,16,12,28,3,1,4,10,20,45
Bobby Simmons,SF,30,SAS,2,0,16,0,3,0.0,0,3,0.0,0,0,0.0,0.0,0,0,0.0,0,0,0,2,0,0,0,2,0
Brian Skinner,C,34,MIL,2,0,6,0,0,0.0,0,0,0.0,0,0,0.0,0.0,0,0,0.0,0,0,0,0,0,0,0,0,0
Craig Smith,PF,27,LAC,48,0,586,104,188,0.5529999999999999,0,5,0.0,104,183,0.568,0.5529999999999999,50,68,0.735,43,74,117,31,16,7,33,84,258
Ish Smith,PG,22,TOT,43,3,442,43,115,0.374,3,10,0.3,40,105,0.381,0.387,12,21,0.5710000000000001,7,40,47,79,18,2,34,37,101
J.R. Smith,SF,25,DEN,79,6,1968,341,784,0.435,124,318,0.39,217,466,0.466,0.514,163,221,0.738,45,277,322,175,92,16,100,173,969
Jason Smith,C,24,NOH,77,6,1102,136,307,0.44299999999999995,0,2,0.0,136,305,0.446,0.44299999999999995,59,70,0.843,89,152,241,36,26,32,53,150,331
Joe Smith,PF,35,TOT,16,3,69,3,16,0.188,0,0,0.0,3,16,0.188,0.188,2,2,1.0,3,18,21,4,0,4,5,13,8
Josh Smith,PF,25,ATL,77,77,2645,497,1041,0.47700000000000004,51,154,0.331,446,887,0.503,0.502,229,316,0.725,134,523,657,255,99,120,197,217,1274
Darius Songaila,C,32,PHI,10,0,71,7,15,0.467,0,0,0.0,7,15,0.467,0.467,2,4,0.5,2,8,10,2,0,0,4,16,16
Marreese Speights,C,23,PHI,64,1,734,144,291,0.495,1,4,0.25,143,287,0.498,0.49700000000000005,55,73,0.753,64,146,210,30,8,19,40,120,344
Tiago Splitter,C,26,SAS,60,6,738,101,191,0.529,0,1,0.0,101,190,0.532,0.529,76,140,0.5429999999999999,72,129,201,26,29,17,32,91,278
Jerry Stackhouse,SG,36,MIA,7,1,50,3,12,0.25,1,4,0.25,2,8,0.25,0.292,5,7,0.7140000000000001,1,6,7,3,0,2,2,3,12
Lance Stephenson,SG,20,IND,12,0,115,13,39,0.33299999999999996,0,5,0.0,13,34,0.382,0.33299999999999996,11,14,0.7859999999999999,1,17,18,21,4,0,16,14,37
DeShawn Stevenson,SG,29,DAL,72,54,1158,128,330,0.38799999999999996,94,249,0.37799999999999995,34,81,0.42,0.53,33,43,0.767,20,86,106,77,21,5,44,71,383
Peja Stojaković,SF,33,TOT,33,13,617,100,227,0.441,57,136,0.419,43,91,0.473,0.5660000000000001,23,25,0.92,14,61,75,29,13,2,17,24,280
Amar'e Stoudemire,C,28,NYK,78,78,2870,744,1482,0.502,10,23,0.435,734,1459,0.503,0.505,473,597,0.792,198,438,636,202,71,150,250,274,1971
Rodney Stuckey,PG,24,DET,70,54,2183,363,827,0.439,26,90,0.289,337,737,0.457,0.455,330,381,0.866,70,146,216,361,76,10,155,177,1082
DaJuan Summers,SF,23,DET,22,1,199,28,69,0.406,9,21,0.429,19,48,0.396,0.47100000000000003,9,20,0.45,2,10,12,2,3,1,13,21,74
Pape Sy,SF,22,ATL,3,0,21,2,6,0.33299999999999996,0,1,0.0,2,5,0.4,0.33299999999999996,3,3,1.0,2,1,3,2,1,0,3,1,7
Jermaine Taylor,SG,24,TOT,34,8,483,94,196,0.48,14,45,0.311,80,151,0.53,0.515,21,28,0.75,26,36,62,32,14,5,46,39,223
Jeff Teague,PG,22,ATL,70,7,963,133,304,0.43799999999999994,18,48,0.375,115,256,0.449,0.467,77,97,0.794,11,91,102,138,45,25,64,82,361
Sebastian Telfair,PG,25,MIN,37,8,711,97,241,0.402,28,78,0.359,69,163,0.423,0.461,44,60,0.733,17,37,54,111,25,3,64,64,266
Garrett Temple,PG-SG,24,TOT,24,0,230,20,68,0.294,10,37,0.27,10,31,0.32299999999999995,0.368,7,17,0.41200000000000003,1,22,23,32,11,6,23,24,57
Jason Terry,SG,33,DAL,82,10,2564,492,1091,0.451,127,351,0.36200000000000004,365,740,0.493,0.509,182,214,0.85,24,129,153,334,93,13,167,140,1293
Hasheem Thabeet,C,23,TOT,47,0,373,17,40,0.425,0,0,0.0,17,40,0.425,0.425,19,35,0.5429999999999999,24,51,75,4,9,16,17,76,53
Etan Thomas,C,32,ATL,13,0,82,10,21,0.47600000000000003,0,0,0.0,10,21,0.47600000000000003,0.47600000000000003,12,15,0.8,6,17,23,2,1,4,5,11,32
Kurt Thomas,PF,38,CHI,52,37,1178,95,186,0.511,1,1,1.0,94,185,0.508,0.513,20,32,0.625,75,226,301,60,32,42,42,164,211
Tyrus Thomas,C,24,CHA,41,2,861,156,331,0.47100000000000003,0,3,0.0,156,328,0.47600000000000003,0.47100000000000003,107,136,0.787,65,159,224,29,30,66,65,113,419
Jason Thompson,PF,24,SAC,75,39,1748,271,534,0.507,0,3,0.0,271,531,0.51,0.507,121,200,0.605,144,310,454,88,28,44,99,212,663
Al Thornton,SF-PF,27,TOT,71,23,1383,205,431,0.47600000000000003,4,26,0.154,201,405,0.496,0.48,110,142,0.775,56,157,213,62,35,12,64,143,524
Marcus Thornton,SG,23,TOT,73,23,1775,350,807,0.434,88,240,0.36700000000000005,262,567,0.462,0.488,145,184,0.7879999999999999,61,197,258,135,64,9,93,110,933
Anthony Tolliver,SF,25,MIN,65,4,1362,141,313,0.45,47,115,0.409,94,198,0.475,0.526,105,131,0.802,92,203,295,82,28,28,49,145,434
Ronny Turiaf,C,28,NYK,64,21,1141,103,163,0.632,0,0,0.0,103,163,0.632,0.632,61,98,0.622,64,143,207,92,35,73,41,160,267
Hedo Türkoğlu,SF-PF,31,TOT,81,72,2540,322,722,0.446,127,310,0.41,195,412,0.473,0.534,106,156,0.679,45,311,356,343,72,34,132,247,877
Evan Turner,SG,22,PHI,78,14,1797,225,529,0.425,14,44,0.318,211,485,0.435,0.439,101,125,0.8079999999999999,42,264,306,159,49,14,80,138,565
Ekpe Udoh,C,23,GSW,58,18,1030,97,222,0.43700000000000006,0,0,0.0,97,222,0.43700000000000006,0.43700000000000006,42,64,0.6559999999999999,80,101,181,40,22,86,48,144,236
Ime Udoka,SF,33,SAS,20,0,130,5,21,0.23800000000000002,0,8,0.0,5,13,0.385,0.23800000000000002,4,8,0.5,5,14,19,13,8,1,5,14,14
Beno Udrih,PG,28,SAC,79,64,2734,412,824,0.5,65,182,0.35700000000000004,347,642,0.54,0.539,197,228,0.8640000000000001,41,224,265,386,94,9,141,181,1086
Ben Uzoh,PG,22,NJN,42,0,438,61,144,0.424,3,8,0.375,58,136,0.426,0.434,33,56,0.589,30,31,61,69,13,8,25,29,158
Anderson Varejão,C,28,CLE,31,31,994,114,216,0.528,0,2,0.0,114,214,0.5329999999999999,0.528,54,81,0.667,98,203,301,45,27,38,40,87,282
Greivis Vásquez,SG,24,MEM,70,1,860,95,233,0.408,25,86,0.29100000000000004,70,147,0.47600000000000003,0.461,34,44,0.773,12,61,73,151,22,4,70,83,249
Charlie Villanueva,PF,26,DET,76,11,1666,313,708,0.442,125,323,0.387,188,385,0.488,0.53,89,116,0.767,50,245,295,48,42,42,66,175,840
Sasha Vujačić,SG,26,TOT,67,17,1648,239,595,0.402,97,262,0.37,142,333,0.426,0.483,81,96,0.8440000000000001,30,156,186,132,54,5,66,136,656
Dwyane Wade,SG,29,MIA,76,76,2823,692,1384,0.5,63,206,0.306,629,1178,0.534,0.523,494,652,0.758,123,362,485,346,111,87,237,197,1941
Von Wafer,SG,25,BOS,58,2,553,67,159,0.42100000000000004,18,67,0.26899999999999996,49,92,0.5329999999999999,0.478,32,38,0.8420000000000001,7,42,49,35,18,5,20,39,184
Henry Walker,SG,23,NYK,61,1,784,104,236,0.441,59,153,0.386,45,83,0.542,0.5660000000000001,31,44,0.705,16,106,122,34,21,6,37,81,298
John Wall,PG,20,WAS,69,64,2606,398,972,0.409,34,115,0.29600000000000004,364,857,0.425,0.42700000000000005,301,393,0.7659999999999999,35,282,317,574,121,35,261,175,1131
Ben Wallace,C,36,DET,54,49,1238,67,149,0.45,1,2,0.5,66,147,0.449,0.45299999999999996,19,57,0.33299999999999996,129,221,350,72,54,54,44,81,154
Gerald Wallace,SF-PF,28,TOT,71,63,2693,386,851,0.45399999999999996,62,186,0.33299999999999996,324,665,0.48700000000000004,0.49,279,374,0.746,111,458,569,173,105,63,152,183,1113
Luke Walton,SF,30,LAL,54,0,484,38,116,0.32799999999999996,8,34,0.235,30,82,0.366,0.36200000000000004,7,10,0.7,9,58,67,62,9,4,31,38,91
Willie Warren,PG,21,LAC,19,0,134,13,35,0.371,5,15,0.33299999999999996,8,20,0.4,0.44299999999999995,6,8,0.75,1,11,12,27,6,0,8,16,37
Hakim Warrick,PF,28,PHO,80,6,1416,228,446,0.511,1,11,0.091,227,435,0.522,0.512,212,294,0.721,88,208,296,69,32,9,79,100,669
C.J. Watson,PG,26,CHI,82,1,1091,146,394,0.371,44,112,0.39299999999999996,102,282,0.36200000000000004,0.426,69,93,0.742,16,78,94,186,55,11,73,82,405
Earl Watson,PG,31,UTA,80,13,1567,126,307,0.41,36,107,0.336,90,200,0.45,0.469,55,82,0.6709999999999999,52,130,182,278,61,17,116,146,343
Kyle Weaver,SG,24,UTA,5,0,69,9,25,0.36,3,7,0.429,6,18,0.33299999999999996,0.42,7,8,0.875,2,8,10,7,2,2,7,3,28
Martell Webster,SF,24,MIN,46,1,1094,152,340,0.447,55,132,0.41700000000000004,97,208,0.466,0.528,94,122,0.77,36,111,147,53,28,9,58,101,453
Sonny Weems,SF,24,TOR,59,28,1413,228,513,0.444,17,61,0.27899999999999997,211,452,0.467,0.461,72,94,0.7659999999999999,39,114,153,104,34,2,86,87,545
David West,PF,30,NOH,70,70,2451,528,1040,0.508,2,9,0.222,526,1031,0.51,0.509,264,327,0.807,155,374,529,164,67,62,142,202,1322
Delonte West,PG,27,BOS,24,2,453,55,120,0.45799999999999996,12,33,0.364,43,87,0.494,0.508,13,15,0.867,6,31,37,64,20,10,30,29,135
Mario West,SG,26,NJN,6,3,116,9,21,0.429,1,4,0.25,8,17,0.47100000000000003,0.452,3,5,0.6,2,9,11,10,7,0,2,13,22
Russell Westbrook,PG,22,OKC,82,82,2847,614,1390,0.442,34,103,0.33,580,1287,0.451,0.45399999999999996,531,631,0.8420000000000001,121,258,379,670,155,30,316,207,1793
D.J. White,C-PF,24,TOT,47,0,685,111,219,0.507,0,2,0.0,111,217,0.512,0.507,46,64,0.7190000000000001,43,115,158,19,12,20,14,77,268
Hassan Whiteside,C,21,SAC,1,0,2,0,0,0.0,0,0,0.0,0,0,0.0,0.0,0,0,0.0,0,0,0,0,0,0,0,2,0
Chris Wilcox,PF,28,DET,57,29,995,187,322,0.581,0,1,0.0,187,321,0.583,0.581,50,89,0.562,95,176,271,43,29,17,43,145,424
Damien Wilkins,SF,31,ATL,52,0,676,69,137,0.504,2,10,0.2,67,127,0.528,0.511,40,56,0.7140000000000001,23,67,90,41,27,9,21,72,180
Deron Williams,PG,26,TOT,65,65,2465,428,975,0.439,105,317,0.331,323,658,0.491,0.493,348,412,0.845,40,220,260,667,79,15,230,190,1309
Jason Williams,PG,35,TOT,27,0,295,22,67,0.32799999999999996,10,38,0.263,12,29,0.414,0.40299999999999997,0,0,0.0,3,27,30,52,11,1,18,8,54
Jawad Williams,SF,27,CLE,26,1,391,41,126,0.325,13,45,0.289,28,81,0.34600000000000003,0.377,9,12,0.75,7,41,48,22,9,3,16,34,104
Lou Williams,SG,24,PHI,75,0,1747,323,795,0.406,88,253,0.348,235,542,0.434,0.462,293,356,0.823,32,117,149,252,47,17,102,128,1027
Marvin Williams,SF,24,ATL,65,52,1865,246,537,0.45799999999999996,37,110,0.336,209,427,0.489,0.493,147,174,0.845,68,245,313,88,34,23,62,104,676
Mo Williams,PG,28,TOT,58,56,1788,291,730,0.39899999999999997,79,244,0.324,212,486,0.436,0.45299999999999996,151,177,0.853,21,132,153,380,53,10,171,150,812
Reggie Williams,SF,24,GSW,80,9,1626,268,572,0.469,102,241,0.423,166,331,0.502,0.5579999999999999,100,134,0.746,45,171,216,121,28,3,57,124,738
Shawne Williams,PF,24,NYK,64,11,1323,164,385,0.426,85,212,0.401,79,173,0.457,0.536,41,49,0.8370000000000001,60,179,239,47,39,51,46,164,454
Shelden Williams,PF,27,TOT,59,38,911,103,220,0.46799999999999997,0,0,0.0,103,220,0.46799999999999997,0.46799999999999997,58,75,0.773,93,180,273,32,23,26,43,126,264
Terrence Williams,SG,23,TOT,21,0,290,43,115,0.374,6,22,0.273,37,93,0.39799999999999996,0.4,14,21,0.667,4,47,51,38,9,0,33,25,106
Metta World Peace,SF,31,LAL,82,82,2410,261,658,0.397,83,233,0.35600000000000004,178,425,0.419,0.46,92,136,0.6759999999999999,100,167,267,175,124,36,90,181,697
Antoine Wright,SG,26,SAC,7,0,31,1,8,0.125,0,4,0.0,1,4,0.25,0.125,0,0,0.0,2,1,3,0,1,0,1,3,2
Brandan Wright,PF,23,TOT,37,2,379,60,117,0.513,0,0,0.0,60,117,0.513,0.513,21,31,0.677,31,58,89,12,11,17,14,34,141
Dorell Wright,SF,25,GSW,82,82,3147,485,1146,0.423,194,516,0.376,291,630,0.462,0.508,180,228,0.789,88,343,431,242,124,63,133,171,1344
Julian Wright,SF,23,TOR,52,6,766,82,160,0.513,2,10,0.2,80,150,0.5329999999999999,0.519,22,43,0.512,47,71,118,58,39,20,43,45,188
Nick Young,SG,25,WAS,64,40,2034,412,935,0.441,105,271,0.387,307,664,0.462,0.49700000000000005,186,228,0.816,26,148,174,75,45,17,90,144,1115
Sam Young,SF,25,MEM,78,46,1577,233,494,0.47200000000000003,17,50,0.34,216,444,0.486,0.489,89,116,0.767,40,147,187,71,68,23,61,120,572
Thaddeus Young,PF,22,PHI,82,1,2135,458,847,0.541,6,22,0.273,452,825,0.5479999999999999,0.544,123,174,0.7070000000000001,153,281,434,82,90,26,99,170,1045
