Player,Pos,Age,Tm,G,GS,MP,FG,FGA,FG%,3P,3PA,3P%,2P,2PA,2P%,eFG%,FT,FTA,FT%,ORB,DRB,TRB,AST,STL,BLK,TOV,PF,PTS
Shareef Abdur-Rahim,PF,31,SAC,6,0,51,3,14,0.214,0,0,0.0,3,14,0.214,0.214,4,4,1.0,6,4,10,4,1,0,1,9,10
Arron Afflalo,SG,22,DET,75,9,970,99,241,0.41100000000000003,10,48,0.20800000000000002,89,193,0.461,0.43200000000000005,68,87,0.782,36,101,137,52,31,8,34,83,276
Maurice Ager,SG,23,TOT,26,3,165,21,65,0.32299999999999995,3,19,0.158,18,46,0.391,0.34600000000000003,6,12,0.5,4,9,13,8,0,1,6,17,51
Blake Ahearn,PG,23,MIA,12,0,177,15,57,0.263,10,34,0.294,5,23,0.217,0.35100000000000003,30,31,0.968,1,18,19,19,6,0,16,20,70
LaMarcus Aldridge,PF,22,POR,76,76,2649,561,1160,0.484,1,7,0.14300000000000002,560,1153,0.486,0.484,227,298,0.762,220,358,578,122,55,94,126,240,1350
Malik Allen,PF,29,TOT,73,16,1096,157,327,0.48,1,2,0.5,156,325,0.48,0.48200000000000004,23,25,0.92,66,130,196,44,19,31,45,149,338
Ray Allen*,SG,32,BOS,73,73,2624,439,986,0.445,180,452,0.39799999999999996,259,534,0.485,0.537,215,237,0.907,75,193,268,225,65,16,127,147,1273
Tony Allen,SG,26,BOS,75,11,1373,169,389,0.434,18,57,0.316,151,332,0.455,0.45799999999999996,138,181,0.762,34,134,168,114,62,21,109,168,494
Lance Allred,C,26,CLE,3,0,10,1,4,0.25,0,0,0.0,1,4,0.25,0.25,1,2,0.5,0,1,1,0,0,0,0,1,3
Morris Almond,SG,22,UTA,9,0,39,4,15,0.267,1,4,0.25,3,11,0.273,0.3,4,6,0.667,0,2,2,3,1,0,2,5,13
Rafer Alston,PG,31,HOU,74,74,2526,364,924,0.39399999999999996,143,407,0.35100000000000003,221,517,0.42700000000000005,0.47100000000000003,98,137,0.715,28,232,260,392,98,18,160,139,969
Lou Amundson,PF,25,PHI,16,0,64,8,16,0.5,0,0,0.0,8,16,0.5,0.5,2,7,0.28600000000000003,7,5,12,0,1,1,2,13,18
Chris Andersen,C,29,NOH,5,0,34,2,7,0.28600000000000003,0,0,0.0,2,7,0.28600000000000003,0.28600000000000003,2,4,0.5,2,7,9,0,0,4,1,6,6
Derek Anderson,SG,33,CHA,28,0,396,47,125,0.376,19,52,0.365,28,73,0.384,0.452,28,38,0.737,9,43,52,44,12,1,25,49,141
Carmelo Anthony,SF,23,DEN,77,77,2806,728,1481,0.49200000000000005,58,164,0.354,670,1317,0.509,0.511,464,590,0.7859999999999999,178,393,571,259,98,39,253,253,1978
Joel Anthony,PF,25,MIA,24,1,498,28,60,0.467,0,0,0.0,28,60,0.467,0.467,29,49,0.5920000000000001,38,55,93,3,9,31,17,55,85
Gilbert Arenas,PG,26,WAS,13,8,425,78,196,0.39799999999999996,22,78,0.282,56,118,0.475,0.45399999999999996,74,96,0.7709999999999999,6,45,51,66,23,1,49,30,252
Trevor Ariza,SF,22,TOT,35,3,546,69,136,0.507,5,18,0.278,64,118,0.542,0.526,49,75,0.653,30,78,108,44,31,11,23,45,192
Darrell Armstrong,PG,39,NJN,50,2,549,40,110,0.364,23,69,0.33299999999999996,17,41,0.415,0.46799999999999997,20,30,0.667,17,50,67,73,28,2,41,53,123
Hilton Armstrong,C,23,NOH,65,3,732,67,148,0.45299999999999996,0,0,0.0,67,148,0.45299999999999996,0.45299999999999996,44,70,0.629,65,98,163,23,15,34,59,130,178
Carlos Arroyo,PG,28,ORL,62,20,1269,157,348,0.451,29,84,0.345,128,264,0.485,0.493,87,102,0.853,10,103,113,219,26,2,77,85,430
Chucky Atkins,SG,33,DEN,24,0,352,42,122,0.344,25,79,0.316,17,43,0.395,0.447,4,9,0.444,3,28,31,47,9,1,10,27,113
James Augustine,PF,23,ORL,25,0,149,18,34,0.529,0,0,0.0,18,34,0.529,0.529,4,8,0.5,16,14,30,2,5,2,6,18,40
Kelenna Azubuike,SG,24,GSW,81,17,1732,261,587,0.445,71,195,0.364,190,392,0.485,0.505,99,138,0.7170000000000001,107,217,324,75,45,34,58,159,692
Renaldo Balkman,SF,23,NYK,65,0,952,91,186,0.489,1,12,0.083,90,174,0.517,0.49200000000000005,41,95,0.43200000000000005,83,133,216,40,44,30,37,132,224
Marcus Banks,PG,26,TOT,36,3,569,86,191,0.45,40,102,0.392,46,89,0.517,0.555,27,35,0.7709999999999999,4,41,45,61,14,13,37,65,239
Leandro Barbosa,SG,25,PHO,82,12,2421,472,1021,0.462,164,422,0.389,308,599,0.514,0.5429999999999999,175,213,0.8220000000000001,40,191,231,216,75,18,117,195,1283
J.J. Barea,PG,23,DAL,44,9,460,71,170,0.418,21,54,0.389,50,116,0.431,0.479,28,35,0.8,4,43,47,58,14,1,35,48,191
Andrea Bargnani,PF,22,TOR,78,53,1861,280,725,0.386,90,261,0.345,190,464,0.409,0.44799999999999995,142,169,0.84,50,238,288,89,23,37,88,211,792
Matt Barnes,PF,27,GSW,73,18,1414,187,442,0.423,53,181,0.293,134,261,0.513,0.483,59,79,0.747,94,230,324,139,48,36,85,159,486
Andre Barrett,PG,25,LAC,4,0,25,2,5,0.4,1,3,0.33299999999999996,1,2,0.5,0.5,1,2,0.5,0,1,1,7,0,0,1,1,6
Earl Barron,C,26,MIA,46,15,889,132,327,0.40399999999999997,1,13,0.077,131,314,0.41700000000000004,0.405,61,87,0.701,67,131,198,29,19,8,48,114,326
Brent Barry,SF,36,SAS,31,1,554,77,160,0.48100000000000004,48,112,0.429,29,48,0.604,0.631,19,20,0.95,12,43,55,54,17,3,18,43,221
Brandon Bass,C,22,DAL,79,1,1557,246,493,0.499,0,4,0.0,246,489,0.503,0.499,162,197,0.8220000000000001,120,227,347,58,22,48,82,150,654
Maceo Baston,PF,32,TOR,15,2,103,17,25,0.68,0,0,0.0,17,25,0.68,0.68,7,10,0.7,9,17,26,3,2,4,4,20,41
Shane Battier,SF,29,HOU,80,78,2907,265,619,0.428,139,369,0.377,126,250,0.504,0.54,75,101,0.743,131,276,407,155,77,90,78,196,744
Marco Belinelli,SG,21,GSW,33,0,241,36,93,0.387,16,41,0.39,20,52,0.385,0.473,7,9,0.778,3,11,14,15,5,0,12,15,95
Charlie Bell,SG,28,MIL,68,5,1628,185,486,0.381,74,217,0.341,111,269,0.413,0.457,70,87,0.805,31,136,167,210,52,2,76,121,514
Raja Bell,SG,31,PHO,75,75,2646,317,753,0.42100000000000004,176,439,0.401,141,314,0.449,0.5379999999999999,79,91,0.868,47,227,274,168,54,27,65,220,889
Mike Bibby,PG,29,TOT,48,44,1573,248,603,0.41100000000000003,93,248,0.375,155,355,0.43700000000000006,0.488,78,100,0.78,16,144,160,290,54,4,119,97,667
Andris Biedriņš,C,21,GSW,76,59,2078,340,543,0.626,0,0,0.0,340,543,0.626,0.626,116,187,0.62,256,488,744,75,56,94,85,262,796
Chauncey Billups,PG,31,DET,78,78,2522,393,877,0.44799999999999995,137,342,0.401,256,535,0.479,0.526,401,437,0.9179999999999999,42,170,212,529,101,17,160,130,1324
Steve Blake,PG,27,POR,81,78,2424,261,640,0.408,121,298,0.406,140,342,0.409,0.502,49,64,0.7659999999999999,31,164,195,413,55,4,113,133,692
Andray Blatche,PF,21,WAS,82,15,1675,254,536,0.474,3,13,0.231,251,523,0.48,0.47700000000000004,107,154,0.695,164,261,425,92,53,114,112,258,618
Mark Blount,C,32,MIA,69,46,1542,238,515,0.462,17,44,0.386,221,471,0.469,0.479,88,138,0.638,69,194,263,41,33,34,70,133,581
Keith Bogans,SG,27,ORL,82,35,2198,241,588,0.41,148,409,0.36200000000000004,93,179,0.52,0.536,81,110,0.736,42,224,266,104,59,10,53,164,711
Andrew Bogut,C,23,MIL,78,78,2720,465,910,0.511,0,7,0.0,465,903,0.515,0.511,189,322,0.5870000000000001,245,518,763,199,64,135,172,254,1119
Matt Bonner,PF,27,SAS,68,3,853,121,291,0.41600000000000004,46,137,0.336,75,154,0.48700000000000004,0.495,38,44,0.8640000000000001,53,139,192,32,14,17,39,111,326
Josh Boone,PF,23,NJN,70,53,1773,238,434,0.5479999999999999,0,0,0.0,238,434,0.5479999999999999,0.5479999999999999,99,217,0.456,192,317,509,55,36,61,68,155,575
Calvin Booth,C,31,PHI,31,0,204,9,27,0.33299999999999996,0,0,0.0,9,27,0.33299999999999996,0.33299999999999996,6,10,0.6,6,32,38,8,6,18,4,35,24
Carlos Boozer,PF,26,UTA,81,81,2827,709,1297,0.547,0,1,0.0,709,1296,0.547,0.547,290,393,0.738,197,647,844,233,100,41,210,293,1708
Chris Bosh,C,23,TOR,67,67,2425,507,1027,0.494,10,25,0.4,497,1002,0.496,0.499,472,559,0.8440000000000001,174,409,583,171,63,67,153,157,1496
Bruce Bowen,SF,36,SAS,81,81,2448,174,428,0.40700000000000003,90,215,0.419,84,213,0.39399999999999996,0.512,45,69,0.652,33,201,234,91,54,22,46,177,483
Ryan Bowen,SF,32,NOH,53,4,660,49,100,0.49,0,1,0.0,49,99,0.495,0.49,16,29,0.552,55,45,100,25,32,11,15,77,114
Earl Boykins,PG,31,CHA,36,0,577,61,172,0.355,14,44,0.318,47,128,0.36700000000000005,0.395,49,59,0.831,9,25,34,96,13,0,41,21,185
Elton Brand,PF,28,LAC,8,6,274,52,114,0.456,0,0,0.0,52,114,0.456,0.456,37,47,0.787,21,43,64,16,3,15,17,21,141
Corey Brewer,SF,21,MIN,79,35,1803,182,486,0.374,7,36,0.19399999999999998,175,450,0.389,0.382,88,110,0.8,82,210,292,111,76,25,89,188,459
Ronnie Brewer,SG,22,UTA,76,76,2088,354,634,0.5579999999999999,11,50,0.22,343,584,0.5870000000000001,0.5670000000000001,195,257,0.759,97,121,218,134,129,19,69,110,914
Primož Brezec,C,28,TOT,50,18,475,44,94,0.46799999999999997,0,0,0.0,44,94,0.46799999999999997,0.46799999999999997,24,40,0.6,30,51,81,11,3,7,24,83,112
Aaron Brooks,PG,23,HOU,51,0,608,93,225,0.413,36,109,0.33,57,116,0.491,0.493,42,49,0.857,13,43,56,87,13,5,44,69,264
Andre Brown,PF,26,MEM,33,1,286,39,78,0.5,0,0,0.0,39,78,0.5,0.5,22,49,0.449,37,55,92,8,7,4,14,38,100
Devin Brown,SG,29,CLE,78,20,1762,217,531,0.409,45,146,0.308,172,385,0.447,0.451,107,142,0.754,65,198,263,175,52,7,99,144,586
Kwame Brown,C,25,TOT,38,15,713,72,142,0.507,0,0,0.0,72,142,0.507,0.507,40,98,0.408,51,137,188,45,22,23,51,82,184
P.J. Brown,PF,38,BOS,18,0,209,14,41,0.341,0,1,0.0,14,40,0.35,0.341,11,16,0.688,29,39,68,10,5,8,10,29,39
Shannon Brown,SG,22,TOT,21,4,240,44,126,0.349,9,30,0.3,35,96,0.365,0.385,17,29,0.586,6,14,20,17,11,3,24,29,114
Kobe Bryant,SG,29,LAL,82,82,3192,775,1690,0.45899999999999996,150,415,0.361,625,1275,0.49,0.503,623,742,0.84,94,423,517,441,151,40,257,227,2323
Greg Buckner,SG,31,MIN,31,4,520,45,117,0.385,15,50,0.3,30,67,0.44799999999999995,0.449,19,22,0.8640000000000001,10,55,65,39,21,2,29,63,124
Caron Butler,SF,27,WAS,58,58,2314,439,943,0.466,66,185,0.35700000000000004,373,758,0.49200000000000005,0.501,236,262,0.9009999999999999,93,295,388,284,128,20,150,160,1180
Rasual Butler,SF,28,NOH,51,8,875,91,260,0.35,44,133,0.331,47,127,0.37,0.435,26,31,0.8390000000000001,16,84,100,36,15,21,10,66,252
Andrew Bynum,C,20,LAL,35,25,1008,189,297,0.636,0,0,0.0,189,297,0.636,0.636,82,118,0.695,105,251,356,61,12,72,52,98,460
José Calderón,PG,26,TOR,82,56,2484,367,707,0.519,79,184,0.429,288,523,0.551,0.575,109,120,0.9079999999999999,34,202,236,678,87,6,126,134,922
Marcus Camby,C,33,DEN,79,79,2758,286,635,0.45,6,20,0.3,280,615,0.455,0.455,143,202,0.708,230,807,1037,259,85,285,118,216,721
Brian Cardinal,PF,30,MEM,37,1,440,43,126,0.341,25,81,0.309,18,45,0.4,0.44,13,19,0.684,26,70,96,22,10,2,23,62,124
Rodney Carney,SF,23,PHI,70,6,1039,158,392,0.40299999999999997,38,120,0.317,120,272,0.441,0.452,55,81,0.679,50,99,149,32,39,23,34,96,409
Matt Carroll,SG,27,CHA,80,18,2016,252,589,0.428,105,241,0.436,147,348,0.42200000000000004,0.517,111,138,0.804,33,193,226,73,46,19,58,187,720
Anthony Carter,PG,32,DEN,70,67,1960,218,476,0.45799999999999996,45,129,0.349,173,347,0.499,0.505,64,85,0.753,27,173,200,388,107,28,124,172,545
Vince Carter,SG,31,NJN,76,72,2959,587,1287,0.456,98,273,0.359,489,1014,0.48200000000000004,0.494,350,429,0.816,112,341,453,389,93,33,181,241,1622
Sam Cassell,PG,38,TOT,55,34,1274,233,532,0.43799999999999994,23,76,0.303,210,456,0.461,0.46,127,144,0.882,17,119,136,214,37,6,97,98,616
Tyson Chandler,C,25,NOH,79,79,2783,377,605,0.623,0,1,0.0,377,604,0.624,0.623,175,295,0.593,322,606,928,81,45,84,136,243,929
Wilson Chandler,SF,20,NYK,35,16,685,106,242,0.43799999999999994,9,30,0.3,97,212,0.45799999999999996,0.457,34,54,0.63,38,89,127,33,15,16,27,83,255
Josh Childress,SF,24,ATL,76,0,2274,327,573,0.5710000000000001,22,60,0.36700000000000005,305,513,0.595,0.59,222,275,0.807,174,199,373,117,71,43,98,129,898
Jarron Collins,C,29,UTA,70,9,702,36,82,0.439,0,1,0.0,36,81,0.444,0.439,46,74,0.622,40,76,116,37,10,6,22,106,118
Jason Collins,C,29,TOT,74,26,1172,53,113,0.469,0,1,0.0,53,112,0.473,0.469,34,74,0.45899999999999996,64,114,178,25,23,25,48,194,140
Mardy Collins,SG,23,NYK,46,8,634,57,175,0.326,8,32,0.25,49,143,0.34299999999999997,0.349,23,38,0.605,19,56,75,89,24,8,56,56,145
Nick Collison,PF,27,SEA,78,35,2223,322,641,0.502,0,2,0.0,322,639,0.504,0.502,123,167,0.737,254,476,730,113,47,60,118,250,767
Mike Conley,PG,20,MEM,53,46,1381,189,442,0.428,30,91,0.33,159,351,0.45299999999999996,0.462,90,123,0.732,21,118,139,222,44,2,89,85,498
Brian Cook,PF,27,TOT,51,2,629,88,234,0.376,43,115,0.374,45,119,0.37799999999999995,0.46799999999999997,19,21,0.905,28,81,109,27,13,12,39,93,238
Daequan Cook,SG,20,MIA,59,19,1441,196,514,0.381,79,238,0.332,117,276,0.424,0.45799999999999996,47,57,0.825,20,157,177,75,23,9,63,157,518
Jamal Crawford,SG,27,NYK,80,80,3190,570,1391,0.41,176,494,0.35600000000000004,394,897,0.439,0.473,329,381,0.8640000000000001,37,170,207,398,81,17,192,144,1645
Javaris Crittenton,SG,20,TOT,50,0,679,98,233,0.42100000000000004,10,37,0.27,88,196,0.449,0.442,72,104,0.6920000000000001,27,83,110,51,19,2,55,47,278
Austin Croshere,PF,32,GSW,44,0,457,61,137,0.445,22,61,0.361,39,76,0.513,0.526,29,32,0.9059999999999999,33,71,104,30,8,6,22,60,173
Eddy Curry,C,25,NYK,59,58,1530,297,544,0.546,0,0,0.0,297,544,0.546,0.546,187,300,0.623,111,164,275,32,14,29,126,157,781
Samuel Dalembert,C,26,PHI,82,82,2724,339,661,0.513,0,1,0.0,339,660,0.514,0.513,186,263,0.7070000000000001,304,545,849,45,40,192,155,269,864
Erick Dampier,C,32,DAL,72,64,1755,178,277,0.643,0,0,0.0,178,277,0.643,0.643,84,146,0.575,207,332,539,63,24,106,80,226,440
Antonio Daniels,PG,32,WAS,71,63,2161,205,447,0.45899999999999996,17,74,0.23,188,373,0.504,0.478,170,219,0.7759999999999999,23,180,203,340,69,2,91,78,597
Marquis Daniels,SG,27,IND,74,1,1546,241,561,0.43,27,102,0.265,214,459,0.466,0.45399999999999996,97,139,0.698,66,146,212,137,79,18,112,121,606
Jermareo Davidson,SF,23,CHA,38,2,322,51,125,0.408,0,0,0.0,51,125,0.408,0.408,18,28,0.643,21,41,62,13,7,15,17,46,120
Baron Davis,PG,28,GSW,82,82,3196,650,1526,0.426,173,525,0.33,477,1001,0.47700000000000004,0.483,318,424,0.75,96,289,385,623,191,43,232,247,1791
Glen Davis,C,22,BOS,69,1,940,107,221,0.484,0,0,0.0,107,221,0.484,0.484,99,150,0.66,95,113,208,28,31,20,65,160,313
Paul Davis,PF,23,LAC,22,1,194,24,65,0.369,0,0,0.0,24,65,0.369,0.369,6,10,0.6,25,22,47,10,6,6,9,33,54
Ricky Davis,SF,28,MIA,82,47,2963,420,971,0.433,135,333,0.405,285,638,0.447,0.502,155,197,0.787,55,298,353,276,87,14,191,187,1130
Carlos Delfino,SG,25,TOR,82,0,1928,251,632,0.397,120,314,0.382,131,318,0.41200000000000003,0.49200000000000005,116,156,0.7440000000000001,66,293,359,145,69,11,75,177,738
Luol Deng,SF,22,CHI,63,59,2128,429,896,0.479,8,22,0.364,421,874,0.48200000000000004,0.483,204,265,0.77,136,258,394,155,57,29,120,117,1070
Boris Diaw,PF,25,PHO,82,19,2308,308,646,0.47700000000000004,13,41,0.317,295,605,0.488,0.48700000000000004,96,129,0.7440000000000001,97,281,378,317,61,39,155,166,725
Yakhouba Diawara,SG,25,DEN,54,14,542,55,134,0.41,21,66,0.318,34,68,0.5,0.489,22,31,0.71,23,39,62,37,8,3,16,61,153
Guillermo Díaz,SG,22,LAC,6,0,18,1,4,0.25,0,1,0.0,1,3,0.33299999999999996,0.25,3,5,0.6,2,0,2,1,0,0,0,0,5
Dan Dickau,PG,29,LAC,67,8,1040,124,296,0.419,36,108,0.33299999999999996,88,188,0.46799999999999997,0.48,68,82,0.8290000000000001,13,84,97,172,32,3,55,108,352
Kaniel Dickens,PF,29,CLE,5,0,12,1,3,0.33299999999999996,0,0,0.0,1,3,0.33299999999999996,0.33299999999999996,0,0,0.0,0,1,1,1,0,1,0,1,2
Travis Diener,PG,25,IND,66,21,1356,159,430,0.37,74,233,0.318,85,197,0.431,0.456,64,71,0.9009999999999999,26,89,115,251,35,4,55,107,456
Ike Diogu,PF,24,IND,30,1,305,64,134,0.478,0,0,0.0,64,134,0.478,0.478,40,47,0.851,38,47,85,10,7,3,20,43,168
DeSagana Diop,C,26,TOT,79,23,1295,94,180,0.522,0,0,0.0,94,180,0.522,0.522,38,70,0.5429999999999999,160,232,392,40,26,88,58,146,226
Juan Dixon,PG,29,TOT,53,0,668,106,258,0.41100000000000003,30,72,0.41700000000000004,76,186,0.409,0.469,21,26,0.8079999999999999,15,60,75,97,21,2,54,62,263
Michael Doleac,C,30,MIN,24,8,257,28,63,0.444,0,0,0.0,28,63,0.444,0.444,1,2,0.5,16,33,49,7,10,10,12,44,57
Keyon Dooling,PG,27,ORL,72,1,1334,198,423,0.46799999999999997,22,65,0.33799999999999997,176,358,0.49200000000000005,0.494,163,193,0.845,7,94,101,133,36,5,61,131,581
Quincy Douby,PG,23,SAC,74,0,876,132,335,0.39399999999999996,42,122,0.344,90,213,0.423,0.457,48,52,0.9229999999999999,17,66,83,53,30,12,59,80,354
Jared Dudley,PF,22,CHA,73,14,1384,163,348,0.46799999999999997,9,41,0.22,154,307,0.502,0.48100000000000004,87,118,0.737,121,165,286,81,55,10,50,128,422
Chris Duhon,PG,25,CHI,66,18,1490,133,344,0.387,54,155,0.348,79,189,0.418,0.465,65,80,0.813,19,97,116,263,48,2,71,92,385
Tim Duncan,C,31,SAS,78,78,2651,585,1178,0.49700000000000005,0,4,0.0,585,1174,0.498,0.49700000000000005,338,463,0.73,237,644,881,218,56,152,178,185,1508
Mike Dunleavy,SG,27,IND,82,82,2953,532,1117,0.47600000000000003,165,389,0.424,367,728,0.504,0.55,336,403,0.8340000000000001,59,365,424,288,86,31,190,208,1565
Ronald Dupree,SF,27,TOT,5,0,21,1,3,0.33299999999999996,0,0,0.0,1,3,0.33299999999999996,0.33299999999999996,2,2,1.0,1,7,8,1,1,0,0,0,4
Kevin Durant,SG,19,SEA,80,80,2768,587,1366,0.43,59,205,0.28800000000000003,528,1161,0.455,0.451,391,448,0.873,70,278,348,192,78,75,232,122,1624
Monta Ellis,SG,22,GSW,81,72,3071,652,1227,0.531,12,52,0.231,640,1175,0.545,0.536,320,417,0.767,133,271,404,315,124,27,173,195,1636
Francisco Elson,C,31,TOT,63,5,813,92,236,0.39,0,1,0.0,92,235,0.391,0.39,26,37,0.703,50,150,200,24,15,20,47,96,210
Melvin Ely,C,29,NOH,52,1,621,85,180,0.47200000000000003,0,0,0.0,85,180,0.47200000000000003,0.47200000000000003,32,58,0.552,28,117,145,22,7,18,42,79,202
Maurice Evans,SG,29,TOT,75,47,1720,262,545,0.48100000000000004,81,209,0.38799999999999996,181,336,0.539,0.555,59,83,0.711,92,126,218,81,46,10,40,142,664
Reggie Evans,PF,27,PHI,81,61,1879,152,346,0.439,1,1,1.0,151,345,0.43799999999999994,0.441,120,257,0.467,224,387,611,65,86,8,108,213,425
Jordan Farmar,PG,21,LAL,82,0,1690,291,631,0.461,114,307,0.371,177,324,0.546,0.552,53,78,0.679,39,144,183,225,77,5,108,105,749
Nick Fazekas,PF,22,TOT,26,0,269,46,82,0.561,0,2,0.0,46,80,0.575,0.561,15,22,0.682,34,55,89,11,8,11,13,25,107
Raymond Felton,PG,23,CHA,79,79,2972,412,997,0.413,56,200,0.28,356,797,0.447,0.441,260,325,0.8,37,199,236,583,96,12,213,184,1140
Kyrylo Fesenko,C,21,UTA,9,0,70,6,16,0.375,0,0,0.0,6,16,0.375,0.375,2,4,0.5,14,11,25,2,0,3,8,19,14
Michael Finley,SG,34,SAS,82,61,2204,315,761,0.414,132,357,0.37,183,404,0.45299999999999996,0.501,64,80,0.8,27,227,254,114,29,10,56,93,826
Derek Fisher,PG,33,LAL,82,82,2249,339,777,0.436,112,276,0.406,227,501,0.45299999999999996,0.508,166,188,0.883,24,146,170,239,86,3,90,188,956
T.J. Ford,PG,24,TOR,51,26,1199,246,524,0.469,15,51,0.294,231,473,0.488,0.484,110,125,0.88,23,77,100,313,54,0,102,93,617
Jeff Foster,C,31,IND,77,52,1884,205,373,0.55,0,3,0.0,205,370,0.5539999999999999,0.55,86,145,0.593,264,404,668,129,56,32,62,221,496
Randy Foye,PG,24,MIN,39,31,1259,198,462,0.429,61,148,0.41200000000000003,137,314,0.436,0.495,53,65,0.815,13,115,128,164,36,3,79,102,510
Adonal Foyle,C,32,ORL,82,0,774,70,153,0.45799999999999996,0,0,0.0,70,153,0.45799999999999996,0.45799999999999996,16,34,0.47100000000000003,71,137,208,18,16,45,32,94,156
Richie Frahm,SG,30,LAC,10,2,163,20,54,0.37,7,25,0.28,13,29,0.44799999999999995,0.435,0,2,0.0,4,10,14,8,2,0,6,7,47
Steve Francis,PG,30,HOU,10,3,199,19,57,0.33299999999999996,4,17,0.235,15,40,0.375,0.368,13,23,0.565,8,15,23,30,9,5,14,25,55
Channing Frye,C,24,POR,78,20,1342,221,453,0.488,3,10,0.3,218,443,0.49200000000000005,0.491,85,109,0.78,107,247,354,57,29,27,55,208,530
Dan Gadzuric,C,29,MIL,51,4,534,64,154,0.41600000000000004,0,1,0.0,64,153,0.418,0.41600000000000004,33,63,0.524,67,77,144,11,20,24,34,83,161
Jorge Garbajosa,PF,30,TOR,7,0,74,8,25,0.32,6,16,0.375,2,9,0.222,0.44,0,0,0.0,2,13,15,3,3,0,1,2,22
Francisco García,SF,26,SAC,79,20,2096,348,752,0.46299999999999997,113,289,0.391,235,463,0.508,0.5379999999999999,162,208,0.779,52,212,264,128,96,50,128,232,971
Thomas Gardner,SG,22,CHI,4,0,45,9,23,0.391,3,12,0.25,6,11,0.545,0.457,0,2,0.0,3,1,4,1,0,0,4,4,21
Kevin Garnett,PF,31,BOS,71,71,2328,534,990,0.539,0,11,0.0,534,979,0.545,0.539,269,336,0.8009999999999999,135,520,655,244,100,89,138,163,1337
Pat Garrity,PF,31,ORL,31,0,284,27,80,0.33799999999999997,8,37,0.21600000000000003,19,43,0.442,0.38799999999999996,4,5,0.8,9,35,44,13,6,1,17,35,66
Pau Gasol,C,27,TOT,66,66,2351,475,890,0.534,4,16,0.25,471,874,0.539,0.536,292,362,0.807,155,398,553,211,30,98,124,139,1246
Rudy Gay,SF,21,MEM,81,81,3000,625,1355,0.461,134,387,0.34600000000000003,491,968,0.507,0.511,248,316,0.785,140,359,499,158,111,79,190,230,1632
Mickaël Gelabale,SG,24,SEA,39,0,465,69,157,0.439,16,37,0.43200000000000005,53,120,0.442,0.49,14,18,0.778,16,42,58,33,10,9,27,31,168
Devean George,SF,30,DAL,53,4,821,74,207,0.35700000000000004,22,68,0.324,52,139,0.374,0.41100000000000003,24,34,0.706,28,109,137,35,19,13,24,90,194
Daniel Gibson,PG,21,CLE,58,26,1765,201,465,0.43200000000000005,118,268,0.44,83,197,0.42100000000000004,0.5589999999999999,85,105,0.81,30,104,134,145,47,14,76,163,605
Eddie Gill,PG,29,TOT,14,1,154,12,31,0.387,5,15,0.33299999999999996,7,16,0.43799999999999994,0.46799999999999997,9,9,1.0,1,21,22,22,7,2,9,18,38
Manu Ginóbili,SG,30,SAS,74,23,2299,453,984,0.46,156,389,0.401,297,595,0.499,0.54,380,442,0.86,63,291,354,332,109,33,200,173,1442
Gordan Giriček,SG,30,TOT,56,0,831,133,302,0.44,36,99,0.364,97,203,0.478,0.5,23,26,0.885,16,80,96,62,24,4,52,82,325
Ryan Gomes,PF,25,MIN,82,74,2434,392,857,0.457,59,179,0.33,333,678,0.491,0.49200000000000005,190,229,0.83,133,342,475,145,65,10,96,154,1033
Drew Gooden,PF,26,TOT,69,65,2122,332,740,0.449,0,6,0.0,332,734,0.452,0.449,162,215,0.753,175,415,590,81,48,53,122,203,826
Ben Gordon,SG,24,CHI,72,27,2291,464,1069,0.434,142,346,0.41,322,723,0.445,0.5,266,293,0.9079999999999999,40,181,221,213,55,8,150,171,1336
Marcin Gortat,C,23,ORL,6,0,41,8,17,0.47100000000000003,0,0,0.0,8,17,0.47100000000000003,0.47100000000000003,2,3,0.667,8,8,16,2,1,1,2,4,18
Joey Graham,SF,25,TOR,38,3,331,49,113,0.434,2,3,0.667,47,110,0.42700000000000005,0.442,38,45,0.8440000000000001,18,49,67,15,3,0,23,47,138
Stephen Graham,SF,25,IND,22,0,128,34,58,0.586,7,14,0.5,27,44,0.614,0.647,12,16,0.75,4,18,22,9,4,1,10,14,87
Danny Granger,SF,24,IND,80,80,2876,537,1205,0.446,171,423,0.40399999999999997,366,782,0.46799999999999997,0.517,322,378,0.852,93,393,486,166,95,84,171,290,1567
Aaron Gray,C,23,CHI,61,1,613,103,204,0.505,0,1,0.0,103,203,0.507,0.505,56,99,0.5660000000000001,70,98,168,41,21,16,57,117,262
Gerald Green,SF,22,TOT,30,0,362,52,151,0.344,15,39,0.385,37,112,0.33,0.39399999999999996,34,41,0.8290000000000001,13,51,64,29,8,4,32,45,153
Jeff Green,SF,21,SEA,80,52,2253,320,749,0.42700000000000005,21,76,0.276,299,673,0.444,0.441,177,238,0.7440000000000001,101,278,379,119,46,49,158,198,838
Taurean Green,SG-PG,21,TOT,17,0,74,7,25,0.28,2,11,0.182,5,14,0.35700000000000004,0.32,11,12,0.917,0,10,10,11,2,0,9,5,27
Willie Green,SG,26,PHI,74,74,1970,379,870,0.436,51,179,0.285,328,691,0.475,0.465,112,148,0.757,32,150,182,151,54,22,109,119,921
Orien Greene,SG,25,SAC,7,2,61,3,11,0.273,0,1,0.0,3,10,0.3,0.273,0,0,0.0,0,6,6,3,3,1,7,9,6
Adrian Griffin,SG-SF,33,TOT,35,2,307,30,76,0.395,0,0,0.0,30,76,0.395,0.395,5,9,0.556,28,31,59,27,17,2,21,27,65
Richard Hamilton,SG,29,DET,72,72,2424,499,1030,0.484,62,141,0.44,437,889,0.49200000000000005,0.515,184,221,0.833,75,160,235,299,73,10,132,171,1244
Anfernee Hardaway,SF,36,MIA,16,8,325,22,60,0.36700000000000005,8,19,0.42100000000000004,14,41,0.341,0.433,8,9,0.889,3,32,35,35,19,1,13,24,60
Matt Harpring,SF,31,UTA,76,0,1374,237,474,0.5,2,10,0.2,235,464,0.506,0.502,146,205,0.7120000000000001,96,144,240,82,45,14,95,162,622
Al Harrington,C,27,GSW,81,59,2190,401,923,0.434,153,408,0.375,248,515,0.48200000000000004,0.517,147,190,0.774,107,332,439,132,74,16,90,266,1102
Othella Harrington,C,34,CHA,22,0,166,18,42,0.429,0,0,0.0,18,42,0.429,0.429,10,16,0.625,11,31,42,4,1,4,11,34,46
Devin Harris,PG,24,TOT,64,61,2022,321,693,0.46299999999999997,56,167,0.335,265,526,0.504,0.504,248,301,0.8240000000000001,28,145,173,369,90,10,161,190,946
Mike Harris,PF,24,HOU,17,0,159,27,54,0.5,0,2,0.0,27,52,0.519,0.5,8,13,0.615,24,30,54,3,6,3,9,16,62
David Harrison,C,25,IND,55,0,702,90,170,0.529,0,0,0.0,90,170,0.529,0.529,49,96,0.51,43,75,118,14,20,59,58,164,229
Jason Hart,PG,29,UTA,57,0,606,58,180,0.322,11,31,0.355,47,149,0.315,0.353,38,45,0.8440000000000001,5,50,55,86,30,3,28,75,165
Udonis Haslem,PF,27,MIA,49,48,1805,237,507,0.467,0,0,0.0,237,507,0.467,0.467,115,142,0.81,107,336,443,68,39,18,67,145,589
Trenton Hassell,SG,28,TOT,63,6,773,57,135,0.42200000000000004,2,9,0.222,55,126,0.43700000000000006,0.43,7,10,0.7,20,63,83,41,13,3,22,90,123
Spencer Hawes,C,19,SAC,71,8,931,146,318,0.45899999999999996,4,21,0.19,142,297,0.478,0.465,38,58,0.655,68,162,230,44,14,40,56,128,334
Chuck Hayes,PF,24,HOU,79,44,1575,113,221,0.511,0,3,0.0,113,218,0.518,0.511,11,24,0.45799999999999996,132,295,427,91,85,43,62,212,237
Jarvis Hayes,SF,26,DET,82,1,1287,217,504,0.431,73,194,0.376,144,310,0.465,0.503,45,60,0.75,35,143,178,62,47,6,47,137,552
Brendan Haywood,C,28,WAS,80,80,2228,316,599,0.528,0,0,0.0,316,599,0.528,0.528,216,294,0.735,273,303,576,71,31,133,108,216,848
Luther Head,SG,25,HOU,73,17,1379,206,477,0.43200000000000005,79,225,0.35100000000000003,127,252,0.504,0.515,66,81,0.815,18,117,135,138,44,9,70,75,557
Walter Herrmann,PF,28,TOT,45,0,373,56,144,0.389,20,64,0.313,36,80,0.45,0.45799999999999996,21,25,0.84,22,51,73,18,7,1,12,24,153
Nenê Hilário,PF,25,DEN,16,1,266,29,71,0.408,0,1,0.0,29,70,0.414,0.408,27,49,0.551,30,57,87,15,9,14,21,46,85
Grant Hill*,SF,35,PHO,70,68,2222,358,712,0.503,33,104,0.317,325,608,0.535,0.526,170,196,0.867,74,279,353,203,65,56,96,153,919
Kirk Hinrich,PG,27,CHI,75,72,2380,330,797,0.414,84,240,0.35,246,557,0.442,0.467,118,142,0.831,28,216,244,452,87,19,157,224,862
Ryan Hollins,PF,23,CHA,60,1,532,46,94,0.489,0,0,0.0,46,94,0.489,0.489,55,82,0.6709999999999999,53,54,107,14,10,30,25,96,147
Al Horford,C,21,ATL,81,77,2540,333,668,0.499,0,5,0.0,333,663,0.502,0.499,155,212,0.731,248,537,785,124,60,76,137,267,821
Robert Horry,PF,37,SAS,45,5,583,38,119,0.319,18,70,0.257,20,49,0.408,0.395,18,28,0.643,35,74,109,47,21,19,22,55,112
Eddie House,PG,29,BOS,78,2,1480,217,531,0.409,117,298,0.39299999999999996,100,233,0.429,0.519,33,36,0.917,19,148,167,152,59,10,76,114,584
Dwight Howard,C,22,ORL,82,82,3088,583,974,0.599,0,4,0.0,583,970,0.601,0.599,529,897,0.59,279,882,1161,110,74,176,263,274,1695
Josh Howard,SF,27,DAL,76,76,2757,567,1247,0.455,67,210,0.319,500,1037,0.48200000000000004,0.48200000000000004,312,384,0.813,120,412,532,164,59,32,114,202,1513
Juwan Howard,PF,34,DAL,50,0,353,23,64,0.359,0,0,0.0,23,64,0.359,0.359,11,14,0.7859999999999999,21,60,81,17,5,2,17,62,57
Troy Hudson,PG,31,GSW,9,0,93,9,31,0.29,4,12,0.33299999999999996,5,19,0.263,0.355,6,6,1.0,0,7,7,9,3,0,7,4,28
Larry Hughes,PG-SG,29,TOT,68,57,2020,305,801,0.381,67,194,0.345,238,607,0.392,0.423,150,188,0.7979999999999999,39,191,230,181,99,17,116,139,827
Kris Humphries,PF,22,TOR,70,0,925,161,333,0.483,0,2,0.0,161,331,0.486,0.483,75,124,0.605,90,169,259,28,25,28,47,107,397
Lindsey Hunter,PG,37,DET,24,0,215,22,64,0.344,7,26,0.26899999999999996,15,38,0.395,0.39799999999999996,7,9,0.778,4,9,13,33,13,2,13,30,58
Steven Hunter,C,26,DEN,19,2,120,15,28,0.536,0,0,0.0,15,28,0.536,0.536,9,20,0.45,10,19,29,0,0,6,7,20,39
Andre Iguodala,SF,24,PHI,82,82,3242,582,1277,0.456,101,307,0.32899999999999996,481,970,0.496,0.495,365,506,0.721,85,361,446,391,171,49,214,187,1630
Zydrunas Ilgauskas,C,32,CLE,73,73,2222,417,879,0.474,0,1,0.0,417,878,0.475,0.474,195,243,0.802,263,419,682,104,34,120,135,247,1029
Didier Ilunga-Mbenga,C,27,TOT,42,0,326,39,84,0.46399999999999997,0,0,0.0,39,84,0.46399999999999997,0.46399999999999997,5,12,0.41700000000000004,28,44,72,10,7,26,12,70,83
Allen Iverson*,SG,32,DEN,82,82,3424,712,1556,0.45799999999999996,95,275,0.345,617,1281,0.48200000000000004,0.488,645,797,0.809,47,196,243,586,160,12,245,109,2164
Royal Ivey,PG,26,MIL,75,20,1437,149,378,0.39399999999999996,35,107,0.327,114,271,0.42100000000000004,0.44,85,117,0.726,38,80,118,160,45,7,75,166,418
Jarrett Jack,SG,24,POR,82,16,2229,267,620,0.431,65,190,0.342,202,430,0.47,0.483,215,248,0.867,31,203,234,313,61,1,178,129,814
Bobby Jackson,SG-PG,34,TOT,72,5,1389,204,506,0.40299999999999997,81,226,0.358,123,280,0.439,0.483,64,81,0.79,33,148,181,139,45,5,59,96,553
Luke Jackson,SF,26,MIA,14,1,228,26,80,0.325,11,30,0.36700000000000005,15,50,0.3,0.39399999999999996,16,23,0.696,7,26,33,17,8,0,9,22,79
Stephen Jackson,SF,29,GSW,73,73,2855,488,1204,0.405,182,501,0.363,306,703,0.435,0.48100000000000004,308,370,0.8320000000000001,67,251,318,300,92,29,197,171,1466
Casey Jacobsen,SG,26,MEM,53,0,547,39,115,0.33899999999999997,16,72,0.222,23,43,0.535,0.409,13,17,0.765,12,53,65,20,5,1,16,34,107
Jerome James,C,32,NYK,2,0,5,1,1,1.0,0,0,0.0,1,1,1.0,1.0,2,2,1.0,0,3,3,0,0,0,0,0,4
LeBron James,SF,23,CLE,75,74,3027,794,1642,0.484,113,359,0.315,681,1283,0.531,0.518,549,771,0.7120000000000001,133,459,592,539,138,81,255,165,2250
Mike James,PG,32,TOT,54,1,720,101,290,0.348,31,97,0.32,70,193,0.363,0.402,39,48,0.813,14,55,69,60,21,2,36,56,272
Antawn Jamison,PF,31,WAS,79,79,3061,618,1417,0.436,120,354,0.33899999999999997,498,1063,0.46799999999999997,0.478,333,438,0.76,215,591,806,120,106,34,113,195,1689
Marko Jarić,SG,29,MIN,75,56,2189,227,528,0.43,46,127,0.36200000000000004,181,401,0.451,0.473,121,163,0.742,38,184,222,311,97,32,128,180,621
Al Jefferson,C,23,MIN,82,82,2919,721,1441,0.5,0,5,0.0,721,1436,0.502,0.5,284,394,0.721,308,603,911,117,74,119,167,222,1726
Richard Jefferson,SF,27,NJN,82,82,3200,619,1328,0.466,77,213,0.36200000000000004,542,1115,0.486,0.495,542,679,0.7979999999999999,93,249,342,252,76,21,199,225,1857
Jared Jeffries,SF,26,NYK,73,19,1325,108,270,0.4,4,25,0.16,104,245,0.424,0.40700000000000003,49,93,0.527,118,125,243,66,36,23,64,132,269
Yi Jianlian,PF,20,MIL,66,49,1647,219,520,0.42100000000000004,6,21,0.28600000000000003,213,499,0.42700000000000005,0.42700000000000005,122,145,0.841,106,238,344,55,36,56,90,153,566
Alexander Johnson,PF,24,MIA,43,6,549,61,125,0.488,0,0,0.0,61,125,0.488,0.488,57,83,0.687,32,62,94,13,13,10,42,80,179
Amir Johnson,PF,20,DET,62,0,764,92,165,0.5579999999999999,0,0,0.0,92,165,0.5579999999999999,0.5579999999999999,37,55,0.6729999999999999,87,148,235,29,24,82,39,141,221
Anthony Johnson,PG,33,TOT,69,52,1531,155,355,0.43700000000000006,42,93,0.452,113,262,0.431,0.496,35,43,0.8140000000000001,22,115,137,262,52,9,84,115,387
DerMarr Johnson,SF,27,SAS,5,0,28,7,14,0.5,3,9,0.33299999999999996,4,5,0.8,0.607,0,2,0.0,0,1,1,1,1,0,0,4,17
Joe Johnson,SG,26,ATL,82,82,3343,647,1497,0.43200000000000005,169,444,0.381,478,1053,0.45399999999999996,0.489,316,379,0.8340000000000001,83,284,367,474,84,18,223,168,1779
Linton Johnson,PF,27,TOT,8,0,63,9,19,0.474,1,3,0.33299999999999996,8,16,0.5,0.5,2,2,1.0,5,9,14,4,0,1,5,11,21
Bobby Jones,SF,24,TOT,47,2,531,60,140,0.429,18,53,0.34,42,87,0.483,0.493,40,51,0.784,29,63,92,28,15,3,28,85,178
Dahntay Jones,SG,27,SAC,25,0,206,23,53,0.434,1,6,0.16699999999999998,22,47,0.46799999999999997,0.44299999999999995,34,51,0.667,7,28,35,12,8,6,10,28,81
Damon Jones,SG,31,CLE,67,3,1336,151,363,0.41600000000000004,115,276,0.41700000000000004,36,87,0.414,0.574,20,28,0.7140000000000001,5,67,72,126,19,1,36,66,437
Dwayne Jones,PF,24,CLE,56,0,472,25,47,0.532,0,1,0.0,25,46,0.5429999999999999,0.532,28,58,0.483,69,71,140,10,10,25,17,88,78
Eddie Jones,SG,36,DAL,47,33,922,66,180,0.36700000000000005,34,116,0.293,32,64,0.5,0.461,10,14,0.7140000000000001,18,114,132,69,26,8,29,72,176
Fred Jones,SG,28,NYK,70,26,1757,182,432,0.42100000000000004,74,192,0.385,108,240,0.45,0.507,94,126,0.746,30,140,170,166,48,18,78,140,532
James Jones,SF,27,POR,58,3,1276,143,327,0.43700000000000006,91,205,0.444,52,122,0.426,0.5760000000000001,86,98,0.878,43,118,161,34,24,15,28,96,463
Solomon Jones,PF,23,ATL,35,0,145,12,30,0.4,0,2,0.0,12,28,0.429,0.4,11,20,0.55,19,23,42,0,3,5,11,28,35
Chris Kaman,C,25,LAC,56,55,2083,338,700,0.483,0,4,0.0,338,696,0.486,0.483,202,265,0.762,173,538,711,107,33,155,164,179,878
Jason Kapono,SF,26,TOR,81,7,1530,243,498,0.488,57,118,0.483,186,380,0.489,0.545,37,43,0.86,31,89,120,65,34,2,58,131,580
Coby Karl,SG,24,LAL,17,0,71,9,26,0.34600000000000003,4,13,0.308,5,13,0.385,0.423,8,10,0.8,3,11,14,9,4,2,5,4,30
Viktor Khryapa,PF,25,CHI,9,0,105,12,31,0.387,0,1,0.0,12,30,0.4,0.387,8,14,0.5710000000000001,6,14,20,8,6,0,6,11,32
Jason Kidd*,PG,34,TOT,80,80,2906,305,793,0.385,119,312,0.381,186,481,0.387,0.46,135,165,0.818,94,506,600,806,136,26,266,165,864
Tarence Kinsey,SG,23,MEM,11,0,96,16,38,0.42100000000000004,3,7,0.429,13,31,0.419,0.461,5,6,0.833,3,9,12,2,3,0,3,11,40
Andrei Kirilenko,SF,26,UTA,72,72,2217,275,544,0.506,44,116,0.379,231,428,0.54,0.546,198,257,0.77,121,218,339,285,86,109,140,165,792
Linas Kleiza,SF,23,DEN,79,13,1889,311,659,0.47200000000000003,94,277,0.33899999999999997,217,382,0.568,0.5429999999999999,164,213,0.77,92,241,333,95,44,19,89,181,880
Brevin Knight,PG,32,LAC,74,39,1674,138,342,0.40399999999999997,0,6,0.0,138,336,0.41100000000000003,0.40399999999999997,62,71,0.873,15,127,142,328,100,11,71,160,338
Kyle Korver,SG-PF,26,TOT,75,0,1732,255,575,0.44299999999999995,111,296,0.375,144,279,0.516,0.54,119,130,0.915,21,151,172,101,42,29,75,192,740
Nenad Krstić,C,24,NJN,45,38,812,123,300,0.41,0,2,0.0,123,298,0.413,0.41,52,69,0.754,35,165,200,27,9,17,41,111,298
Raef LaFrentz,C,31,POR,39,0,291,27,61,0.44299999999999995,0,4,0.0,27,57,0.474,0.44299999999999995,11,19,0.579,28,39,67,6,12,17,10,59,65
Carl Landry,PF,24,HOU,42,0,711,135,219,0.616,0,1,0.0,135,218,0.619,0.616,72,109,0.6609999999999999,96,111,207,21,17,7,26,98,342
Keith Langford,SG,24,SAS,2,0,10,1,4,0.25,0,0,0.0,1,4,0.25,0.25,0,0,0.0,0,2,2,0,0,0,0,1,2
Stéphane Lasme,PF-SF,25,TOT,16,4,303,32,71,0.451,0,0,0.0,32,71,0.451,0.451,19,32,0.594,26,27,53,3,13,22,15,35,83
Acie Law,PG,23,ATL,56,6,865,95,237,0.401,7,34,0.20600000000000002,88,203,0.433,0.41600000000000004,38,48,0.792,12,45,57,113,29,0,56,73,235
David Lee,PF,24,NYK,81,29,2356,341,618,0.552,0,2,0.0,341,616,0.5539999999999999,0.552,194,237,0.8190000000000001,242,482,724,95,55,29,97,210,876
Rashard Lewis,PF,28,ORL,81,81,3076,516,1135,0.455,226,553,0.409,290,582,0.498,0.5539999999999999,218,260,0.838,97,340,437,196,99,38,140,214,1476
Kyle Lowry,PG,21,MEM,82,9,2089,256,592,0.43200000000000005,36,140,0.257,220,452,0.48700000000000004,0.46299999999999997,243,348,0.698,41,209,250,296,92,22,127,185,791
Tyronn Lue,PG,30,TOT,50,3,736,113,253,0.447,39,86,0.45299999999999996,74,167,0.44299999999999995,0.524,25,32,0.7809999999999999,9,45,54,74,11,1,27,66,290
Mark Madsen,PF,32,MIN,20,6,151,3,19,0.158,0,0,0.0,3,19,0.158,0.158,3,12,0.25,18,20,38,4,3,2,9,25,9
Corey Maggette,SF,28,LAC,70,65,2502,458,1000,0.45799999999999996,78,203,0.384,380,797,0.47700000000000004,0.49700000000000005,553,681,0.812,78,316,394,189,71,7,195,210,1547
Jamaal Magloire,C,29,TOT,31,2,286,18,55,0.327,0,0,0.0,18,55,0.327,0.327,20,44,0.455,19,70,89,7,1,10,30,50,56
Ian Mahinmi,C,21,SAS,6,0,23,6,12,0.5,0,0,0.0,6,12,0.5,0.5,9,9,1.0,0,5,5,1,0,4,2,4,21
Stephon Marbury,PG,30,NYK,24,19,805,111,265,0.419,28,74,0.37799999999999995,83,191,0.435,0.47200000000000003,83,116,0.716,17,42,59,113,21,2,48,57,333
Shawn Marion,PF,29,TOT,63,62,2315,400,787,0.508,66,198,0.33299999999999996,334,589,0.5670000000000001,0.55,106,150,0.7070000000000001,136,507,643,138,125,85,86,150,972
Sean Marks,C,32,PHO,19,0,130,23,43,0.535,1,4,0.25,22,39,0.564,0.547,12,19,0.632,9,27,36,4,3,10,8,23,59
Donyell Marshall,PF,34,TOT,26,1,340,32,98,0.327,15,53,0.28300000000000003,17,45,0.37799999999999995,0.40299999999999997,19,22,0.8640000000000001,24,52,76,10,6,16,15,31,98
Darrick Martin,PG,36,TOR,17,0,141,10,43,0.233,2,16,0.125,8,27,0.29600000000000004,0.256,5,6,0.833,3,4,7,21,6,0,1,12,27
Kenyon Martin,PF,30,DEN,71,71,2159,376,699,0.5379999999999999,2,11,0.182,374,688,0.544,0.539,123,212,0.58,105,356,461,90,88,85,91,235,877
Kevin Martin,SG,24,SAC,61,57,2216,417,914,0.456,107,266,0.402,310,648,0.478,0.515,502,578,0.8690000000000001,48,225,273,129,62,5,131,150,1443
Desmond Mason,SF,30,MIL,59,56,1702,230,477,0.48200000000000004,0,0,0.0,230,477,0.48200000000000004,0.48200000000000004,114,173,0.659,75,181,256,121,40,30,83,106,574
Roger Mason,PG,27,WAS,80,9,1708,266,600,0.44299999999999995,130,327,0.39799999999999996,136,273,0.498,0.552,62,71,0.873,17,113,130,134,40,18,69,140,724
Jason Maxiell,C,24,DET,82,7,1768,240,446,0.5379999999999999,0,1,0.0,240,445,0.539,0.5379999999999999,171,270,0.633,177,256,433,46,21,94,71,183,651
Rashad McCants,SG,23,MIN,75,24,2020,428,944,0.45299999999999996,142,349,0.40700000000000003,286,595,0.48100000000000004,0.529,116,155,0.748,50,156,206,162,66,18,172,234,1114
Jelani McCoy,C,30,DEN,6,1,33,1,1,1.0,0,0,0.0,1,1,1.0,1.0,1,2,0.5,1,6,7,0,0,5,4,7,3
Antonio McDyess,PF,33,DET,78,78,2285,293,600,0.488,0,2,0.0,293,598,0.49,0.488,97,156,0.622,204,462,666,89,61,53,75,246,683
Tracy McGrady*,SG,28,HOU,66,62,2440,548,1307,0.419,86,295,0.292,462,1012,0.457,0.452,245,358,0.684,42,297,339,387,68,30,160,91,1427
Dominic McGuire,SG,22,WAS,70,1,695,39,103,0.379,1,6,0.16699999999999998,38,97,0.392,0.38299999999999995,14,32,0.43799999999999994,53,86,139,40,20,26,40,76,93
Jeff McInnis,PG,33,CHA,54,26,1410,108,249,0.434,3,19,0.158,105,230,0.457,0.44,23,30,0.767,16,80,96,220,23,3,76,120,242
Josh McRoberts,PF,20,POR,8,0,28,6,10,0.6,0,1,0.0,6,9,0.667,0.6,0,0,0.0,2,8,10,2,1,0,2,1,12
Chris Mihm,C,28,LAL,23,5,278,32,95,0.337,0,0,0.0,32,95,0.337,0.337,18,27,0.667,28,49,77,13,4,14,17,42,82
C.J. Miles,SG,20,UTA,60,13,689,113,236,0.479,30,77,0.39,83,159,0.522,0.542,41,52,0.7879999999999999,16,62,78,53,32,8,27,98,297
Darko Miličić,C,22,MEM,70,64,1663,219,500,0.43799999999999994,0,1,0.0,219,499,0.439,0.43799999999999994,67,121,0.5539999999999999,127,297,424,58,32,114,101,185,505
Andre Miller,PG,31,PHI,82,82,3016,569,1156,0.49200000000000005,3,34,0.08800000000000001,566,1122,0.504,0.494,257,333,0.772,95,229,324,565,105,6,206,181,1398
Brad Miller,C,31,SAC,72,72,2513,337,728,0.46299999999999997,28,90,0.311,309,638,0.484,0.48200000000000004,262,309,0.848,167,514,681,264,69,74,164,247,964
Mike Miller,SG,27,MEM,70,70,2474,414,824,0.502,155,359,0.43200000000000005,259,465,0.557,0.596,164,212,0.774,51,416,467,240,35,16,182,145,1147
Paul Millsap,PF,22,UTA,82,2,1702,253,502,0.504,0,4,0.0,253,498,0.508,0.504,155,229,0.677,167,293,460,81,72,73,87,269,661
Yao Ming*,C,27,HOU,55,55,2044,432,852,0.507,0,2,0.0,432,850,0.508,0.507,345,406,0.85,172,422,594,129,25,111,183,171,1209
Cuttino Mobley,SG,32,LAC,77,38,2702,377,870,0.433,67,192,0.349,310,678,0.457,0.47200000000000003,163,199,0.8190000000000001,50,225,275,202,78,34,123,152,984
Nazr Mohammed,C,30,TOT,82,29,1650,272,528,0.515,0,1,0.0,272,527,0.516,0.515,95,163,0.583,194,300,494,72,45,60,101,230,639
Jamario Moon,SF,27,TOR,78,75,2166,279,575,0.485,40,122,0.32799999999999996,239,453,0.528,0.52,63,85,0.741,92,392,484,90,80,108,51,152,661
Mikki Moore,PF,32,SAC,82,79,2385,282,489,0.5770000000000001,0,2,0.0,282,487,0.579,0.5770000000000001,134,182,0.736,160,334,494,84,35,46,110,310,698
Randolph Morris,C,22,NYK,18,2,181,21,58,0.36200000000000004,0,0,0.0,21,58,0.36200000000000004,0.36200000000000004,14,29,0.483,12,25,37,2,4,2,9,37,56
Alonzo Mourning*,C,37,MIA,25,0,389,52,95,0.547,0,0,0.0,52,95,0.547,0.547,45,76,0.5920000000000001,34,59,93,7,4,42,25,56,149
Troy Murphy,PF,27,IND,75,61,2106,315,693,0.455,94,236,0.39799999999999996,221,457,0.484,0.522,192,241,0.797,108,435,543,165,49,32,96,217,916
Ronald Murray,PG,28,TOT,42,19,874,154,367,0.42,20,63,0.317,134,304,0.441,0.447,68,98,0.6940000000000001,23,60,83,144,38,4,84,50,396
Dikembe Mutombo*,C,41,HOU,39,25,619,43,80,0.5379999999999999,0,0,0.0,43,80,0.5379999999999999,0.5379999999999999,32,45,0.711,68,131,199,5,11,48,17,55,118
Boštjan Nachbar,PF,27,NJN,75,1,1660,245,609,0.402,94,262,0.359,151,347,0.435,0.479,154,196,0.7859999999999999,56,204,260,88,44,21,85,182,738
Eduardo Nájera,PF,31,DEN,78,3,1664,174,368,0.473,53,147,0.361,121,221,0.5479999999999999,0.545,63,89,0.708,113,224,337,95,69,40,59,199,464
Steve Nash*,PG,33,PHO,81,81,2780,485,962,0.504,179,381,0.47,306,581,0.527,0.597,222,245,0.9059999999999999,28,254,282,898,53,5,295,113,1371
Juan Carlos Navarro,SG,27,MEM,82,30,2117,308,766,0.402,156,432,0.361,152,334,0.455,0.504,124,146,0.8490000000000001,34,176,210,177,48,1,134,94,896
Jameer Nelson,PG,25,ORL,69,62,1961,283,603,0.469,64,154,0.41600000000000004,219,449,0.488,0.522,125,151,0.828,28,215,243,383,63,4,141,167,755
Rasho Nesterović,C,31,TOR,71,39,1486,257,467,0.55,1,3,0.33299999999999996,256,464,0.552,0.551,37,49,0.755,130,212,342,82,20,52,60,132,552
Ira Newble,SG-SF,33,TOT,49,13,698,76,174,0.43700000000000006,16,49,0.327,60,125,0.48,0.483,20,26,0.769,47,78,125,18,28,8,34,69,188
Demetris Nichols,SF,23,TOT,14,0,44,6,23,0.261,3,13,0.231,3,10,0.3,0.326,0,0,0.0,0,5,5,1,0,3,4,4,15
Joakim Noah,C,22,CHI,74,31,1534,177,367,0.48200000000000004,0,1,0.0,177,366,0.484,0.48200000000000004,134,194,0.691,174,242,416,84,68,64,89,173,488
Andrés Nocioni,SF,28,CHI,82,27,2021,379,877,0.43200000000000005,126,346,0.364,253,531,0.47600000000000003,0.504,196,243,0.807,48,294,342,95,25,43,133,245,1080
Steve Novak,SF,24,HOU,35,0,264,49,102,0.48,34,71,0.479,15,31,0.484,0.647,3,4,0.75,4,31,35,6,2,3,4,17,135
Dirk Nowitzki,PF,29,DAL,77,77,2769,630,1314,0.479,79,220,0.359,551,1094,0.504,0.51,478,544,0.879,95,564,659,266,51,71,160,198,1817
Patrick O'Bryant,C,21,GSW,24,0,99,16,29,0.552,0,0,0.0,16,29,0.552,0.552,3,5,0.6,10,19,29,4,4,9,7,27,35
Jermaine O'Neal,C,29,IND,42,34,1206,225,512,0.439,0,5,0.0,225,507,0.444,0.439,121,163,0.742,82,201,283,93,20,87,106,129,571
Shaquille O'Neal*,C,35,TOT,61,61,1748,331,558,0.593,0,0,0.0,331,558,0.593,0.593,170,338,0.503,166,388,554,93,32,88,181,228,832
Fabricio Oberto,PF,32,SAS,82,64,1644,180,296,0.608,0,1,0.0,180,295,0.61,0.608,37,61,0.607,153,277,430,95,37,20,51,203,397
Lamar Odom,PF,28,LAL,77,77,2921,417,795,0.525,31,113,0.27399999999999997,386,682,0.5660000000000001,0.544,229,328,0.698,197,622,819,273,75,72,156,222,1094
Emeka Okafor,C,25,CHA,82,82,2718,460,860,0.535,0,0,0.0,460,860,0.535,0.535,213,374,0.57,255,621,876,70,62,138,164,241,1133
Mehmet Okur,C,28,UTA,72,72,2390,374,841,0.445,114,294,0.38799999999999996,260,547,0.475,0.512,185,230,0.804,132,424,556,145,55,29,104,236,1047
Kevin Ollie,SG,35,PHI,40,0,300,29,69,0.42,0,1,0.0,29,68,0.426,0.42,12,15,0.8,4,15,19,38,10,0,5,28,70
Bo Outlaw,PF,36,ORL,2,0,7,2,3,0.667,0,0,0.0,2,3,0.667,0.667,0,0,0.0,0,0,0,0,0,0,1,1,4
Travis Outlaw,PF,23,POR,82,6,2186,417,964,0.433,40,101,0.396,377,863,0.43700000000000006,0.45299999999999996,218,294,0.741,96,280,376,106,59,63,107,173,1092
Andre Owens,PG,27,IND,31,7,392,40,107,0.374,18,40,0.45,22,67,0.32799999999999996,0.45799999999999996,25,34,0.735,13,34,47,47,13,3,24,37,123
Zaza Pachulia,C,23,ATL,62,5,944,107,245,0.43700000000000006,0,3,0.0,107,242,0.442,0.43700000000000006,108,153,0.706,89,159,248,36,24,13,69,140,322
Jannero Pargo,SG,28,NOH,80,5,1497,254,652,0.39,65,186,0.349,189,466,0.406,0.439,71,81,0.877,26,104,130,192,50,5,93,123,644
Anthony Parker,SG,32,TOR,82,82,2634,395,829,0.47600000000000003,133,304,0.43799999999999994,262,525,0.499,0.557,102,125,0.816,50,284,334,183,79,17,87,157,1025
Smush Parker,PG,26,TOT,28,2,592,64,184,0.348,18,78,0.231,46,106,0.434,0.397,19,28,0.679,4,47,51,84,24,6,44,60,165
Tony Parker,PG,25,SAS,69,68,2312,515,1043,0.494,17,66,0.258,498,977,0.51,0.502,248,347,0.715,30,191,221,411,55,8,164,93,1295
Ruben Patterson,SF,32,LAC,20,5,327,39,86,0.45299999999999996,0,2,0.0,39,84,0.46399999999999997,0.45299999999999996,24,43,0.5579999999999999,24,40,64,17,21,7,27,37,102
Chris Paul,PG,22,NOH,80,80,3006,630,1291,0.488,92,249,0.369,538,1042,0.516,0.524,332,390,0.851,62,259,321,925,217,4,201,185,1684
Sasha Pavlović,SG,24,CLE,51,45,1188,146,403,0.36200000000000004,34,114,0.298,112,289,0.38799999999999996,0.40399999999999997,53,77,0.688,35,93,128,82,29,6,55,117,379
Oleksiy Pecherov,C,22,WAS,35,0,320,44,125,0.35200000000000004,17,60,0.28300000000000003,27,65,0.415,0.42,20,31,0.645,21,45,66,7,6,5,17,30,125
Kendrick Perkins,C,23,BOS,78,78,1912,214,348,0.615,0,1,0.0,214,347,0.617,0.615,114,183,0.623,145,329,474,84,31,114,125,242,542
Kosta Perović,C,22,GSW,7,0,38,3,10,0.3,0,0,0.0,3,10,0.3,0.3,4,6,0.667,6,7,13,1,0,2,1,6,10
Morris Peterson,SG,30,NOH,76,76,1796,215,516,0.41700000000000004,113,287,0.39399999999999996,102,229,0.445,0.526,65,85,0.765,36,170,206,67,47,7,41,125,608
Johan Petro,C,22,SEA,72,28,1310,184,439,0.419,0,1,0.0,184,438,0.42,0.419,64,87,0.736,98,272,370,32,35,42,73,173,432
Eric Piatkowski,SF,37,PHO,16,0,113,12,33,0.364,11,26,0.423,1,7,0.14300000000000002,0.53,4,4,1.0,1,11,12,10,0,1,6,11,39
Paul Pierce,SF,30,BOS,80,80,2874,509,1098,0.46399999999999997,143,365,0.392,366,733,0.499,0.529,409,485,0.843,53,358,411,363,101,36,221,200,1570
Mickaël Piétrus,SF,25,GSW,66,16,1316,170,387,0.439,66,183,0.361,104,204,0.51,0.525,66,98,0.6729999999999999,67,175,242,49,66,43,48,200,472
Scot Pollard,C,32,BOS,22,0,173,12,23,0.522,0,0,0.0,12,23,0.522,0.522,15,22,0.682,14,23,37,3,3,6,5,43,39
James Posey,PF,31,BOS,74,2,1821,173,414,0.418,106,279,0.38,67,135,0.496,0.546,93,115,0.809,30,292,322,114,72,19,65,182,545
Leon Powe,C,24,BOS,56,5,809,154,269,0.5720000000000001,0,1,0.0,154,268,0.575,0.5720000000000001,137,193,0.71,95,132,227,15,15,16,43,127,445
Josh Powell,C,25,LAC,64,25,1228,145,315,0.46,0,3,0.0,145,312,0.465,0.46,63,87,0.7240000000000001,115,216,331,47,14,23,65,130,353
Kasib Powell,SF,26,MIA,11,4,304,35,95,0.368,8,33,0.242,27,62,0.435,0.41100000000000003,6,9,0.667,8,36,44,18,9,2,5,18,84
Ronnie Price,PG,24,UTA,61,3,588,88,204,0.431,26,75,0.34700000000000003,62,129,0.48100000000000004,0.495,26,38,0.684,8,38,46,78,32,3,30,83,228
Tayshaun Prince,SF,27,DET,82,82,2694,421,940,0.44799999999999995,53,146,0.363,368,794,0.46299999999999997,0.47600000000000003,185,241,0.768,109,289,398,268,42,33,91,90,1080
Gabe Pruitt,PG,21,BOS,15,0,95,14,39,0.359,3,12,0.25,11,27,0.40700000000000003,0.397,1,2,0.5,1,7,8,13,5,0,5,10,32
Joel Przybilla,C,28,POR,77,67,1819,144,250,0.5760000000000001,0,1,0.0,144,249,0.578,0.5760000000000001,83,122,0.68,195,454,649,27,13,93,95,234,371
Chris Quinn,PG,24,MIA,60,25,1340,158,373,0.424,64,159,0.40299999999999997,94,214,0.439,0.509,85,98,0.867,11,107,118,178,46,4,55,90,465
Vladimir Radmanović,SF,27,LAL,65,41,1483,198,437,0.45299999999999996,95,234,0.406,103,203,0.507,0.562,52,65,0.8,56,159,215,123,46,12,73,147,543
Shavlik Randolph,PF,24,PHI,9,0,27,4,14,0.28600000000000003,0,0,0.0,4,14,0.28600000000000003,0.28600000000000003,0,0,0.0,9,2,11,3,1,3,2,5,8
Zach Randolph,C,26,NYK,69,68,2244,486,1058,0.45899999999999996,22,80,0.275,464,978,0.474,0.47,223,289,0.772,184,526,710,140,59,16,186,194,1217
Theo Ratliff,C-PF,34,TOT,26,9,437,41,85,0.48200000000000004,0,1,0.0,41,84,0.488,0.48200000000000004,29,43,0.674,32,57,89,14,7,37,21,59,111
Michael Redd,SG,28,MIL,72,71,2702,550,1243,0.442,130,359,0.36200000000000004,420,884,0.475,0.495,402,490,0.82,85,224,309,247,65,13,181,120,1632
J.J. Redick,SG,23,ORL,34,0,276,48,108,0.444,17,43,0.395,31,65,0.47700000000000004,0.523,27,34,0.794,1,22,23,16,4,0,15,29,140
Chris Richard,C,23,MIN,52,3,556,41,87,0.47100000000000003,0,0,0.0,41,87,0.47100000000000003,0.47100000000000003,16,27,0.593,52,83,135,18,10,12,24,83,98
Jason Richardson,SF,27,CHA,82,82,3149,648,1468,0.441,243,599,0.406,405,869,0.466,0.524,249,331,0.752,80,361,441,258,116,57,166,241,1788
Jeremy Richardson,SF-SG,23,TOT,27,1,132,16,44,0.364,7,19,0.368,9,25,0.36,0.44299999999999995,2,2,1.0,1,8,9,2,3,0,6,13,41
Quentin Richardson,SF,27,NYK,65,65,1841,199,555,0.359,69,214,0.322,130,341,0.381,0.42100000000000004,60,88,0.682,56,259,315,116,44,15,69,153,527
Luke Ridnour,PG,26,SEA,61,5,1223,147,368,0.39899999999999997,21,71,0.29600000000000004,126,297,0.424,0.428,78,91,0.857,13,81,94,241,37,14,80,120,393
Nate Robinson,PG,23,NYK,72,17,1883,331,782,0.423,97,292,0.332,234,490,0.478,0.485,154,196,0.7859999999999999,51,171,222,212,60,1,103,186,913
Sergio Rodríguez,PG,21,POR,72,0,628,69,196,0.35200000000000004,17,58,0.293,52,138,0.377,0.395,25,38,0.6579999999999999,13,45,58,123,24,0,53,57,180
Rajon Rondo,PG,21,BOS,77,77,2306,351,713,0.49200000000000005,5,19,0.263,346,694,0.499,0.496,107,175,0.611,78,244,322,393,129,13,147,187,814
Malik Rose,PF,33,NYK,49,3,494,66,180,0.36700000000000005,2,7,0.28600000000000003,64,173,0.37,0.37200000000000005,37,51,0.725,31,72,103,28,16,7,40,80,171
Quinton Ross,SG,26,LAC,76,44,1505,131,335,0.391,9,21,0.429,122,314,0.389,0.40399999999999997,40,60,0.667,54,118,172,88,43,33,29,132,311
Brandon Roy,SG,23,POR,74,74,2792,531,1170,0.45399999999999996,73,215,0.34,458,955,0.48,0.485,281,373,0.753,81,267,348,430,79,16,136,147,1416
Michael Ruffin,C,31,MIL,46,2,632,33,62,0.532,0,0,0.0,33,62,0.532,0.532,25,63,0.397,90,96,186,24,31,19,19,93,91
Kareem Rush,SG,27,IND,71,15,1504,228,569,0.401,102,262,0.389,126,307,0.41,0.49,30,42,0.7140000000000001,19,149,168,89,42,19,62,108,588
John Salmons,SG,28,SAC,81,41,2517,381,799,0.47700000000000004,39,120,0.325,342,679,0.504,0.501,214,260,0.823,76,273,349,208,93,31,170,171,1015
Cheikh Samb,C,23,DET,4,0,31,3,4,0.75,0,0,0.0,3,4,0.75,0.75,1,2,0.5,3,4,7,0,1,2,1,8,7
Brian Scalabrine,PF,29,BOS,48,9,512,29,94,0.309,15,46,0.326,14,48,0.292,0.38799999999999996,15,20,0.75,22,57,79,40,9,8,26,63,88
Luis Scola,PF,27,HOU,82,39,2024,345,670,0.515,0,3,0.0,345,667,0.517,0.515,157,235,0.6679999999999999,174,351,525,106,60,19,105,235,847
Thabo Sefolosha,SG,23,CHI,69,22,1436,180,421,0.428,29,88,0.33,151,333,0.45299999999999996,0.462,75,104,0.721,50,205,255,129,61,30,93,128,464
Mouhamed Sene,C,21,SEA,13,0,62,11,24,0.45799999999999996,0,0,0.0,11,24,0.45799999999999996,0.45799999999999996,8,17,0.47100000000000003,7,9,16,1,0,7,0,9,30
Ramon Sessions,PG,21,MIL,17,7,450,51,117,0.436,3,7,0.429,48,110,0.436,0.449,32,41,0.78,8,50,58,127,17,3,36,26,137
Bobby Simmons,SF,27,MIL,70,21,1521,209,496,0.42100000000000004,60,171,0.35100000000000003,149,325,0.45799999999999996,0.48200000000000004,53,70,0.757,67,159,226,80,50,5,78,140,531
Cedric Simmons,PF,22,TOT,14,0,87,4,14,0.28600000000000003,0,0,0.0,4,14,0.28600000000000003,0.28600000000000003,0,10,0.0,6,12,18,0,2,5,6,8,8
Courtney Sims,C,24,IND,3,0,11,0,1,0.0,0,0,0.0,0,1,0.0,0.0,0,0,0.0,1,1,2,1,0,0,0,2,0
Brian Skinner,C,31,PHO,66,0,844,92,198,0.465,2,3,0.667,90,195,0.462,0.47,33,63,0.524,63,175,238,15,21,77,39,112,219
Craig Smith,PF,24,MIN,77,11,1547,297,528,0.563,0,9,0.0,297,519,0.5720000000000001,0.563,133,200,0.665,123,230,353,60,36,17,89,217,727
J.R. Smith,SG,22,DEN,74,0,1421,311,674,0.461,157,390,0.40299999999999997,154,284,0.542,0.578,128,178,0.7190000000000001,43,109,152,128,62,12,112,144,907
Jason Smith,PF,21,PHI,76,1,1107,141,310,0.455,4,14,0.28600000000000003,137,296,0.46299999999999997,0.461,54,82,0.659,77,153,230,20,22,50,48,142,340
Joe Smith,PF,32,TOT,77,36,1726,312,653,0.478,0,3,0.0,312,650,0.48,0.478,154,204,0.755,163,238,401,66,34,47,71,186,778
Josh Smith,PF,22,ATL,81,81,2873,518,1133,0.457,25,99,0.253,493,1034,0.47700000000000004,0.46799999999999997,333,469,0.71,161,506,667,272,123,227,245,269,1394
Eric Snow,PG,34,CLE,22,5,305,6,38,0.158,0,2,0.0,6,36,0.16699999999999998,0.158,10,22,0.455,4,16,20,42,10,4,10,30,22
Kirk Snyder,SF-PF,24,TOT,36,18,761,96,189,0.508,5,23,0.217,91,166,0.5479999999999999,0.521,64,88,0.727,30,96,126,64,20,15,52,55,261
Darius Songaila,C,29,WAS,80,13,1554,214,467,0.45799999999999996,0,2,0.0,214,465,0.46,0.45799999999999996,67,73,0.9179999999999999,81,190,271,135,53,16,86,181,495
Jerry Stackhouse,SG,33,DAL,58,13,1412,213,526,0.405,60,184,0.326,153,342,0.447,0.462,132,148,0.892,33,100,133,145,28,10,86,82,618
DeShawn Stevenson,SG,26,WAS,82,82,2564,301,780,0.386,158,413,0.38299999999999995,143,367,0.39,0.48700000000000004,157,197,0.797,37,198,235,252,65,15,102,110,917
Peja Stojaković,SF,30,NOH,77,77,2711,451,1026,0.44,231,524,0.441,220,502,0.43799999999999994,0.552,130,140,0.929,64,267,331,96,57,10,61,127,1263
Awvee Storey,SG,30,MIL,26,0,259,39,89,0.43799999999999994,0,7,0.0,39,82,0.47600000000000003,0.43799999999999994,14,29,0.483,31,23,54,16,7,1,10,41,92
Damon Stoudamire,PG,34,TOT,60,33,1037,120,337,0.35600000000000004,50,149,0.336,70,188,0.37200000000000005,0.43,27,34,0.794,20,98,118,165,30,2,80,76,317
Salim Stoudamire,PG,25,ATL,35,0,402,65,180,0.361,29,85,0.341,36,95,0.379,0.442,41,50,0.82,4,20,24,28,7,5,21,34,200
Amar'e Stoudemire,C,25,PHO,79,79,2677,714,1211,0.59,5,31,0.161,709,1180,0.601,0.5920000000000001,556,691,0.805,178,541,719,118,64,163,174,294,1989
D.J. Strawberry,SG,22,PHO,33,0,270,29,92,0.315,6,25,0.24,23,67,0.34299999999999997,0.348,9,19,0.474,9,19,28,30,12,6,11,36,73
Rodney Stuckey,PG,21,DET,57,2,1081,153,382,0.401,3,16,0.188,150,366,0.41,0.40399999999999997,127,156,0.8140000000000001,32,97,129,160,49,6,78,113,436
Robert Swift,C,22,SEA,8,4,98,6,17,0.353,0,0,0.0,6,17,0.353,0.353,2,2,1.0,6,12,18,1,5,6,10,16,14
Stromile Swift,PF,28,TOT,56,4,844,135,265,0.509,0,2,0.0,135,263,0.513,0.509,73,109,0.67,64,135,199,26,15,54,51,113,343
Wally Szczerbiak,SF,30,TOT,75,2,1736,311,722,0.431,90,218,0.413,221,504,0.43799999999999994,0.493,149,175,0.851,34,183,217,104,23,12,76,103,861
Sebastian Telfair,PG,22,MIN,60,51,1933,223,556,0.401,32,114,0.281,191,442,0.43200000000000005,0.43,78,105,0.743,16,119,135,355,59,11,111,171,556
Jason Terry,SG,30,DAL,82,34,2579,471,1008,0.467,136,363,0.375,335,645,0.519,0.535,191,223,0.857,30,178,208,264,88,18,92,170,1269
Billy Thomas,SF,32,TOT,11,0,42,4,17,0.235,4,16,0.25,0,1,0.0,0.353,2,2,1.0,0,2,2,0,1,0,4,4,14
Kenny Thomas,PF,30,SAC,23,3,281,16,38,0.42100000000000004,0,0,0.0,16,38,0.42100000000000004,0.42100000000000004,0,5,0.0,18,43,61,13,6,1,21,38,32
Kurt Thomas,C-PF,35,TOT,70,48,1584,195,396,0.49200000000000005,0,1,0.0,195,395,0.494,0.49200000000000005,53,80,0.6629999999999999,130,377,507,67,56,57,46,188,443
Tim Thomas,PF,30,LAC,63,51,1940,291,705,0.413,83,271,0.306,208,434,0.479,0.47200000000000003,115,153,0.752,62,261,323,171,40,29,98,192,780
Tyrus Thomas,PF,21,CHI,74,27,1330,186,440,0.423,1,6,0.16699999999999998,185,434,0.426,0.424,129,174,0.741,102,240,342,90,48,72,77,170,502
Al Thornton,PF,24,LAC,79,31,2158,374,871,0.429,43,130,0.331,331,741,0.447,0.45399999999999996,214,288,0.743,98,260,358,98,46,43,128,195,1005
Jamaal Tinsley,PG,29,IND,39,36,1293,176,463,0.38,40,141,0.284,136,322,0.42200000000000004,0.423,72,100,0.72,24,117,141,326,66,10,130,97,464
Alando Tucker,SF,23,PHO,6,0,48,8,22,0.364,1,4,0.25,7,18,0.389,0.386,5,6,0.833,4,4,8,0,0,1,0,2,22
Ronny Turiaf,C,25,LAL,78,21,1458,188,397,0.474,0,1,0.0,188,396,0.475,0.474,140,186,0.753,95,211,306,128,28,108,72,199,516
Hedo Türkoğlu,SF,28,ORL,82,82,3026,556,1219,0.456,166,415,0.4,390,804,0.485,0.524,324,391,0.8290000000000001,83,388,471,409,74,25,246,244,1602
Ime Udoka,PF,30,SAS,73,0,1316,159,375,0.424,61,165,0.37,98,210,0.467,0.505,44,58,0.759,36,192,228,63,56,17,58,127,423
Beno Udrih,PG,25,SAC,65,51,2080,328,708,0.46299999999999997,53,137,0.387,275,571,0.48200000000000004,0.501,125,147,0.85,34,183,217,282,56,10,148,138,834
Anderson Varejão,C,25,CLE,48,13,1320,136,295,0.461,0,2,0.0,136,293,0.46399999999999997,0.461,49,82,0.598,134,265,399,53,37,26,59,134,321
Jacque Vaughn,PG,32,SAS,74,9,1139,121,283,0.428,3,10,0.3,118,273,0.43200000000000005,0.433,61,80,0.763,13,61,74,159,23,1,54,97,306
Charlie Villanueva,PF,23,MIL,76,31,1829,354,814,0.435,55,185,0.297,299,629,0.475,0.469,123,157,0.7829999999999999,145,321,466,78,30,35,107,174,886
Marcus Vinicius,SF,23,NOH,13,0,69,9,20,0.45,5,12,0.41700000000000004,4,8,0.5,0.575,5,11,0.455,1,7,8,2,1,1,3,4,28
Jake Voskuhl,C,30,MIL,44,0,386,37,80,0.46299999999999997,0,0,0.0,37,80,0.46299999999999997,0.46299999999999997,24,29,0.828,30,67,97,13,9,21,29,83,98
Sasha Vujačić,SG,23,LAL,72,0,1279,219,482,0.45399999999999996,118,270,0.43700000000000006,101,212,0.47600000000000003,0.5770000000000001,76,91,0.835,19,135,154,72,36,5,52,107,632
Dwyane Wade,SG,26,MIA,51,49,1954,439,937,0.469,22,77,0.28600000000000003,417,860,0.485,0.48,354,467,0.758,45,169,214,354,87,37,224,137,1254
Von Wafer,SG,22,TOT,29,0,154,17,61,0.27899999999999997,4,26,0.154,13,35,0.371,0.311,8,12,0.667,1,18,19,7,2,3,13,7,46
Antoine Walker,PF,31,MIN,46,1,892,136,375,0.363,61,188,0.324,75,187,0.401,0.444,35,66,0.53,56,112,168,45,33,8,46,80,368
Ben Wallace,C-PF,33,TOT,72,72,2205,138,352,0.392,0,4,0.0,138,348,0.397,0.392,72,169,0.426,234,370,604,105,88,117,67,121,348
Gerald Wallace,PF,25,CHA,62,59,2376,408,908,0.449,71,221,0.321,337,687,0.491,0.488,313,428,0.731,58,315,373,216,131,58,180,189,1200
Rasheed Wallace,C,33,DET,77,76,2346,376,870,0.43200000000000005,112,315,0.35600000000000004,264,555,0.47600000000000003,0.49700000000000005,115,150,0.767,84,427,511,137,91,129,86,213,979
Luke Walton,SF,27,LAL,74,31,1729,215,478,0.45,28,84,0.33299999999999996,187,394,0.475,0.479,77,109,0.706,85,206,291,218,60,18,100,133,535
Hakim Warrick,PF,25,MEM,75,30,1754,328,653,0.502,13,48,0.271,315,605,0.521,0.512,183,260,0.7040000000000001,123,233,356,53,36,28,85,156,852
Darius Washington,SG,22,SAS,18,0,146,21,48,0.43799999999999994,4,12,0.33299999999999996,17,36,0.47200000000000003,0.479,7,13,0.5379999999999999,4,16,20,15,5,0,14,16,53
Darryl Watkins,C,23,SAC,9,0,71,5,15,0.33299999999999996,0,0,0.0,5,15,0.33299999999999996,0.33299999999999996,2,5,0.4,5,7,12,0,2,2,7,8,12
C.J. Watson,PG,23,GSW,32,0,368,43,101,0.426,9,26,0.34600000000000003,34,75,0.45299999999999996,0.47,23,29,0.7929999999999999,13,19,32,35,15,0,18,19,118
Earl Watson,PG,28,SEA,78,73,2269,339,747,0.45399999999999996,49,132,0.371,290,615,0.47200000000000003,0.48700000000000004,111,145,0.7659999999999999,43,182,225,531,69,11,175,158,838
Chris Webber,PF,34,GSW,9,8,126,15,31,0.484,0,0,0.0,15,31,0.484,0.484,5,12,0.41700000000000004,2,30,32,18,4,6,11,17,35
Martell Webster,SF,21,POR,75,70,2132,277,656,0.42200000000000004,123,317,0.38799999999999996,154,339,0.45399999999999996,0.516,122,166,0.735,54,242,296,90,42,28,83,159,799
Bonzi Wells,SG,31,TOT,73,7,1562,252,569,0.44299999999999995,12,50,0.24,240,519,0.462,0.45299999999999996,146,227,0.643,84,247,331,97,75,32,103,157,662
David West,PF,27,NOH,76,76,2870,629,1305,0.48200000000000004,6,25,0.24,623,1280,0.48700000000000004,0.484,300,353,0.85,180,495,675,177,62,99,165,208,1564
Delonte West,PG,24,TOT,61,31,1533,196,475,0.413,48,135,0.35600000000000004,148,340,0.435,0.46299999999999997,67,91,0.736,31,162,193,229,59,29,117,103,507
Mario West,SG,23,ATL,64,2,269,21,49,0.429,0,4,0.0,21,45,0.467,0.429,17,26,0.654,26,22,48,13,12,4,9,61,59
Chris Wilcox,PF,25,SEA,62,55,1739,334,638,0.524,0,3,0.0,334,635,0.526,0.524,160,248,0.645,126,307,433,74,46,36,103,174,828
Damien Wilkins,SF,28,SEA,76,31,1843,271,673,0.40299999999999997,50,155,0.32299999999999995,221,518,0.42700000000000005,0.44,106,144,0.736,72,173,245,150,62,19,89,128,698
Mike Wilks,PG,28,TOT,15,0,188,17,36,0.47200000000000003,3,8,0.375,14,28,0.5,0.514,4,4,1.0,5,14,19,14,9,0,9,13,41
Aaron Williams,C,36,LAC,30,5,297,27,55,0.491,0,0,0.0,27,55,0.491,0.491,14,18,0.778,15,46,61,9,12,15,13,44,68
Deron Williams,PG,23,UTA,82,82,3059,566,1117,0.507,83,210,0.395,483,907,0.5329999999999999,0.544,330,411,0.8029999999999999,34,209,243,862,90,23,279,200,1545
Jason Williams,PG,32,MIA,67,53,1886,211,550,0.384,97,275,0.353,114,275,0.415,0.47200000000000003,69,80,0.863,12,118,130,307,83,5,91,93,588
Justin Williams,C,23,TOT,23,0,123,13,29,0.44799999999999995,0,0,0.0,13,29,0.44799999999999995,0.44799999999999995,8,26,0.308,20,29,49,0,5,5,4,17,34
Lou Williams,PG,21,PHI,80,0,1862,319,752,0.424,55,153,0.359,264,599,0.441,0.461,227,290,0.7829999999999999,41,126,167,253,81,13,125,130,920
Marcus Williams,PG,22,NJN,53,7,854,111,293,0.379,54,142,0.38,57,151,0.377,0.47100000000000003,37,47,0.787,14,87,101,140,25,3,75,52,313
Marcus Williams,PF-SF,21,TOT,11,0,36,5,20,0.25,0,0,0.0,5,20,0.25,0.25,0,0,0.0,4,8,12,3,1,1,0,3,10
Marvin Williams,SF,21,ATL,80,80,2765,424,918,0.462,1,10,0.1,423,908,0.466,0.462,336,409,0.8220000000000001,119,338,457,137,81,33,127,225,1185
Mo Williams,PG,25,MIL,66,66,2410,441,919,0.48,89,231,0.385,352,688,0.512,0.528,166,194,0.856,37,193,230,419,78,10,182,188,1137
Sean Williams,C,21,NJN,73,29,1278,164,305,0.5379999999999999,0,0,0.0,164,305,0.5379999999999999,0.5379999999999999,81,133,0.609,115,207,322,28,28,106,70,193,409
Shawne Williams,SF,21,IND,65,3,967,159,372,0.42700000000000005,43,137,0.314,116,235,0.494,0.485,76,106,0.7170000000000001,54,122,176,59,26,26,58,132,437
Shelden Williams,PF,24,TOT,64,0,776,92,212,0.434,0,2,0.0,92,210,0.43799999999999994,0.434,71,105,0.6759999999999999,68,137,205,19,22,21,35,110,255
Loren Woods,C,29,HOU,7,0,17,3,5,0.6,0,0,0.0,3,5,0.6,0.6,0,0,0.0,0,1,1,2,0,0,0,2,6
Metta World Peace,SF,28,SAC,57,54,2172,436,962,0.45299999999999996,84,221,0.38,352,741,0.475,0.49700000000000005,212,295,0.7190000000000001,101,227,328,199,133,38,148,159,1168
Antoine Wright,SG,23,TOT,56,10,1232,136,329,0.413,32,110,0.29100000000000004,104,219,0.475,0.462,46,67,0.687,40,107,147,80,28,21,50,127,350
Brandan Wright,PF,20,GSW,38,6,376,62,112,0.5539999999999999,0,0,0.0,62,112,0.5539999999999999,0.5539999999999999,27,40,0.675,38,61,99,9,6,22,13,36,151
Dorell Wright,SF,22,MIA,44,34,1104,143,293,0.488,4,11,0.364,139,282,0.493,0.495,57,69,0.826,48,172,220,60,29,41,29,79,347
Julian Wright,SF,20,NOH,57,1,640,90,169,0.5329999999999999,10,24,0.41700000000000004,80,145,0.552,0.562,33,52,0.635,33,84,117,40,29,12,34,43,223
Lorenzen Wright,C,32,TOT,18,1,161,6,21,0.28600000000000003,0,0,0.0,6,21,0.28600000000000003,0.28600000000000003,3,6,0.5,8,30,38,4,3,3,4,31,15
Nick Young,SG,22,WAS,75,2,1158,210,478,0.439,40,100,0.4,170,378,0.45,0.48100000000000004,101,124,0.815,23,92,115,63,35,7,94,130,561
Thaddeus Young,PF,19,PHI,74,22,1554,264,490,0.539,6,19,0.316,258,471,0.5479999999999999,0.545,76,103,0.738,120,192,312,58,73,8,64,126,610
