Player,Pos,Age,Tm,G,GS,MP,FG,FGA,FG%,3P,3PA,3P%,2P,2PA,2P%,eFG%,FT,FTA,FT%,ORB,DRB,TRB,AST,STL,BLK,TOV,PF,PTS
Álex Abrines,SG,23,OKC,68,6,1055,134,341,0.39299999999999996,94,247,0.381,40,94,0.426,0.531,44,49,0.898,18,68,86,40,37,8,33,114,406
Quincy Acy,PF,26,TOT,38,1,558,70,170,0.41200000000000003,37,90,0.41100000000000003,33,80,0.413,0.521,45,60,0.75,20,95,115,18,14,15,21,67,222
Steven Adams,C,23,OKC,80,80,2389,374,655,0.5710000000000001,0,1,0.0,374,654,0.5720000000000001,0.5710000000000001,157,257,0.611,281,332,613,86,89,78,146,195,905
Arron Afflalo,SG,31,SAC,61,45,1580,185,420,0.44,62,151,0.41100000000000003,123,269,0.457,0.514,83,93,0.892,9,116,125,78,21,6,42,104,515
Alexis Ajinça,C,28,NOP,39,15,584,89,178,0.5,0,4,0.0,89,174,0.511,0.5,29,40,0.725,46,131,177,12,20,22,31,77,207
Cole Aldrich,C,28,MIN,62,0,531,45,86,0.523,0,0,0.0,45,86,0.523,0.523,15,22,0.682,51,107,158,25,25,23,17,85,105
LaMarcus Aldridge,PF,31,SAS,72,72,2335,500,1049,0.47700000000000004,23,56,0.41100000000000003,477,993,0.48,0.488,220,271,0.812,172,351,523,139,46,88,98,158,1243
Lavoy Allen,PF,27,IND,61,5,871,77,168,0.45799999999999996,0,1,0.0,77,167,0.461,0.45799999999999996,23,33,0.6970000000000001,105,114,219,57,18,24,29,78,177
Tony Allen,SG,35,MEM,71,66,1914,274,595,0.461,15,54,0.278,259,541,0.479,0.473,80,130,0.615,166,225,391,98,115,29,100,178,643
Al-Farouq Aminu,PF,26,POR,61,25,1773,183,466,0.39299999999999996,70,212,0.33,113,254,0.445,0.46799999999999997,96,136,0.706,77,374,451,99,60,44,94,102,532
Chris Andersen,C,38,CLE,12,0,114,9,22,0.409,0,3,0.0,9,19,0.474,0.409,10,14,0.7140000000000001,9,22,31,5,5,7,5,20,28
Alan Anderson,SF,34,LAC,30,0,308,30,80,0.375,14,44,0.318,16,36,0.444,0.46299999999999997,12,16,0.75,3,21,24,11,3,0,7,35,86
Justin Anderson,SF,23,TOT,75,10,1228,186,439,0.424,58,194,0.299,128,245,0.522,0.49,102,129,0.7909999999999999,69,176,245,66,41,23,66,109,532
Kyle Anderson,SF,23,SAS,72,14,1020,93,209,0.445,15,40,0.375,78,169,0.462,0.48100000000000004,45,57,0.789,33,175,208,91,51,26,39,63,246
Ryan Anderson,PF,28,HOU,72,72,2116,323,773,0.418,204,506,0.40299999999999997,119,267,0.446,0.55,129,150,0.86,112,218,330,68,31,14,55,142,979
Giannis Antetokounmpo,SF,22,MIL,80,80,2845,656,1259,0.521,49,180,0.272,607,1079,0.563,0.541,471,612,0.77,142,558,700,434,131,151,234,246,1832
Carmelo Anthony,SF,32,NYK,74,74,2538,602,1389,0.433,151,421,0.359,451,968,0.466,0.488,304,365,0.833,62,376,438,213,60,34,153,198,1659
Joel Anthony,C,34,SAS,19,0,122,10,16,0.625,0,0,0.0,10,16,0.625,0.625,5,8,0.625,8,23,31,3,2,6,4,11,25
Trevor Ariza,SF,31,HOU,80,80,2773,326,798,0.409,191,555,0.344,135,243,0.556,0.528,93,126,0.738,54,404,458,175,147,20,73,133,936
Darrell Arthur,PF,28,DEN,41,7,639,95,215,0.442,53,117,0.45299999999999996,42,98,0.429,0.565,19,22,0.8640000000000001,25,87,112,42,19,21,36,76,262
Ömer Aşık,C,30,NOP,31,19,482,31,65,0.47700000000000004,0,0,0.0,31,65,0.47700000000000004,0.47700000000000004,23,39,0.59,48,115,163,15,5,10,14,51,85
D.J. Augustin,PG,29,ORL,78,20,1538,195,517,0.377,95,274,0.34700000000000003,100,243,0.41200000000000003,0.469,131,161,0.8140000000000001,15,102,117,209,31,1,90,101,616
Luke Babbitt,SF,27,MIA,68,55,1065,113,281,0.402,87,210,0.414,26,71,0.366,0.557,11,15,0.733,12,129,141,36,20,11,25,118,324
Ron Baker,SG,23,NYK,52,13,857,82,217,0.37799999999999995,23,86,0.267,59,131,0.45,0.431,28,43,0.6509999999999999,12,86,98,107,34,8,56,74,215
Wade Baldwin,PG,20,MEM,33,1,405,36,115,0.313,3,22,0.136,33,93,0.355,0.326,31,37,0.838,11,35,46,61,18,7,39,40,106
Leandro Barbosa,SG,34,PHO,67,0,963,172,392,0.439,35,98,0.35700000000000004,137,294,0.466,0.483,40,45,0.889,15,89,104,81,31,8,48,82,419
J.J. Barea,PG,32,DAL,35,6,771,142,343,0.414,53,148,0.358,89,195,0.456,0.491,44,51,0.863,9,75,84,193,14,1,63,30,381
Harrison Barnes,PF,24,DAL,79,79,2803,599,1280,0.46799999999999997,78,222,0.35100000000000003,521,1058,0.49200000000000005,0.498,242,281,0.861,93,301,394,116,65,15,102,128,1518
Matt Barnes,SF,36,TOT,74,18,1777,185,473,0.391,87,263,0.331,98,210,0.467,0.483,70,89,0.787,70,314,384,195,48,26,107,185,527
Will Barton,SG,26,DEN,60,19,1705,295,666,0.44299999999999995,87,235,0.37,208,431,0.483,0.508,143,190,0.753,58,201,259,206,48,28,97,110,820
Brandon Bass,PF,31,LAC,52,0,577,107,186,0.575,1,3,0.33299999999999996,106,183,0.579,0.578,77,88,0.875,43,86,129,21,14,11,29,45,292
Nicolas Batum,SG,28,CHO,77,77,2617,393,975,0.40299999999999997,135,405,0.33299999999999996,258,570,0.45299999999999996,0.47200000000000003,243,284,0.856,46,435,481,456,86,29,194,109,1164
Jerryd Bayless,PG,28,PHI,3,1,71,11,32,0.344,2,5,0.4,9,27,0.33299999999999996,0.375,9,10,0.9,3,9,12,13,0,0,9,4,33
Aron Baynes,C,30,DET,75,2,1163,143,279,0.513,0,0,0.0,143,279,0.513,0.513,79,94,0.84,111,222,333,32,17,39,50,166,365
Kent Bazemore,SF,27,ATL,73,64,1963,295,721,0.409,92,266,0.34600000000000003,203,455,0.446,0.473,119,168,0.708,45,186,231,177,91,52,125,165,801
Bradley Beal,SG,23,WAS,77,77,2684,637,1322,0.48200000000000004,223,552,0.40399999999999997,414,770,0.5379999999999999,0.5660000000000001,282,342,0.825,53,187,240,267,83,21,156,169,1779
Malik Beasley,SG,20,DEN,22,1,165,33,73,0.452,9,28,0.321,24,45,0.5329999999999999,0.514,8,10,0.8,5,12,17,11,7,0,8,10,83
Michael Beasley,PF,28,MIL,56,6,935,216,406,0.532,18,43,0.419,198,363,0.545,0.5539999999999999,78,105,0.743,40,153,193,53,27,27,66,92,528
Marco Belinelli,SG,30,CHO,74,0,1778,264,615,0.429,102,283,0.36,162,332,0.488,0.512,150,168,0.893,14,164,178,147,44,9,70,90,780
DeAndre' Bembry,SF,22,ATL,38,1,371,47,98,0.48,1,18,0.055999999999999994,46,80,0.575,0.485,6,16,0.375,14,45,59,28,8,5,16,21,101
Dragan Bender,PF,19,PHO,43,0,574,57,161,0.354,28,101,0.27699999999999997,29,60,0.483,0.441,4,11,0.364,23,80,103,23,10,22,32,74,146
Anthony Bennett,PF,23,BRK,23,1,264,38,92,0.413,13,48,0.271,25,44,0.568,0.484,26,36,0.722,25,53,78,12,5,3,12,18,115
Ben Bentil,PF,21,DAL,3,0,10,0,3,0.0,0,1,0.0,0,2,0.0,0.0,0,0,0.0,0,2,2,0,0,0,1,1,0
Dāvis Bertāns,PF,24,SAS,67,6,808,103,234,0.44,69,173,0.39899999999999997,34,61,0.557,0.588,28,34,0.8240000000000001,22,76,98,46,20,28,32,75,303
Patrick Beverley,SG,28,HOU,67,67,2058,228,543,0.42,110,288,0.382,118,255,0.46299999999999997,0.521,73,95,0.768,95,298,393,281,99,25,100,222,639
Bismack Biyombo,C,24,ORL,81,27,1793,179,339,0.528,0,0,0.0,179,339,0.528,0.528,125,234,0.534,157,410,567,74,25,91,95,202,483
Nemanja Bjelica,PF,28,MIN,65,1,1190,151,356,0.424,56,177,0.316,95,179,0.531,0.503,45,61,0.738,57,187,244,79,40,20,59,154,403
Tarik Black,C,25,LAL,67,16,1091,150,294,0.51,1,2,0.5,149,292,0.51,0.512,82,109,0.752,144,199,343,39,29,44,58,173,383
Eric Bledsoe,PG,27,PHO,66,66,2176,449,1034,0.434,104,310,0.335,345,724,0.47700000000000004,0.485,388,458,0.847,52,268,320,418,91,31,224,164,1390
Bojan Bogdanović,SF,27,TOT,81,54,2083,376,845,0.445,144,392,0.36700000000000005,232,453,0.512,0.53,217,243,0.893,37,240,277,111,34,7,131,146,1113
Andrew Bogut,C,32,TOT,27,21,583,38,81,0.469,0,1,0.0,38,80,0.475,0.469,3,11,0.273,56,162,218,49,13,25,43,86,79
Joel Bolomboy,PF,23,UTA,12,0,53,9,16,0.563,1,4,0.25,8,12,0.667,0.594,3,6,0.5,4,13,17,2,1,2,2,1,22
Devin Booker,SG,20,PHO,78,78,2730,606,1431,0.423,147,405,0.363,459,1026,0.447,0.475,367,441,0.8320000000000001,46,203,249,268,72,21,241,242,1726
Trevor Booker,PF,29,BRK,71,43,1754,305,591,0.516,25,78,0.321,280,513,0.546,0.537,74,110,0.6729999999999999,143,428,571,138,75,28,127,152,709
Avery Bradley,SG,26,BOS,55,55,1835,359,775,0.46299999999999997,108,277,0.39,251,498,0.504,0.5329999999999999,68,93,0.731,65,269,334,122,68,11,88,141,894
Corey Brewer,SF,30,TOT,82,11,1281,147,348,0.42200000000000004,27,118,0.22899999999999998,120,230,0.522,0.461,50,68,0.735,32,134,166,97,61,20,55,133,371
Malcolm Brogdon,SG,24,MIL,75,28,1982,290,635,0.457,78,193,0.40399999999999997,212,442,0.48,0.518,109,126,0.865,47,166,213,317,84,12,113,140,767
Aaron Brooks,PG,32,IND,65,0,894,121,300,0.40299999999999997,48,128,0.375,73,172,0.424,0.483,32,40,0.8,18,51,69,125,25,9,66,93,322
Anthony Brown,SF,24,TOT,11,0,159,18,50,0.36,7,27,0.259,11,23,0.478,0.43,0,0,0.0,8,25,33,8,5,1,6,15,43
Bobby Brown,PG,32,HOU,25,0,123,23,60,0.38299999999999995,14,35,0.4,9,25,0.36,0.5,2,2,1.0,0,6,6,14,1,0,5,5,62
Jaylen Brown,SF,20,BOS,78,20,1341,192,423,0.45399999999999996,46,135,0.341,146,288,0.507,0.508,85,124,0.685,45,175,220,64,35,18,68,142,515
Nicolás Brussino,SG,23,DAL,54,2,521,52,141,0.369,29,95,0.305,23,46,0.5,0.47200000000000003,17,22,0.773,26,69,95,47,17,8,26,43,150
Reggie Bullock,SF,25,DET,31,5,467,54,128,0.42200000000000004,28,73,0.384,26,55,0.473,0.531,5,7,0.7140000000000001,13,51,64,29,18,3,10,22,141
Trey Burke,PG,24,WAS,57,0,703,116,255,0.455,31,70,0.44299999999999995,85,185,0.45899999999999996,0.516,22,29,0.759,7,40,47,100,11,5,48,54,285
Alec Burks,SG,25,UTA,42,0,653,99,248,0.39899999999999997,25,76,0.32899999999999996,74,172,0.43,0.45,60,78,0.769,17,103,120,30,18,5,35,50,283
Jimmy Butler,SF,27,CHI,76,75,2809,570,1252,0.455,91,248,0.36700000000000005,479,1004,0.47700000000000004,0.49200000000000005,585,676,0.865,129,341,470,417,143,32,159,112,1816
Bruno Caboclo,SF,21,TOR,9,0,40,6,16,0.375,2,6,0.33299999999999996,4,10,0.4,0.43799999999999994,0,0,0.0,5,5,10,4,2,1,2,4,14
José Calderón,PG,35,TOT,41,13,539,55,134,0.41,20,64,0.313,35,70,0.5,0.485,11,12,0.917,15,59,74,88,11,1,41,36,141
Kentavious Caldwell-Pope,SG,23,DET,76,75,2529,370,928,0.39899999999999997,153,437,0.35,217,491,0.442,0.48100000000000004,154,185,0.8320000000000001,55,193,248,193,89,12,86,118,1047
Isaiah Canaan,SG,25,CHI,39,0,592,63,173,0.364,25,94,0.266,38,79,0.48100000000000004,0.436,30,33,0.909,6,44,50,37,22,1,21,35,181
Clint Capela,C,22,HOU,65,59,1551,362,563,0.643,0,0,0.0,362,563,0.643,0.643,94,177,0.531,178,348,526,63,34,79,87,179,818
DeMarre Carroll,SF,30,TOR,72,72,1882,220,550,0.4,109,320,0.341,111,230,0.483,0.499,89,117,0.7609999999999999,63,212,275,74,81,27,54,143,638
Vince Carter,SF,40,MEM,73,15,1799,193,490,0.39399999999999996,112,296,0.37799999999999995,81,194,0.418,0.508,88,115,0.765,36,191,227,133,60,36,50,163,586
Michael Carter-Williams,PG,25,CHI,45,19,846,112,306,0.366,15,64,0.23399999999999999,97,242,0.401,0.391,58,77,0.753,24,129,153,113,38,23,66,102,297
Omri Casspi,PF,28,TOT,36,2,643,77,164,0.47,15,43,0.349,62,121,0.512,0.515,17,29,0.586,27,85,112,37,23,3,29,50,186
Willie Cauley-Stein,C,23,SAC,75,21,1421,255,481,0.53,0,2,0.0,255,479,0.532,0.53,101,151,0.669,85,254,339,80,53,44,69,147,611
Tyson Chandler,C,34,PHO,47,46,1298,153,228,0.6709999999999999,0,0,0.0,153,228,0.6709999999999999,0.6709999999999999,91,124,0.7340000000000001,153,386,539,30,33,24,65,126,397
Wilson Chandler,SF,29,DEN,71,33,2197,433,939,0.461,110,326,0.337,323,613,0.527,0.52,141,194,0.727,103,357,460,141,51,30,114,172,1117
Marquese Chriss,PF,19,PHO,82,75,1743,284,632,0.449,72,224,0.321,212,408,0.52,0.506,113,181,0.624,96,252,348,60,67,70,108,263,753
Rakeem Christmas,PF,25,IND,29,0,219,19,43,0.442,0,0,0.0,19,43,0.442,0.442,21,29,0.7240000000000001,26,30,56,4,3,6,8,37,59
Semaj Christon,PG,24,OKC,64,1,973,77,223,0.345,12,63,0.19,65,160,0.406,0.37200000000000005,17,31,0.5479999999999999,19,68,87,130,28,7,43,79,183
Ian Clark,SG,25,GSW,77,0,1137,211,433,0.48700000000000004,61,163,0.374,150,270,0.556,0.5579999999999999,44,58,0.759,22,99,121,90,39,8,55,77,527
Jordan Clarkson,SG,24,LAL,82,19,2397,477,1071,0.445,117,356,0.32899999999999996,360,715,0.503,0.5,134,168,0.7979999999999999,49,197,246,213,88,8,164,150,1205
Norris Cole,PG,28,OKC,13,0,125,16,52,0.308,3,13,0.231,13,39,0.33299999999999996,0.337,8,10,0.8,0,11,11,14,8,0,7,18,43
Darren Collison,PG,29,SAC,68,64,2063,340,714,0.47600000000000003,73,175,0.41700000000000004,267,539,0.495,0.527,147,171,0.86,23,129,152,312,67,9,114,119,900
Nick Collison,PF,36,OKC,20,0,128,14,23,0.609,0,1,0.0,14,22,0.636,0.609,5,8,0.625,9,22,31,12,2,2,4,17,33
Mike Conley,PG,29,MEM,69,68,2292,464,1009,0.46,171,419,0.408,293,590,0.49700000000000005,0.545,316,368,0.8590000000000001,31,210,241,433,92,19,156,126,1415
Pat Connaughton,SG,24,POR,39,1,316,37,72,0.514,17,33,0.515,20,39,0.513,0.632,7,9,0.778,10,42,52,28,6,2,17,23,98
Quinn Cook,PG,23,TOT,14,0,188,33,66,0.5,11,26,0.423,22,40,0.55,0.583,2,5,0.4,1,6,7,26,4,0,13,13,79
DeMarcus Cousins,C,26,TOT,72,72,2465,647,1432,0.452,131,363,0.361,516,1069,0.483,0.498,517,670,0.772,152,642,794,332,100,93,269,278,1942
Robert Covington,SF,26,PHI,67,67,2119,292,732,0.39899999999999997,137,412,0.33299999999999996,155,320,0.484,0.49200000000000005,143,174,0.8220000000000001,92,344,436,102,127,69,131,203,864
Allen Crabbe,SG,24,POR,79,7,2254,303,647,0.46799999999999997,134,302,0.444,169,345,0.49,0.5720000000000001,105,124,0.847,19,207,226,94,54,20,62,171,845
Jamal Crawford,SG,36,LAC,82,1,2157,359,870,0.413,116,322,0.36,243,548,0.44299999999999995,0.479,174,203,0.857,17,112,129,214,61,14,134,115,1008
Jordan Crawford,SG,28,NOP,19,0,442,105,218,0.48200000000000004,37,95,0.389,68,123,0.5529999999999999,0.5670000000000001,20,26,0.769,4,30,34,57,11,2,25,30,267
Jae Crowder,SF,26,BOS,72,72,2335,333,720,0.46299999999999997,157,394,0.39799999999999996,176,326,0.54,0.5720000000000001,176,217,0.8109999999999999,48,367,415,155,73,23,80,161,999
Dante Cunningham,PF,29,NOP,66,35,1649,174,359,0.485,71,181,0.392,103,178,0.579,0.584,16,27,0.593,56,221,277,37,39,28,28,100,435
Seth Curry,PG,26,DAL,70,42,2029,338,703,0.48100000000000004,137,322,0.425,201,381,0.528,0.578,85,100,0.85,25,154,179,189,79,7,92,126,898
Stephen Curry,PG,28,GSW,79,79,2638,675,1443,0.46799999999999997,324,789,0.41100000000000003,351,654,0.537,0.58,325,362,0.898,61,292,353,524,142,17,239,183,1999
Troy Daniels,SG,25,MEM,67,3,1183,185,495,0.374,138,355,0.389,47,140,0.336,0.513,43,54,0.7959999999999999,22,78,100,46,20,4,45,90,551
Anthony Davis,C,23,NOP,75,75,2708,770,1526,0.505,40,134,0.299,730,1392,0.524,0.518,519,647,0.802,172,712,884,157,94,167,181,168,2099
Deyonta Davis,C,20,MEM,36,0,238,24,47,0.511,0,0,0.0,24,47,0.511,0.511,10,18,0.556,20,40,60,2,3,17,8,40,58
Ed Davis,PF,27,POR,46,12,789,75,142,0.528,0,0,0.0,75,142,0.528,0.528,50,81,0.617,96,148,244,26,15,22,37,137,200
Dewayne Dedmon,C,27,SAS,76,37,1330,161,259,0.622,0,0,0.0,161,259,0.622,0.622,65,93,0.6990000000000001,129,367,496,44,37,61,61,180,387
Sam Dekker,PF,22,HOU,77,2,1419,203,429,0.473,60,187,0.321,143,242,0.591,0.5429999999999999,38,68,0.5589999999999999,94,190,284,76,38,21,41,83,504
Malcolm Delaney,PG,27,ATL,73,2,1248,145,388,0.374,26,110,0.23600000000000002,119,278,0.428,0.40700000000000003,75,93,0.8059999999999999,10,113,123,193,39,1,95,112,391
Matthew Dellavedova,PG,26,MIL,76,54,1986,208,534,0.39,79,215,0.36700000000000005,129,319,0.40399999999999997,0.46299999999999997,82,96,0.8540000000000001,24,123,147,357,53,0,133,153,577
Luol Deng,SF,31,LAL,56,49,1486,164,424,0.387,51,165,0.309,113,259,0.436,0.447,46,63,0.73,63,232,295,74,48,20,43,61,425
DeMar DeRozan,SG,27,TOR,74,74,2620,721,1545,0.467,33,124,0.266,688,1421,0.484,0.47700000000000004,545,647,0.8420000000000001,70,316,386,290,78,13,180,134,2020
Cheick Diallo,PF,20,NOP,17,0,199,36,76,0.474,0,0,0.0,36,76,0.474,0.474,15,21,0.7140000000000001,23,50,73,4,4,7,7,17,87
Boris Diaw,PF,34,UTA,73,33,1283,146,327,0.446,20,81,0.247,126,246,0.512,0.47700000000000004,26,35,0.743,46,112,158,170,18,9,87,83,338
Gorgui Dieng,PF,27,MIN,82,82,2653,332,661,0.502,16,43,0.37200000000000005,316,618,0.511,0.514,136,167,0.8140000000000001,188,459,647,158,88,95,107,254,816
Spencer Dinwiddie,PG,23,BRK,59,18,1334,134,302,0.444,38,101,0.376,96,201,0.478,0.507,126,159,0.792,27,137,164,185,44,23,66,119,432
Toney Douglas,PG,30,MEM,24,0,394,43,117,0.368,7,42,0.16699999999999998,36,75,0.48,0.397,24,29,0.828,13,48,61,56,18,5,21,50,117
Goran Dragić,PG,30,MIA,73,73,2459,534,1124,0.475,117,289,0.405,417,835,0.499,0.527,298,377,0.79,62,217,279,423,89,13,212,199,1483
Andre Drummond,C,23,DET,81,81,2409,483,911,0.53,2,7,0.28600000000000003,481,904,0.532,0.531,137,355,0.386,345,770,1115,90,124,89,152,237,1105
Jared Dudley,PF,31,PHO,64,7,1362,157,346,0.45399999999999996,77,203,0.379,80,143,0.5589999999999999,0.565,43,65,0.662,31,194,225,121,42,16,73,154,434
Mike Dunleavy,SF,36,TOT,53,2,841,93,220,0.423,53,134,0.396,40,86,0.465,0.5429999999999999,36,45,0.8,18,97,115,50,15,7,28,67,275
Kris Dunn,PG,22,MIN,78,7,1333,118,313,0.377,21,73,0.28800000000000003,97,240,0.40399999999999997,0.41100000000000003,36,59,0.61,24,142,166,188,78,36,89,178,293
Kevin Durant,PF,28,GSW,62,62,2070,551,1026,0.537,117,312,0.375,434,714,0.608,0.594,336,384,0.875,39,474,513,300,66,99,138,117,1555
Jarell Eddie,SF,25,PHO,5,0,62,6,19,0.316,4,16,0.25,2,3,0.667,0.42100000000000004,8,9,0.889,1,6,7,0,1,0,1,1,24
Henry Ellenson,PF,20,DET,19,2,146,23,64,0.359,10,35,0.28600000000000003,13,29,0.44799999999999995,0.43799999999999994,4,8,0.5,8,33,41,7,1,1,14,6,60
Wayne Ellington,SG,29,MIA,62,13,1500,231,555,0.41600000000000004,149,394,0.37799999999999995,82,161,0.509,0.55,37,43,0.86,18,114,132,70,35,4,30,70,648
Monta Ellis,SG,31,IND,74,33,1998,247,557,0.44299999999999995,43,135,0.319,204,422,0.483,0.48200000000000004,93,128,0.727,19,185,204,236,78,27,135,149,630
Joel Embiid,C,22,PHI,31,31,786,200,429,0.466,36,98,0.36700000000000005,164,331,0.495,0.508,191,244,0.7829999999999999,61,182,243,66,27,76,117,112,627
James Ennis,SF,26,MEM,64,28,1501,146,321,0.455,51,137,0.37200000000000005,95,184,0.516,0.534,86,110,0.782,69,190,259,64,46,19,59,165,429
Tyler Ennis,PG,22,TOT,53,2,588,90,208,0.433,27,70,0.386,63,138,0.457,0.498,21,25,0.84,9,36,45,86,25,2,45,58,228
Tyreke Evans,SF,27,TOT,40,6,788,150,370,0.405,42,118,0.35600000000000004,108,252,0.429,0.462,69,92,0.75,13,124,137,124,35,9,61,60,411
Dante Exum,PG,21,UTA,66,26,1228,155,363,0.42700000000000005,44,149,0.295,111,214,0.519,0.488,58,73,0.795,30,102,132,111,21,12,80,146,412
Kenneth Faried,PF,27,DEN,61,34,1296,228,416,0.5479999999999999,0,6,0.0,228,410,0.556,0.5479999999999999,131,189,0.693,183,279,462,55,43,40,59,124,587
Jordan Farmar,PG,30,SAC,2,0,35,4,12,0.33299999999999996,4,9,0.444,0,3,0.0,0.5,0,0,0.0,1,2,3,9,2,0,3,1,12
Derrick Favors,PF,25,UTA,50,39,1186,203,417,0.48700000000000004,3,10,0.3,200,407,0.491,0.49,67,109,0.615,92,213,305,56,45,40,60,103,476
Kay Felder,PG,21,CLE,42,0,386,62,158,0.392,7,22,0.318,55,136,0.40399999999999997,0.415,35,49,0.7140000000000001,3,38,41,58,18,7,30,38,166
Cristiano Felício,C,24,CHI,66,0,1040,128,221,0.579,0,0,0.0,128,221,0.579,0.579,60,93,0.645,124,187,311,40,25,17,33,110,316
Raymond Felton,PG,32,LAC,80,11,1700,221,514,0.43,46,144,0.319,175,370,0.473,0.475,50,64,0.7809999999999999,33,185,218,191,66,22,83,125,538
Yogi Ferrell,PG,23,TOT,46,29,1197,160,394,0.406,68,176,0.386,92,218,0.42200000000000004,0.49200000000000005,74,89,0.831,20,91,111,172,42,9,70,90,462
Dorian Finney-Smith,PF,23,DAL,81,35,1642,124,333,0.37200000000000005,56,191,0.293,68,142,0.479,0.456,46,61,0.754,55,167,222,67,52,25,45,125,350
Bryn Forbes,SG,23,SAS,36,0,285,36,99,0.364,17,53,0.321,19,46,0.413,0.449,5,6,0.833,2,21,23,23,1,0,11,20,94
Evan Fournier,SG,24,ORL,68,66,2234,408,930,0.439,128,360,0.35600000000000004,280,570,0.491,0.508,223,277,0.805,44,165,209,202,66,4,141,180,1167
Randy Foye,SG,33,BRK,69,40,1284,118,325,0.363,67,203,0.33,51,122,0.418,0.466,54,63,0.857,9,146,155,135,35,9,80,99,357
Tim Frazier,PG,26,NOP,65,35,1525,163,404,0.40299999999999997,40,128,0.313,123,276,0.446,0.45299999999999996,98,129,0.76,34,139,173,335,56,6,101,133,464
Channing Frye,C,33,CLE,74,15,1398,238,520,0.45799999999999996,137,335,0.409,101,185,0.546,0.589,63,74,0.851,37,253,290,45,33,37,53,138,676
Danilo Gallinari,SF,28,DEN,63,63,2134,335,750,0.447,126,324,0.389,209,426,0.491,0.531,349,387,0.902,39,286,325,135,40,15,82,93,1145
Langston Galloway,PG,25,TOT,74,2,1495,207,545,0.38,120,308,0.39,87,237,0.36700000000000005,0.49,51,64,0.797,27,129,156,93,46,6,46,96,585
Patricio Garino,SG,23,ORL,5,0,43,0,7,0.0,0,5,0.0,0,2,0.0,0.0,0,0,0.0,1,6,7,0,0,0,3,4,0
Marc Gasol,C,32,MEM,74,74,2531,532,1160,0.45899999999999996,104,268,0.38799999999999996,428,892,0.48,0.503,278,332,0.8370000000000001,60,404,464,338,67,99,166,171,1446
Pau Gasol,C,36,SAS,64,39,1627,303,604,0.502,56,104,0.5379999999999999,247,500,0.494,0.5479999999999999,130,184,0.7070000000000001,107,394,501,150,24,70,81,110,792
Rudy Gay,SF,30,SAC,30,30,1013,201,442,0.455,42,113,0.37200000000000005,159,329,0.483,0.502,118,138,0.855,35,155,190,83,44,26,74,79,562
Michael Gbinije,SG,24,DET,9,0,32,1,10,0.1,0,4,0.0,1,6,0.16699999999999998,0.1,2,2,1.0,2,1,3,2,0,0,0,2,4
Alonzo Gee,SF,29,DEN,13,0,89,3,14,0.214,0,3,0.0,3,11,0.273,0.214,5,9,0.556,4,11,15,6,5,1,4,14,11
Paul George,SF,26,IND,75,75,2689,622,1348,0.461,195,496,0.39299999999999996,427,852,0.501,0.534,336,374,0.898,58,434,492,251,119,27,220,206,1775
Marcus Georges-Hunt,SG,22,ORL,5,0,48,2,7,0.28600000000000003,1,2,0.5,1,5,0.2,0.35700000000000004,9,10,0.9,1,8,9,3,1,0,2,5,14
Jonathan Gibson,PG,29,DAL,17,0,231,35,95,0.368,15,45,0.33299999999999996,20,50,0.4,0.447,21,29,0.7240000000000001,1,21,22,26,8,0,21,21,106
Taj Gibson,PF,31,TOT,78,71,1989,365,709,0.515,3,13,0.231,362,696,0.52,0.517,113,158,0.715,158,327,485,73,41,65,105,163,846
Manu Ginóbili,SG,39,SAS,69,0,1291,171,439,0.39,89,227,0.392,82,212,0.387,0.491,86,107,0.804,28,129,157,183,82,16,96,119,517
Rudy Gobert,C,24,UTA,81,81,2744,413,625,0.6609999999999999,0,1,0.0,413,624,0.662,0.6609999999999999,311,476,0.653,314,721,1035,97,49,214,147,246,1137
Archie Goodwin,SG,22,TOT,15,0,214,36,66,0.545,5,15,0.33299999999999996,31,51,0.608,0.583,33,42,0.7859999999999999,7,21,28,24,4,5,14,8,110
Aaron Gordon,SF,21,ORL,80,72,2298,393,865,0.45399999999999996,77,267,0.28800000000000003,316,598,0.528,0.499,156,217,0.7190000000000001,116,289,405,150,65,40,89,172,1019
Eric Gordon,SG,28,HOU,75,15,2323,412,1016,0.406,246,661,0.37200000000000005,166,355,0.46799999999999997,0.527,147,175,0.84,29,172,201,188,48,41,121,150,1217
Marcin Gortat,C,32,WAS,82,82,2556,390,674,0.579,0,2,0.0,390,672,0.58,0.579,103,159,0.648,238,611,849,121,40,61,119,213,883
Treveon Graham,SG,23,CHO,27,1,189,19,40,0.475,9,15,0.6,10,25,0.4,0.588,10,15,0.667,5,17,22,6,6,1,3,18,57
Jerami Grant,PF,22,TOT,80,4,1531,152,328,0.46299999999999997,43,116,0.371,109,212,0.514,0.529,90,147,0.612,38,167,205,46,33,79,44,149,437
Jerian Grant,PG,24,CHI,63,28,1028,128,301,0.425,49,134,0.366,79,167,0.473,0.507,65,73,0.89,17,94,111,121,47,8,44,93,370
Danny Green,SG,29,SAS,68,68,1807,176,449,0.392,118,311,0.379,58,138,0.42,0.523,27,32,0.8440000000000001,31,193,224,124,70,57,76,120,497
Draymond Green,PF,26,GSW,76,76,2471,272,650,0.418,81,263,0.308,191,387,0.494,0.48100000000000004,151,213,0.7090000000000001,98,501,599,533,154,106,184,217,776
Gerald Green,SF,31,BOS,47,0,538,95,232,0.409,39,111,0.35100000000000003,56,121,0.46299999999999997,0.494,33,41,0.805,16,68,84,33,9,7,25,48,262
JaMychal Green,PF,26,MEM,77,75,2101,250,500,0.5,55,145,0.379,195,355,0.5489999999999999,0.555,134,167,0.802,167,377,544,84,47,34,94,248,689
Jeff Green,PF,30,ORL,69,11,1534,220,558,0.39399999999999996,53,193,0.275,167,365,0.45799999999999996,0.442,145,168,0.863,39,175,214,81,37,13,75,103,638
Blake Griffin,PF,27,LAC,61,61,2076,479,971,0.493,38,113,0.336,441,858,0.514,0.513,320,421,0.76,112,385,497,300,57,22,142,157,1316
Justin Hamilton,C,26,BRK,64,7,1177,174,379,0.45899999999999996,55,180,0.306,119,199,0.598,0.532,39,52,0.75,71,191,262,55,29,43,43,91,442
A.J. Hammons,C,24,DAL,22,0,163,17,42,0.405,5,10,0.5,12,32,0.375,0.46399999999999997,9,20,0.45,8,28,36,4,1,13,10,21,48
Tim Hardaway,SG,24,ATL,79,30,2154,415,912,0.455,149,417,0.35700000000000004,266,495,0.537,0.537,164,214,0.7659999999999999,35,189,224,182,55,15,106,103,1143
James Harden,PG,27,HOU,81,81,2947,674,1533,0.44,262,756,0.34700000000000003,412,777,0.53,0.525,746,881,0.847,95,564,659,907,121,38,464,215,2356
Maurice Harkless,SF,23,POR,77,69,2223,314,624,0.503,68,194,0.35100000000000003,246,430,0.5720000000000001,0.5579999999999999,77,124,0.621,125,216,341,88,85,70,86,214,773
Justin Harper,PF,27,PHI,3,0,31,5,12,0.41700000000000004,2,7,0.28600000000000003,3,5,0.6,0.5,0,0,0.0,2,3,5,2,0,0,4,2,12
Montrezl Harrell,C,23,HOU,58,14,1064,225,345,0.652,1,7,0.14300000000000002,224,338,0.6629999999999999,0.654,76,121,0.628,81,138,219,64,20,42,44,126,527
Devin Harris,PG,33,DAL,65,0,1087,136,341,0.39899999999999997,58,177,0.32799999999999996,78,164,0.47600000000000003,0.484,107,129,0.8290000000000001,11,116,127,136,43,7,57,101,437
Gary Harris,SG,22,DEN,57,56,1782,320,637,0.502,107,255,0.42,213,382,0.5579999999999999,0.586,104,134,0.7759999999999999,48,130,178,164,71,8,76,92,851
Joe Harris,SG,25,BRK,52,11,1138,154,362,0.425,85,221,0.385,69,141,0.489,0.5429999999999999,35,49,0.7140000000000001,16,131,147,54,30,8,55,121,428
Manny Harris,SG,27,DAL,4,0,25,3,15,0.2,0,2,0.0,3,13,0.231,0.2,2,4,0.5,3,6,9,2,0,0,2,1,8
Tobias Harris,PF,24,DET,82,48,2567,511,1063,0.48100000000000004,109,314,0.34700000000000003,402,749,0.537,0.532,190,226,0.841,63,353,416,142,60,39,96,133,1321
Aaron Harrison,SG,22,CHO,5,0,17,0,4,0.0,0,2,0.0,0,2,0.0,0.0,1,2,0.5,0,3,3,3,0,0,0,2,1
Andrew Harrison,PG,22,MEM,72,18,1474,117,360,0.325,43,156,0.276,74,204,0.363,0.385,148,194,0.763,23,113,136,198,53,21,85,194,425
Udonis Haslem,C,36,MIA,16,0,130,11,23,0.478,0,3,0.0,11,20,0.55,0.478,9,15,0.6,8,28,36,6,6,1,8,22,31
Spencer Hawes,PF,28,TOT,54,1,797,134,277,0.484,25,81,0.309,109,196,0.556,0.529,44,52,0.846,38,153,191,81,15,30,49,77,337
Gordon Hayward,SF,26,UTA,73,73,2516,545,1156,0.47100000000000003,149,374,0.39799999999999996,396,782,0.506,0.536,362,429,0.8440000000000001,49,345,394,252,73,20,140,117,1601
Gerald Henderson,SG,29,PHI,72,41,1667,234,553,0.423,61,173,0.353,173,380,0.455,0.478,133,165,0.8059999999999999,34,151,185,112,40,15,62,129,662
John Henson,C,26,MIL,58,39,1123,159,309,0.515,0,1,0.0,159,308,0.516,0.515,74,107,0.6920000000000001,92,203,295,57,29,78,52,151,392
Juan Hernangómez,PF,21,DEN,62,9,842,101,224,0.451,46,113,0.40700000000000003,55,111,0.495,0.5539999999999999,57,76,0.75,43,144,187,29,30,12,31,62,305
Willy Hernangómez,C,22,NYK,72,22,1324,246,465,0.529,4,15,0.267,242,450,0.5379999999999999,0.5329999999999999,91,125,0.728,170,332,502,96,41,36,100,150,587
Mario Hezonja,SF,21,ORL,65,2,960,117,330,0.355,43,144,0.299,74,186,0.39799999999999996,0.42,40,50,0.8,20,126,146,62,30,15,58,74,317
Roy Hibbert,C,30,TOT,48,13,682,80,147,0.544,0,0,0.0,80,147,0.544,0.544,61,75,0.813,54,98,152,21,8,46,32,100,221
Buddy Hield,SG,24,TOT,82,55,1888,327,767,0.426,148,379,0.391,179,388,0.461,0.523,64,76,0.8420000000000001,35,234,269,121,38,9,101,115,866
Nenê Hilário,C,34,HOU,67,8,1198,245,397,0.617,3,9,0.33299999999999996,242,388,0.624,0.621,116,197,0.589,95,187,282,65,56,39,73,163,609
George Hill,PG,30,UTA,49,49,1544,289,606,0.47700000000000004,94,233,0.40299999999999997,195,373,0.523,0.5539999999999999,157,196,0.8009999999999999,23,144,167,204,50,11,85,114,829
Jordan Hill,C,29,MIN,7,0,47,5,13,0.385,0,0,0.0,5,13,0.385,0.385,2,2,1.0,8,6,14,0,1,0,4,9,12
Solomon Hill,SF,25,NOP,80,71,2374,183,478,0.38299999999999995,94,270,0.348,89,208,0.428,0.48100000000000004,103,128,0.805,51,256,307,141,72,32,82,182,563
Darrun Hilliard,SG,23,DET,39,1,381,47,126,0.373,12,46,0.261,35,80,0.43799999999999994,0.42100000000000004,21,28,0.75,2,31,33,33,11,2,28,39,127
Jrue Holiday,PG,26,NOP,67,61,2190,405,893,0.45399999999999996,100,281,0.35600000000000004,305,612,0.498,0.51,119,168,0.708,46,218,264,488,100,44,194,133,1029
Justin Holiday,SG,27,NYK,82,4,1639,233,538,0.433,97,273,0.355,136,265,0.513,0.523,66,80,0.825,27,198,225,102,65,31,66,109,629
Rondae Hollis-Jefferson,SF,22,BRK,78,50,1761,235,542,0.434,15,67,0.22399999999999998,220,475,0.46299999999999997,0.447,190,253,0.7509999999999999,96,356,452,154,82,44,116,177,675
Richaun Holmes,C,23,PHI,57,17,1193,230,412,0.5579999999999999,27,77,0.35100000000000003,203,335,0.606,0.591,72,103,0.6990000000000001,94,217,311,58,42,55,55,136,559
Rodney Hood,SG,24,UTA,59,55,1593,272,666,0.408,114,307,0.371,158,359,0.44,0.494,90,115,0.7829999999999999,16,186,202,96,38,11,65,132,748
Al Horford,C,30,BOS,68,68,2193,379,801,0.473,86,242,0.355,293,559,0.524,0.527,108,135,0.8,95,370,465,337,52,86,115,138,952
Danuel House,SG,23,WAS,1,0,1,0,0,0.0,0,0,0.0,0,0,0.0,0.0,0,0,0.0,0,1,1,0,0,0,0,0,0
Dwight Howard,C,31,ATL,74,74,2199,388,613,0.633,0,2,0.0,388,611,0.635,0.633,226,424,0.5329999999999999,296,644,940,104,64,92,170,203,1002
Marcelo Huertas,PG,33,LAL,23,1,237,25,68,0.368,4,19,0.21100000000000002,21,49,0.429,0.397,9,17,0.529,2,22,24,52,10,2,19,16,63
Josh Huestis,PF,25,OKC,2,0,31,6,11,0.545,2,4,0.5,4,7,0.5710000000000001,0.636,0,1,0.0,4,5,9,3,0,3,0,0,14
Kris Humphries,PF,31,ATL,56,4,689,87,214,0.40700000000000003,19,54,0.35200000000000004,68,160,0.425,0.451,64,82,0.78,60,146,206,29,15,21,28,69,257
R.J. Hunter,SG,23,CHI,3,0,9,0,1,0.0,0,1,0.0,0,0,0.0,0.0,0,0,0.0,0,1,1,0,0,0,0,0,0
Serge Ibaka,PF,27,TOT,79,79,2422,471,982,0.48,124,317,0.391,347,665,0.522,0.5429999999999999,107,125,0.856,129,409,538,75,41,124,105,215,1173
Andre Iguodala,SF,33,GSW,76,0,1998,219,415,0.528,64,177,0.36200000000000004,155,238,0.6509999999999999,0.605,72,102,0.706,51,253,304,261,76,39,58,97,574
Ersan İlyasova,PF,29,TOT,82,52,2142,384,890,0.431,142,402,0.353,242,488,0.496,0.511,161,207,0.778,115,366,481,141,58,23,116,211,1071
Joe Ingles,SF,29,UTA,82,26,1972,204,451,0.452,123,279,0.441,81,172,0.47100000000000003,0.589,50,68,0.735,23,238,261,225,96,8,107,163,581
Brandon Ingram,SF,19,LAL,79,40,2279,276,686,0.402,55,187,0.294,221,499,0.44299999999999995,0.442,133,214,0.621,60,256,316,166,50,36,116,158,740
Kyrie Irving,PG,24,CLE,72,72,2525,671,1420,0.473,177,441,0.401,494,979,0.505,0.535,297,328,0.905,52,178,230,418,83,24,180,157,1816
Jarrett Jack,PG,33,NOP,2,0,33,2,3,0.667,0,1,0.0,2,2,1.0,0.667,2,2,1.0,0,0,0,5,2,0,3,4,6
Demetrius Jackson,PG,22,BOS,5,0,17,3,4,0.75,1,1,1.0,2,3,0.667,0.875,3,6,0.5,2,2,4,3,0,0,0,0,10
Pierre Jackson,PG,25,DAL,8,1,84,13,39,0.33299999999999996,3,11,0.273,10,28,0.35700000000000004,0.37200000000000005,6,7,0.857,1,8,9,19,2,0,3,5,35
Reggie Jackson,PG,26,DET,52,50,1424,284,677,0.419,66,184,0.359,218,493,0.442,0.46799999999999997,118,136,0.868,21,93,114,270,35,5,114,129,752
LeBron James,SF,32,CLE,74,74,2794,736,1344,0.5479999999999999,124,342,0.363,612,1002,0.611,0.594,358,531,0.674,97,542,639,646,92,44,303,134,1954
Al Jefferson,C,32,IND,66,1,931,235,471,0.499,0,1,0.0,235,470,0.5,0.499,65,85,0.765,75,203,278,57,19,16,33,125,535
Richard Jefferson,SF,36,CLE,79,13,1614,153,343,0.446,62,186,0.33299999999999996,91,157,0.58,0.536,80,108,0.741,28,175,203,78,26,10,52,153,448
John Jenkins,SG,25,PHO,4,0,13,2,5,0.4,1,2,0.5,1,3,0.33299999999999996,0.5,2,2,1.0,0,1,1,1,0,0,0,0,7
Brandon Jennings,PG,27,TOT,81,13,1802,192,535,0.359,79,252,0.313,113,283,0.39899999999999997,0.433,114,152,0.75,29,167,196,395,70,4,128,116,577
Jonas Jerebko,PF,29,BOS,78,6,1232,114,262,0.435,45,130,0.34600000000000003,69,132,0.523,0.521,26,37,0.703,59,213,272,71,25,17,39,122,299
Amir Johnson,PF,29,BOS,80,77,1608,213,370,0.5760000000000001,27,66,0.409,186,304,0.612,0.612,67,100,0.67,118,248,366,140,51,62,77,211,520
Brice Johnson,PF,22,LAC,3,0,9,2,7,0.28600000000000003,0,0,0.0,2,7,0.28600000000000003,0.28600000000000003,0,0,0.0,1,2,3,1,2,1,1,0,4
James Johnson,PF,29,MIA,76,5,2085,368,769,0.479,87,256,0.34,281,513,0.5479999999999999,0.535,152,215,0.7070000000000001,66,310,376,276,76,86,171,197,975
Joe Johnson,SF,35,UTA,78,14,1843,273,626,0.436,106,258,0.41100000000000003,167,368,0.45399999999999996,0.521,63,77,0.818,33,210,243,144,36,18,69,93,715
Stanley Johnson,SF,20,DET,77,1,1371,129,365,0.353,45,154,0.292,84,211,0.39799999999999996,0.415,36,53,0.679,36,153,189,105,56,24,71,121,339
Tyler Johnson,PG,24,MIA,73,0,2178,357,824,0.433,93,250,0.37200000000000005,264,574,0.46,0.49,195,254,0.768,50,243,293,233,84,44,90,176,1002
Wesley Johnson,SF,29,LAC,68,3,810,73,200,0.365,29,118,0.24600000000000002,44,82,0.537,0.43799999999999994,11,17,0.647,26,155,181,23,29,30,18,83,186
Nikola Jokić,C,21,DEN,73,59,2038,494,854,0.578,45,139,0.324,449,715,0.628,0.605,188,228,0.825,212,506,718,359,61,55,171,214,1221
Dahntay Jones,SF,36,CLE,1,0,12,3,8,0.375,0,2,0.0,3,6,0.5,0.375,3,4,0.75,1,1,2,1,0,0,1,1,9
Damian Jones,C,21,GSW,10,0,85,8,16,0.5,0,0,0.0,8,16,0.5,0.5,3,10,0.3,9,14,23,0,1,4,6,15,19
Derrick Jones,SF,19,PHO,32,8,545,68,121,0.562,3,11,0.273,65,110,0.591,0.574,29,41,0.7070000000000001,39,40,79,12,14,13,13,63,168
James Jones,SF,36,CLE,48,2,381,44,92,0.478,31,66,0.47,13,26,0.5,0.647,13,20,0.65,3,34,37,14,6,10,10,37,132
Terrence Jones,PF,25,TOT,54,12,1270,231,492,0.47,19,75,0.253,212,417,0.508,0.489,103,170,0.606,65,241,306,59,40,54,48,67,584
Tyus Jones,PG,20,MIN,60,0,774,75,181,0.414,26,73,0.35600000000000004,49,108,0.45399999999999996,0.486,33,43,0.767,10,57,67,156,48,5,38,50,209
DeAndre Jordan,C,28,LAC,81,81,2570,412,577,0.7140000000000001,0,2,0.0,412,575,0.7170000000000001,0.7140000000000001,205,425,0.48200000000000004,298,816,1114,96,51,134,115,212,1029
Cory Joseph,PG,25,TOR,80,22,2003,299,661,0.452,48,135,0.35600000000000004,251,526,0.47700000000000004,0.489,94,122,0.77,51,184,235,265,66,13,108,140,740
Frank Kaminsky,C,23,CHO,75,16,1954,320,802,0.39899999999999997,116,354,0.32799999999999996,204,448,0.455,0.47100000000000003,118,156,0.7559999999999999,57,279,336,162,46,34,76,139,874
Enes Kanter,C,24,OKC,72,0,1533,402,737,0.545,5,38,0.132,397,699,0.568,0.5489999999999999,224,285,0.7859999999999999,195,287,482,67,32,38,123,154,1033
Ryan Kelly,PF,25,ATL,16,0,110,8,28,0.28600000000000003,4,10,0.4,4,18,0.222,0.35700000000000004,5,6,0.833,1,17,18,8,4,5,4,5,25
Michael Kidd-Gilchrist,SF,23,CHO,81,81,2349,295,618,0.47700000000000004,1,9,0.111,294,609,0.483,0.478,152,194,0.784,156,409,565,114,81,77,56,187,743
Sean Kilpatrick,SG,27,BRK,70,24,1754,305,735,0.415,105,308,0.341,200,427,0.46799999999999997,0.486,204,242,0.843,22,258,280,157,45,6,135,118,919
Brandon Knight,SG,25,PHO,54,5,1140,209,525,0.39799999999999996,45,139,0.324,164,386,0.425,0.441,132,154,0.857,25,93,118,130,27,5,88,87,595
Kyle Korver,SG,35,TOT,67,22,1753,239,515,0.46399999999999997,162,359,0.451,77,156,0.494,0.621,38,42,0.905,7,179,186,110,34,21,69,107,678
Kosta Koufos,C,27,SAC,71,62,1419,216,392,0.551,0,1,0.0,216,391,0.552,0.551,38,62,0.613,118,285,403,47,36,48,61,172,470
Mindaugas Kuzminskas,SF,27,NYK,68,5,1016,158,369,0.428,54,168,0.321,104,201,0.517,0.501,55,68,0.809,47,79,126,69,29,11,51,79,425
Skal Labissière,PF,20,SAC,33,12,612,117,218,0.537,3,8,0.375,114,210,0.5429999999999999,0.544,52,74,0.703,51,111,162,27,16,13,37,64,289
Jeremy Lamb,SG,24,CHO,62,5,1143,226,491,0.46,41,146,0.281,185,345,0.536,0.502,110,129,0.853,30,234,264,75,27,23,40,98,603
Nicolás Laprovíttola,PG,27,SAS,18,3,174,20,47,0.426,10,27,0.37,10,20,0.5,0.532,9,9,1.0,1,9,10,28,4,1,19,19,59
Joffrey Lauvergne,PF-C,25,TOT,70,1,980,148,336,0.44,33,98,0.337,115,238,0.483,0.49,46,73,0.63,72,179,251,70,25,6,56,83,375
Zach LaVine,SG,21,MIN,47,47,1749,326,710,0.45899999999999996,120,310,0.387,206,400,0.515,0.544,117,140,0.836,19,141,160,139,41,10,85,104,889
Ty Lawson,PG,29,SAC,69,24,1732,237,522,0.45399999999999996,34,118,0.28800000000000003,203,404,0.502,0.48700000000000004,173,217,0.797,44,135,179,334,74,6,129,119,681
Jake Layman,SF,22,POR,35,1,249,26,89,0.292,13,51,0.255,13,38,0.342,0.365,13,17,0.765,6,18,24,11,9,3,11,22,78
Courtney Lee,SG,31,NYK,77,74,2459,321,704,0.456,108,269,0.401,213,435,0.49,0.5329999999999999,85,98,0.867,53,206,259,179,81,24,69,141,835
David Lee,PF,33,SAS,79,10,1477,248,420,0.59,0,0,0.0,248,420,0.59,0.59,80,113,0.708,149,292,441,124,31,40,82,125,576
Alex Len,C,23,PHO,77,34,1560,230,463,0.49700000000000005,3,12,0.25,227,451,0.503,0.5,150,208,0.721,156,354,510,44,38,98,102,242,613
Kawhi Leonard,SF,25,SAS,74,74,2474,636,1312,0.485,147,387,0.38,489,925,0.529,0.541,469,533,0.88,80,350,430,260,133,55,154,122,1888
Meyers Leonard,PF,24,POR,74,12,1222,146,378,0.386,74,213,0.34700000000000003,72,165,0.436,0.484,35,40,0.875,27,210,237,71,13,28,35,172,401
Jon Leuer,PF,27,DET,75,34,1944,310,646,0.48,49,167,0.293,261,479,0.545,0.518,98,113,0.867,102,300,402,111,31,26,66,145,767
Caris LeVert,SF,22,BRK,57,26,1237,171,380,0.45,59,184,0.321,112,196,0.5710000000000001,0.528,67,93,0.72,23,165,188,110,49,8,59,91,468
DeAndre Liggins,SG,28,TOT,62,19,777,55,142,0.387,17,46,0.37,38,96,0.396,0.447,25,40,0.625,20,88,108,54,47,14,42,81,152
Damian Lillard,PG,26,POR,75,75,2694,661,1488,0.444,214,579,0.37,447,909,0.49200000000000005,0.516,488,545,0.895,46,322,368,440,68,20,197,152,2024
Jeremy Lin,PG,28,BRK,36,33,883,175,400,0.43799999999999994,58,156,0.37200000000000005,117,244,0.48,0.51,115,141,0.816,11,124,135,184,42,14,86,79,523
Shaun Livingston,PG,31,GSW,76,3,1345,173,316,0.547,1,3,0.33299999999999996,172,313,0.55,0.5489999999999999,42,60,0.7,28,123,151,139,38,20,62,120,389
Shawn Long,C,24,PHI,18,0,234,61,109,0.56,7,19,0.368,54,90,0.6,0.5920000000000001,19,35,0.5429999999999999,41,44,85,13,9,9,13,49,148
Kevon Looney,C,20,GSW,53,4,447,56,107,0.523,2,9,0.222,54,98,0.551,0.5329999999999999,21,34,0.618,44,80,124,29,15,17,17,64,135
Brook Lopez,C,28,BRK,75,75,2222,555,1172,0.474,134,387,0.34600000000000003,421,785,0.536,0.531,295,364,0.81,121,282,403,176,38,124,184,192,1539
Robin Lopez,C,28,CHI,81,81,2271,382,775,0.493,0,2,0.0,382,773,0.494,0.493,75,104,0.721,244,276,520,80,18,117,91,151,839
Kevin Love,PF,28,CLE,60,60,1885,370,867,0.42700000000000005,145,389,0.373,225,478,0.47100000000000003,0.51,257,295,0.871,148,518,666,116,53,21,122,125,1142
Kyle Lowry,PG,30,TOR,60,60,2244,426,918,0.46399999999999997,193,468,0.41200000000000003,233,450,0.518,0.569,299,365,0.8190000000000001,48,238,286,417,88,19,173,170,1344
John Lucas III,PG,34,MIN,5,0,11,1,4,0.25,0,1,0.0,1,3,0.33299999999999996,0.25,0,0,0.0,0,0,0,1,2,0,0,0,2
Timothé Luwawu-Cabarrot,SF,21,PHI,69,19,1190,145,361,0.402,50,161,0.311,95,200,0.475,0.47100000000000003,105,123,0.8540000000000001,25,124,149,75,32,10,73,154,445
Trey Lyles,PF,21,UTA,71,4,1158,159,439,0.36200000000000004,65,204,0.319,94,235,0.4,0.436,57,79,0.722,48,187,235,69,26,20,64,97,440
Sheldon Mac,SG,24,WAS,30,3,287,30,75,0.4,7,30,0.233,23,45,0.511,0.447,23,27,0.852,4,30,34,15,8,2,5,17,90
Shelvin Mack,PG,26,UTA,55,9,1205,170,381,0.446,37,120,0.308,133,261,0.51,0.495,53,77,0.688,20,105,125,154,42,3,90,100,430
Ian Mahinmi,C,30,WAS,31,0,555,65,111,0.586,0,0,0.0,65,111,0.586,0.586,43,75,0.573,47,103,150,19,33,24,34,90,173
Thon Maker,C,19,MIL,57,34,562,83,181,0.45899999999999996,28,74,0.37799999999999995,55,107,0.514,0.536,32,49,0.653,40,74,114,23,10,26,17,84,226
Boban Marjanović,C,28,DET,35,0,293,72,132,0.545,0,0,0.0,72,132,0.545,0.545,47,58,0.81,46,84,130,9,6,12,10,25,191
Jarell Martin,PF,22,MEM,42,3,558,58,151,0.384,9,25,0.36,49,126,0.389,0.414,40,50,0.8,42,120,162,8,17,9,28,91,165
Wesley Matthews,SG,30,DAL,73,73,2495,333,847,0.39299999999999996,174,479,0.363,159,368,0.43200000000000005,0.496,146,179,0.816,18,241,259,210,77,15,102,161,986
Luc Mbah a Moute,SF,30,LAC,80,76,1787,191,378,0.505,43,110,0.391,148,268,0.552,0.562,59,87,0.6779999999999999,44,126,170,39,81,35,46,122,484
James Michael McAdoo,PF,24,GSW,52,2,457,62,117,0.53,2,8,0.25,60,109,0.55,0.5379999999999999,21,42,0.5,34,57,91,18,18,29,19,47,147
Patrick McCaw,SG,21,GSW,71,20,1074,106,245,0.433,41,123,0.33299999999999996,65,122,0.5329999999999999,0.516,29,37,0.784,21,79,100,77,32,15,36,62,282
CJ McCollum,SG,25,POR,80,80,2796,692,1441,0.48,185,439,0.42100000000000004,507,1002,0.506,0.544,268,294,0.912,60,229,289,285,72,42,172,202,1837
T.J. McConnell,PG,24,PHI,81,51,2133,236,512,0.461,11,55,0.2,225,457,0.49200000000000005,0.47200000000000003,73,90,0.8109999999999999,39,212,251,534,134,10,159,139,556
Chris McCullough,PF,21,TOT,16,0,80,16,32,0.5,1,7,0.14300000000000002,15,25,0.6,0.516,3,5,0.6,9,10,19,2,2,2,3,7,36
K.J. McDaniels,SF,23,TOT,49,0,505,77,169,0.456,20,66,0.303,57,103,0.5529999999999999,0.515,32,38,0.8420000000000001,15,67,82,13,19,18,29,49,206
Doug McDermott,SF,25,TOT,66,5,1508,222,497,0.447,77,208,0.37,145,289,0.502,0.524,71,84,0.845,20,159,179,58,13,5,38,79,592
JaVale McGee,C,29,GSW,77,10,739,208,319,0.652,0,3,0.0,208,316,0.6579999999999999,0.652,56,111,0.505,100,144,244,17,19,67,40,109,472
Rodney McGruder,SG,25,MIA,78,65,1966,190,460,0.413,73,220,0.332,117,240,0.488,0.49200000000000005,44,71,0.62,94,162,256,124,46,18,56,140,497
Ben McLemore,SG,23,SAC,61,26,1176,180,419,0.43,65,170,0.382,115,249,0.462,0.507,70,93,0.753,19,110,129,51,29,6,62,108,495
Jordan McRae,SG,25,CLE,37,4,384,58,150,0.387,18,51,0.353,40,99,0.40399999999999997,0.447,27,34,0.794,6,35,41,19,8,6,14,31,161
Josh McRoberts,PF,29,MIA,22,14,381,44,118,0.373,13,31,0.419,31,87,0.35600000000000004,0.428,6,9,0.667,23,51,74,50,10,4,23,31,107
Jodie Meeks,SG,29,ORL,36,10,738,103,256,0.402,56,137,0.409,47,119,0.395,0.512,65,74,0.878,5,72,77,45,34,4,36,41,327
Salah Mejri,C,30,DAL,73,11,905,88,137,0.642,1,3,0.33299999999999996,87,134,0.649,0.6459999999999999,36,61,0.59,97,211,308,14,32,61,40,152,213
Jordan Mickey,PF,22,BOS,25,1,141,15,34,0.441,0,1,0.0,15,33,0.455,0.441,8,14,0.5710000000000001,13,21,34,7,3,6,9,12,38
Khris Middleton,SF,25,MIL,29,23,889,150,333,0.45,45,104,0.433,105,229,0.45899999999999996,0.518,81,92,0.88,11,112,123,99,41,7,65,79,426
C.J. Miles,SF,29,IND,76,29,1776,281,647,0.434,169,409,0.413,112,238,0.47100000000000003,0.565,84,93,0.903,30,199,229,48,46,25,40,151,815
Mike Miller,SF,36,DEN,20,0,151,9,23,0.391,8,20,0.4,1,3,0.33299999999999996,0.565,2,2,1.0,2,36,38,22,2,0,13,9,28
Patty Mills,PG,28,SAS,80,8,1754,273,621,0.44,147,355,0.414,126,266,0.474,0.5579999999999999,66,80,0.825,24,117,141,280,65,3,101,109,759
Elijah Millsap,SG,29,PHO,2,0,23,1,7,0.14300000000000002,0,2,0.0,1,5,0.2,0.14300000000000002,1,2,0.5,3,3,6,1,0,0,2,2,3
Paul Millsap,PF,31,ATL,69,67,2343,430,972,0.442,75,241,0.311,355,731,0.486,0.48100000000000004,311,405,0.768,111,422,533,252,90,62,158,186,1246
Nikola Mirotić,PF,25,CHI,70,15,1679,258,625,0.413,129,377,0.342,129,248,0.52,0.516,99,128,0.773,61,323,384,75,53,55,80,128,744
Greg Monroe,C,26,MIL,81,0,1823,387,726,0.5329999999999999,0,4,0.0,387,722,0.536,0.5329999999999999,177,239,0.741,167,365,532,187,92,38,140,168,951
E'Twaun Moore,SG,27,NOP,73,22,1820,283,619,0.457,77,208,0.37,206,411,0.501,0.519,57,74,0.77,33,119,152,164,50,32,62,131,700
Marcus Morris,SF,27,DET,79,79,2565,421,1007,0.418,118,357,0.331,303,650,0.466,0.47700000000000004,145,185,0.784,77,289,366,160,52,25,87,168,1105
Markieff Morris,PF,27,WAS,76,76,2374,406,889,0.457,71,196,0.36200000000000004,335,693,0.483,0.49700000000000005,180,215,0.8370000000000001,107,386,493,126,82,42,129,254,1063
Anthony Morrow,SG,31,TOT,49,7,714,98,252,0.389,41,133,0.308,57,119,0.479,0.47,34,37,0.919,12,19,31,25,24,2,6,44,271
Donatas Motiejūnas,PF,26,NOP,34,0,479,57,138,0.413,11,47,0.23399999999999999,46,91,0.505,0.45299999999999996,25,49,0.51,26,75,101,32,18,11,31,55,150
Timofey Mozgov,C,30,LAL,54,52,1104,169,328,0.515,0,1,0.0,169,327,0.517,0.515,63,78,0.8079999999999999,104,160,264,43,16,31,72,133,401
Emmanuel Mudiay,PG,20,DEN,55,41,1406,208,551,0.377,56,178,0.315,152,373,0.408,0.428,131,167,0.784,29,149,178,217,41,13,123,95,603
Shabazz Muhammad,SF,24,MIN,78,1,1516,288,598,0.48200000000000004,49,145,0.33799999999999997,239,453,0.528,0.523,147,190,0.774,84,136,220,35,22,6,56,86,772
Dejounte Murray,PG,20,SAS,38,8,322,50,116,0.431,9,23,0.391,41,93,0.441,0.47,21,30,0.7,6,36,42,48,8,6,38,29,130
Jamal Murray,SG,19,DEN,82,10,1764,295,730,0.40399999999999997,115,344,0.33399999999999996,180,386,0.466,0.483,106,120,0.883,41,173,214,170,51,24,113,124,811
Mike Muscala,C,25,ATL,70,3,1237,170,337,0.504,46,110,0.418,124,227,0.546,0.573,49,64,0.7659999999999999,76,164,240,95,30,41,55,97,435
Larry Nance,PF,24,LAL,63,7,1442,190,361,0.526,10,36,0.278,180,325,0.5539999999999999,0.54,59,80,0.738,120,249,369,96,82,39,56,149,449
Shabazz Napier,PG,25,POR,53,2,512,73,183,0.39899999999999997,34,92,0.37,39,91,0.429,0.49200000000000005,38,49,0.7759999999999999,8,53,61,67,32,2,41,38,218
Maurice Ndour,PF,24,NYK,32,4,331,39,86,0.45299999999999996,1,7,0.14300000000000002,38,79,0.48100000000000004,0.45899999999999996,19,26,0.731,22,42,64,8,15,8,12,30,98
Gary Neal,SG,32,ATL,2,0,18,0,7,0.0,0,2,0.0,0,5,0.0,0.0,4,4,1.0,0,1,1,1,0,0,0,1,4
Jameer Nelson,PG,34,DEN,75,39,2045,268,604,0.444,106,273,0.38799999999999996,162,331,0.489,0.531,45,63,0.7140000000000001,28,164,192,385,54,8,128,197,687
Raul Neto,PG,24,UTA,40,0,346,41,91,0.451,10,31,0.32299999999999995,31,60,0.517,0.505,8,9,0.889,4,26,30,34,21,5,15,48,100
Georges Niang,PF,23,IND,23,0,93,9,36,0.25,1,12,0.083,8,24,0.33299999999999996,0.264,2,2,1.0,2,15,17,5,3,0,5,6,21
Andrew Nicholson,PF,27,TOT,38,0,342,43,111,0.387,5,27,0.185,38,84,0.452,0.41,9,14,0.643,15,46,61,10,16,6,17,55,100
Joakim Noah,C,31,NYK,46,46,1015,99,202,0.49,0,1,0.0,99,201,0.493,0.49,34,78,0.436,162,241,403,103,30,37,58,127,232
Nerlens Noel,C,22,TOT,51,19,1047,184,309,0.595,0,1,0.0,184,308,0.597,0.595,77,111,0.6940000000000001,93,201,294,50,65,50,51,126,445
Lucas Nogueira,C,24,TOR,57,6,1088,103,156,0.66,3,12,0.25,100,144,0.6940000000000001,0.67,44,67,0.657,82,162,244,42,52,89,46,137,253
Steve Novak,PF,33,MIL,8,0,22,2,7,0.28600000000000003,1,6,0.16699999999999998,1,1,1.0,0.35700000000000004,0,0,0.0,0,3,3,0,0,0,0,1,5
Dirk Nowitzki,PF,38,DAL,54,54,1424,296,678,0.43700000000000006,79,209,0.37799999999999995,217,469,0.46299999999999997,0.495,98,112,0.875,23,330,353,82,30,38,51,113,769
Jusuf Nurkić,C,22,TOT,65,48,1391,271,534,0.507,0,1,0.0,271,533,0.508,0.507,120,210,0.5710000000000001,154,313,467,123,50,74,143,161,662
David Nwaba,SG,24,LAL,20,2,397,47,81,0.58,1,5,0.2,46,76,0.605,0.586,25,39,0.6409999999999999,17,46,63,14,13,7,11,36,120
Johnny O'Bryant,PF,23,TOT,11,0,80,15,30,0.5,3,6,0.5,12,24,0.5,0.55,5,6,0.833,9,10,19,6,0,1,6,10,38
Kyle O'Quinn,C,26,NYK,79,8,1229,215,413,0.521,2,17,0.11800000000000001,213,396,0.5379999999999999,0.523,64,83,0.7709999999999999,157,282,439,117,36,104,76,174,496
Daniel Ochefu,C,23,WAS,19,0,75,12,27,0.444,0,0,0.0,12,27,0.444,0.444,0,2,0.0,5,17,22,3,2,0,3,17,24
Jahlil Okafor,C,21,PHI,50,33,1134,242,471,0.514,0,0,0.0,242,471,0.514,0.514,106,158,0.6709999999999999,81,159,240,58,20,49,91,122,590
Victor Oladipo,SG,24,OKC,67,67,2222,412,932,0.442,127,352,0.361,285,580,0.491,0.51,116,154,0.753,39,252,291,176,78,21,119,155,1067
Kelly Olynyk,C,25,BOS,75,6,1538,260,508,0.512,68,192,0.354,192,316,0.608,0.579,90,123,0.732,73,288,361,148,43,29,96,207,678
Arinze Onuaku,C,29,ORL,8,0,28,2,4,0.5,0,0,0.0,2,4,0.5,0.5,0,0,0.0,2,4,6,2,0,1,2,3,4
Chinanu Onuaku,C,20,HOU,5,1,52,5,7,0.7140000000000001,0,0,0.0,5,7,0.7140000000000001,0.7140000000000001,4,4,1.0,2,8,10,3,3,1,4,6,14
Kelly Oubre,SF,21,WAS,79,5,1605,186,442,0.42100000000000004,54,188,0.287,132,254,0.52,0.48200000000000004,75,99,0.758,61,200,261,47,58,17,50,195,501
Zaza Pachulia,C,32,GSW,70,70,1268,164,307,0.534,0,2,0.0,164,305,0.5379999999999999,0.534,98,126,0.778,140,270,410,132,59,33,87,166,426
Georgios Papagiannis,C,19,SAC,22,0,355,56,102,0.5489999999999999,0,2,0.0,56,100,0.56,0.5489999999999999,12,14,0.857,24,62,86,20,3,17,24,44,124
Jabari Parker,PF,21,MIL,51,50,1728,399,814,0.49,65,178,0.365,334,636,0.525,0.53,162,218,0.743,79,235,314,142,50,22,93,111,1025
Tony Parker,PG,34,SAS,63,63,1587,265,569,0.466,23,69,0.33299999999999996,242,500,0.484,0.486,85,117,0.726,9,104,113,285,34,2,89,92,638
Chandler Parsons,SF,28,MEM,34,34,675,75,222,0.33799999999999997,25,93,0.26899999999999996,50,129,0.38799999999999996,0.39399999999999996,35,43,0.8140000000000001,6,78,84,55,20,5,24,52,210
Lamar Patterson,SG,25,ATL,5,0,40,3,15,0.2,1,6,0.16699999999999998,2,9,0.222,0.233,2,3,0.667,1,6,7,6,1,0,4,6,9
Patrick Patterson,PF,27,TOR,65,8,1599,154,384,0.401,94,253,0.37200000000000005,60,131,0.45799999999999996,0.523,43,60,0.7170000000000001,62,231,293,76,40,23,38,120,445
Chris Paul,PG,31,LAC,61,61,1921,374,785,0.47600000000000003,124,302,0.41100000000000003,250,483,0.518,0.555,232,260,0.892,40,264,304,563,119,8,147,146,1104
Adreian Payne,PF,25,MIN,18,0,135,23,54,0.426,3,15,0.2,20,39,0.513,0.45399999999999996,14,19,0.737,9,24,33,7,8,7,8,32,63
Cameron Payne,PG,22,TOT,31,0,462,64,193,0.332,27,86,0.314,37,107,0.34600000000000003,0.402,5,8,0.625,3,45,48,55,14,4,29,52,160
Elfrid Payton,PG,22,ORL,82,58,2412,430,912,0.47100000000000003,40,146,0.27399999999999997,390,766,0.509,0.493,146,211,0.6920000000000001,89,298,387,529,88,40,178,177,1046
Gary Payton,PG,24,MIL,6,0,99,8,22,0.364,1,9,0.111,7,13,0.5379999999999999,0.386,3,5,0.6,0,12,12,13,3,4,10,9,20
Paul Pierce,SF,39,LAC,25,7,277,28,70,0.4,15,43,0.349,13,27,0.48100000000000004,0.507,10,13,0.769,1,47,48,10,4,5,16,40,81
Marshall Plumlee,C,24,NYK,21,1,170,16,30,0.5329999999999999,0,0,0.0,16,30,0.5329999999999999,0.5329999999999999,8,19,0.42100000000000004,23,28,51,10,4,4,12,23,40
Mason Plumlee,C,26,TOT,81,64,2148,334,623,0.536,0,6,0.0,334,617,0.541,0.536,174,300,0.58,170,435,605,284,69,92,134,226,842
Miles Plumlee,C,28,TOT,45,12,484,44,92,0.478,0,0,0.0,44,92,0.478,0.478,25,39,0.6409999999999999,38,57,95,21,18,13,30,73,113
Jakob Pöltl,C,21,TOR,54,4,626,67,115,0.583,0,0,0.0,67,115,0.583,0.583,31,57,0.544,78,87,165,12,17,20,29,113,165
Otto Porter,SF,23,WAS,80,80,2605,414,803,0.516,148,341,0.434,266,462,0.5760000000000001,0.608,99,119,0.8320000000000001,118,396,514,121,116,42,44,193,1075
Bobby Portis,PF,21,CHI,64,13,1000,183,375,0.488,32,96,0.33299999999999996,151,279,0.541,0.531,39,59,0.6609999999999999,75,221,296,35,16,11,37,94,437
Kristaps Porziņģis,PF,21,NYK,66,65,2164,443,985,0.45,112,314,0.35700000000000004,331,671,0.493,0.507,198,252,0.7859999999999999,111,364,475,97,47,129,118,244,1196
Dwight Powell,C,25,DAL,77,3,1333,194,377,0.515,21,74,0.284,173,303,0.5710000000000001,0.542,107,141,0.759,93,213,306,49,61,39,34,135,516
Norman Powell,SG,23,TOR,76,18,1368,227,506,0.449,56,173,0.324,171,333,0.514,0.504,126,159,0.792,26,143,169,82,52,14,70,127,636
Alex Poythress,PF,23,PHI,6,1,157,25,54,0.46299999999999997,6,19,0.316,19,35,0.5429999999999999,0.519,8,10,0.8,11,18,29,5,3,2,3,14,64
Ronnie Price,PG,33,PHO,14,0,134,4,24,0.16699999999999998,3,17,0.17600000000000002,1,7,0.14300000000000002,0.22899999999999998,3,4,0.75,3,8,11,18,11,1,3,14,14
Tim Quarterman,SG,22,POR,16,0,80,13,29,0.44799999999999995,5,13,0.385,8,16,0.5,0.534,0,3,0.0,4,10,14,11,2,3,11,6,31
Chasson Randle,PG,23,TOT,26,0,299,40,98,0.408,16,47,0.34,24,51,0.47100000000000003,0.49,41,43,0.953,6,26,32,34,9,2,19,39,137
Julius Randle,PF,22,LAL,74,73,2132,377,773,0.488,17,63,0.27,360,710,0.507,0.499,204,282,0.723,150,486,636,264,49,37,173,248,975
Zach Randolph,PF,35,MEM,73,5,1786,433,964,0.449,21,94,0.223,412,870,0.474,0.46,141,193,0.731,182,416,598,122,38,10,99,136,1028
J.J. Redick,SG,32,LAC,78,78,2198,396,890,0.445,201,468,0.429,195,422,0.462,0.5579999999999999,180,202,0.8909999999999999,11,160,171,110,54,13,98,125,1173
Willie Reed,C,26,MIA,71,5,1031,162,285,0.568,1,4,0.25,161,281,0.573,0.57,49,88,0.557,129,203,332,26,18,47,31,137,374
Josh Richardson,SG,23,MIA,53,34,1614,202,513,0.39399999999999996,75,227,0.33,127,286,0.444,0.467,60,77,0.779,35,133,168,140,60,39,65,132,539
Malachi Richardson,SG,21,SAC,22,0,198,28,68,0.41200000000000003,8,28,0.28600000000000003,20,40,0.5,0.47100000000000003,15,19,0.789,3,20,23,11,5,1,8,23,79
Austin Rivers,SG,24,LAC,74,29,2054,323,731,0.442,111,299,0.371,212,432,0.491,0.518,132,191,0.691,20,141,161,204,48,10,115,187,889
Andre Roberson,SF,25,OKC,79,79,2376,215,463,0.46399999999999997,45,184,0.245,170,279,0.609,0.513,47,111,0.423,98,305,403,79,94,79,51,204,522
Brian Roberts,PG,31,CHO,41,2,416,46,122,0.377,17,44,0.386,29,78,0.37200000000000005,0.447,33,39,0.846,5,34,39,52,9,1,26,18,142
Glenn Robinson,SF,23,IND,69,27,1427,158,338,0.467,49,125,0.392,109,213,0.512,0.54,54,76,0.711,57,189,246,47,41,20,37,63,419
Thomas Robinson,PF,25,LAL,48,1,560,105,196,0.536,0,1,0.0,105,195,0.5379999999999999,0.536,31,66,0.47,84,139,223,31,26,9,46,76,241
Sergio Rodríguez,PG,30,PHI,68,30,1518,210,536,0.392,92,252,0.365,118,284,0.415,0.478,18,27,0.667,21,136,157,344,49,4,128,95,530
Rajon Rondo,PG,30,CHI,69,42,1843,229,561,0.408,50,133,0.376,179,428,0.418,0.45299999999999996,30,50,0.6,73,282,355,461,99,11,169,144,538
Derrick Rose,PG,28,NYK,64,64,2082,460,977,0.47100000000000003,13,60,0.217,447,917,0.48700000000000004,0.47700000000000004,221,253,0.8740000000000001,66,180,246,283,44,17,147,84,1154
Terrence Ross,SF,25,TOT,78,24,1955,326,746,0.43700000000000006,142,391,0.363,184,355,0.518,0.532,64,77,0.831,18,188,206,88,87,33,68,143,858
Terry Rozier,PG,22,BOS,74,0,1263,151,411,0.36700000000000005,57,179,0.318,94,232,0.405,0.43700000000000006,51,66,0.773,40,187,227,131,46,11,47,69,410
Ricky Rubio,PG,26,MIN,75,75,2469,261,650,0.402,60,196,0.306,201,454,0.44299999999999995,0.44799999999999995,254,285,0.8909999999999999,68,237,305,682,128,10,195,202,836
Damjan Rudež,SF,30,ORL,45,0,314,31,88,0.35200000000000004,20,64,0.313,11,24,0.45799999999999996,0.466,0,0,0.0,5,20,25,20,12,1,9,31,82
Brandon Rush,SG,31,MIN,47,33,1030,70,187,0.374,44,114,0.386,26,73,0.35600000000000004,0.49200000000000005,13,18,0.722,16,83,99,45,22,23,28,42,197
D'Angelo Russell,PG,20,LAL,63,60,1811,351,867,0.405,135,384,0.35200000000000004,216,483,0.447,0.483,147,188,0.782,31,190,221,303,87,16,176,130,984
Domantas Sabonis,PF,20,OKC,81,66,1632,192,481,0.39899999999999997,51,159,0.321,141,322,0.43799999999999994,0.452,44,67,0.657,46,242,288,82,39,32,83,200,479
Larry Sanders,C,28,CLE,5,0,13,1,4,0.25,0,0,0.0,1,4,0.25,0.25,2,2,1.0,3,1,4,0,1,1,2,5,4
Dario Šarić,PF,22,PHI,81,36,2129,381,927,0.41100000000000003,106,341,0.311,275,586,0.469,0.46799999999999997,172,220,0.782,112,401,513,182,57,30,183,162,1040
Tomáš Satoranský,SG,25,WAS,57,3,719,61,147,0.415,9,37,0.243,52,110,0.473,0.446,23,33,0.6970000000000001,25,58,83,92,26,6,38,60,154
Dennis Schröder,PG,23,ATL,79,78,2485,548,1214,0.451,100,294,0.34,448,920,0.48700000000000004,0.493,218,255,0.855,42,206,248,499,74,16,258,149,1414
Luis Scola,PF,36,BRK,36,1,461,71,151,0.47,17,50,0.34,54,101,0.535,0.526,25,37,0.6759999999999999,51,88,139,37,14,4,34,63,184
Mike Scott,PF,28,ATL,18,0,195,17,59,0.28800000000000003,4,27,0.14800000000000002,13,32,0.406,0.322,7,8,0.875,10,27,37,17,4,3,8,12,45
Thabo Sefolosha,SF,32,ATL,62,42,1596,174,395,0.441,41,120,0.342,133,275,0.484,0.49200000000000005,55,75,0.733,54,216,270,107,96,31,58,97,444
Wayne Selden,SG,22,TOT,14,5,236,25,58,0.431,7,28,0.25,18,30,0.6,0.491,14,22,0.636,1,15,16,13,6,1,12,18,71
Kevin Séraphin,PF,27,IND,49,3,559,109,198,0.551,0,2,0.0,109,196,0.556,0.551,14,22,0.636,41,101,142,23,7,20,29,66,232
Ramon Sessions,PG,30,CHO,50,1,811,100,263,0.38,21,62,0.33899999999999997,79,201,0.39299999999999996,0.42,91,118,0.7709999999999999,11,62,73,129,27,3,46,43,312
Iman Shumpert,SG,26,CLE,76,31,1937,201,489,0.41100000000000003,94,261,0.36,107,228,0.469,0.507,71,90,0.789,39,179,218,109,62,27,78,150,567
Pascal Siakam,PF,22,TOR,55,38,859,103,205,0.502,1,7,0.14300000000000002,102,198,0.515,0.505,22,32,0.688,64,121,185,17,26,45,33,109,229
Jonathon Simmons,SG,27,SAS,78,8,1392,177,421,0.42,30,102,0.294,147,319,0.461,0.456,99,132,0.75,20,140,160,126,47,25,76,146,483
Kyle Singler,SF,28,OKC,32,2,385,34,83,0.41,7,37,0.18899999999999997,27,46,0.5870000000000001,0.452,13,17,0.765,8,40,48,9,7,5,11,29,88
Marcus Smart,SG,22,BOS,79,24,2399,269,749,0.359,94,332,0.28300000000000003,175,417,0.42,0.42200000000000004,203,250,0.812,78,227,305,364,125,34,159,192,835
Ish Smith,PG,28,DET,81,32,1955,329,749,0.439,28,105,0.267,301,644,0.467,0.45799999999999996,72,102,0.706,21,214,235,418,61,33,112,127,758
J.R. Smith,SG,31,CLE,41,35,1187,123,356,0.34600000000000003,95,271,0.35100000000000003,28,85,0.32899999999999996,0.479,10,15,0.667,17,96,113,62,40,11,26,77,351
Jason Smith,C,30,WAS,74,3,1068,174,329,0.529,37,78,0.474,137,251,0.546,0.585,35,51,0.6859999999999999,64,194,258,37,21,54,58,168,420
Tony Snell,SG,25,MIL,80,80,2336,246,541,0.455,144,355,0.406,102,186,0.5479999999999999,0.588,47,58,0.81,22,226,248,96,55,14,55,125,683
Marreese Speights,C,29,LAC,82,2,1286,244,548,0.445,103,277,0.37200000000000005,141,271,0.52,0.539,120,137,0.8759999999999999,88,285,373,65,23,41,69,229,711
Tiago Splitter,C,32,PHI,8,0,76,14,31,0.452,2,6,0.33299999999999996,12,25,0.48,0.484,9,11,0.818,8,14,22,4,1,1,6,8,39
Nik Stauskas,SG,23,PHI,80,27,2188,251,634,0.396,132,359,0.368,119,275,0.433,0.5,122,150,0.813,21,205,226,188,45,32,128,144,756
Lance Stephenson,SG,26,TOT,18,0,361,54,120,0.45,6,20,0.3,48,100,0.48,0.475,8,13,0.615,4,48,52,59,5,3,26,32,122
Jarnell Stokes,C,23,DEN,2,0,7,1,1,1.0,0,0,0.0,1,1,1.0,1.0,1,2,0.5,1,1,2,2,1,0,0,3,3
Diamond Stone,C,19,LAC,7,0,24,3,13,0.231,0,0,0.0,3,13,0.231,0.231,4,4,1.0,1,5,6,0,0,1,2,5,10
Rodney Stuckey,PG,30,IND,39,0,696,91,244,0.373,19,60,0.317,72,184,0.391,0.41200000000000003,80,107,0.748,6,78,84,84,16,0,53,44,281
Jared Sullinger,PF,24,TOR,11,1,118,15,47,0.319,3,18,0.16699999999999998,12,29,0.414,0.35100000000000003,4,8,0.5,10,17,27,3,4,1,4,17,37
Edy Tavares,C,24,TOT,2,0,28,4,5,0.8,0,0,0.0,4,5,0.8,0.8,0,3,0.0,4,7,11,1,0,6,2,3,8
Isaiah Taylor,PG,22,HOU,4,0,52,1,7,0.14300000000000002,0,2,0.0,1,5,0.2,0.14300000000000002,1,2,0.5,1,2,3,3,1,1,0,6,3
Jeff Teague,PG,28,IND,82,82,2657,402,909,0.442,90,252,0.35700000000000004,312,657,0.475,0.49200000000000005,360,415,0.867,33,297,330,639,100,32,216,165,1254
Mirza Teletović,PF,31,MIL,70,2,1133,156,418,0.373,104,305,0.341,52,113,0.46,0.498,35,45,0.778,11,151,162,48,12,13,37,109,451
Garrett Temple,SG,30,SAC,65,21,1728,183,432,0.424,82,220,0.373,101,212,0.47600000000000003,0.519,58,74,0.784,32,152,184,168,84,28,78,141,506
Jason Terry,SG,39,MIL,74,0,1365,105,243,0.43200000000000005,73,171,0.42700000000000005,32,72,0.444,0.5820000000000001,24,29,0.828,15,91,106,98,46,20,36,95,307
Isaiah Thomas,PG,27,BOS,76,76,2569,682,1473,0.46299999999999997,245,646,0.379,437,827,0.528,0.546,590,649,0.909,43,162,205,448,70,13,210,167,2199
Lance Thomas,PF,28,NYK,46,15,968,97,244,0.39799999999999996,38,85,0.447,59,159,0.371,0.475,43,51,0.843,32,110,142,35,21,5,25,85,275
Hollis Thompson,SG,25,TOT,40,9,752,77,200,0.385,32,95,0.337,45,105,0.429,0.465,19,29,0.655,19,93,112,35,20,6,11,69,205
Klay Thompson,SG,26,GSW,78,78,2649,644,1376,0.46799999999999997,268,647,0.414,376,729,0.516,0.565,186,218,0.853,49,236,285,160,66,40,128,139,1742
Tristan Thompson,C,25,CLE,78,78,2336,262,437,0.6,0,3,0.0,262,434,0.604,0.6,106,213,0.498,286,429,715,77,39,84,64,176,630
Marcus Thornton,SG,29,WAS,33,1,575,84,210,0.4,28,80,0.35,56,130,0.431,0.467,23,27,0.852,22,54,76,41,19,3,25,48,219
Mike Tobey,C,22,CHO,2,0,25,1,4,0.25,0,0,0.0,1,4,0.25,0.25,0,0,0.0,2,1,3,1,0,0,1,2,2
Anthony Tolliver,PF,31,SAC,65,9,1477,155,351,0.442,90,230,0.391,65,121,0.537,0.57,61,82,0.7440000000000001,51,186,237,77,34,20,56,109,461
Axel Toupane,SF,24,TOT,4,0,47,5,9,0.556,1,4,0.25,4,5,0.8,0.611,0,0,0.0,0,1,1,0,1,1,0,6,11
Karl-Anthony Towns,C,21,MIN,82,82,3030,802,1480,0.542,101,275,0.36700000000000005,701,1205,0.5820000000000001,0.5760000000000001,356,428,0.8320000000000001,296,711,1007,220,56,103,212,241,2061
P.J. Tucker,SF,31,TOT,81,21,2236,199,482,0.413,70,196,0.35700000000000004,129,286,0.451,0.485,72,93,0.774,117,354,471,99,116,19,66,196,540
Evan Turner,SF,28,POR,65,12,1658,235,552,0.426,31,118,0.263,204,434,0.47,0.45399999999999996,85,103,0.825,36,211,247,205,53,24,100,121,586
Myles Turner,C,20,IND,81,81,2541,444,869,0.511,40,115,0.348,404,754,0.536,0.534,245,303,0.809,139,450,589,106,74,172,105,262,1173
Beno Udrih,PG,34,DET,39,0,560,92,197,0.467,11,32,0.344,81,165,0.491,0.495,32,34,0.941,6,51,57,131,13,0,36,29,227
Tyler Ulis,PG,21,PHO,61,15,1123,184,437,0.42100000000000004,21,79,0.266,163,358,0.455,0.445,55,71,0.775,20,75,95,226,48,5,77,73,444
Jarrod Uthoff,PF,23,DAL,9,0,115,16,38,0.42100000000000004,3,9,0.33299999999999996,13,29,0.44799999999999995,0.461,5,7,0.7140000000000001,8,14,22,9,2,4,3,8,40
Jonas Valančiūnas,C,24,TOR,80,80,2066,391,702,0.557,1,2,0.5,390,700,0.557,0.5579999999999999,176,217,0.8109999999999999,226,533,759,57,37,63,106,216,959
Denzel Valentine,SG,23,CHI,57,0,976,102,288,0.354,73,208,0.35100000000000003,29,80,0.363,0.48100000000000004,14,18,0.778,11,140,151,63,30,7,49,86,291
Fred VanVleet,PG,22,TOR,37,0,294,39,111,0.35100000000000003,11,29,0.379,28,82,0.341,0.401,18,22,0.818,4,38,42,35,16,3,15,36,107
Anderson Varejão,C,34,GSW,14,1,92,5,14,0.35700000000000004,0,0,0.0,5,14,0.35700000000000004,0.35700000000000004,8,11,0.727,12,15,27,10,3,3,8,16,18
Greivis Vásquez,PG,30,BRK,3,0,39,2,8,0.25,1,3,0.33299999999999996,1,5,0.2,0.313,2,3,0.667,0,2,2,5,1,1,1,6,7
Rashad Vaughn,SG,20,MIL,41,2,458,57,156,0.365,26,81,0.321,31,75,0.413,0.449,2,5,0.4,4,45,49,23,19,10,14,32,142
Noah Vonleh,PF,21,POR,74,41,1265,130,270,0.48100000000000004,7,20,0.35,123,250,0.49200000000000005,0.494,60,94,0.638,131,256,387,31,30,27,64,154,327
Nikola Vučević,C,26,ORL,75,55,2163,483,1031,0.46799999999999997,23,75,0.307,460,956,0.48100000000000004,0.48,107,160,0.669,176,603,779,208,76,74,117,180,1096
Sasha Vujačić,SG,32,NYK,42,4,408,42,136,0.309,23,74,0.311,19,62,0.306,0.39299999999999996,17,24,0.708,12,47,59,52,13,2,16,38,124
Dwyane Wade,SG,35,CHI,60,59,1792,414,955,0.434,45,145,0.31,369,810,0.456,0.457,223,281,0.794,63,207,270,228,86,41,138,112,1096
Dion Waiters,SG,25,MIA,46,43,1384,281,663,0.424,85,215,0.395,196,448,0.43799999999999994,0.488,82,127,0.6459999999999999,18,135,153,200,42,20,103,95,729
Kemba Walker,PG,26,CHO,79,79,2739,643,1449,0.444,240,602,0.39899999999999997,403,847,0.47600000000000003,0.527,304,359,0.847,45,263,308,434,85,22,168,119,1830
John Wall,PG,26,WAS,78,78,2836,647,1435,0.451,89,272,0.327,558,1163,0.48,0.48200000000000004,422,527,0.8009999999999999,59,267,326,831,157,49,322,151,1805
Taurean Waller-Prince,SF,22,ATL,59,10,981,114,285,0.4,33,102,0.324,81,183,0.44299999999999995,0.45799999999999996,74,94,0.787,25,132,157,55,43,27,61,96,335
T.J. Warren,SF,23,PHO,66,59,2048,403,814,0.495,26,98,0.265,377,716,0.527,0.511,119,154,0.773,125,214,339,75,76,39,57,175,951
C.J. Watson,PG,32,ORL,62,9,1012,96,248,0.387,32,105,0.305,64,143,0.44799999999999995,0.452,57,66,0.8640000000000001,16,73,89,114,43,2,47,84,281
Briante Weber,PG,24,TOT,20,0,205,25,60,0.41700000000000004,1,10,0.1,24,50,0.48,0.425,11,16,0.688,8,18,26,21,12,1,8,16,62
David West,C,36,GSW,68,0,854,135,252,0.536,3,8,0.375,132,244,0.541,0.542,43,56,0.768,47,156,203,151,42,48,78,105,316
Russell Westbrook,PG,28,OKC,81,81,2802,824,1941,0.425,200,583,0.34299999999999997,624,1358,0.45899999999999996,0.47600000000000003,710,840,0.845,137,727,864,840,132,31,438,190,2558
Okaro White,PF,24,MIA,35,0,471,33,87,0.379,12,34,0.353,21,53,0.396,0.44799999999999995,20,22,0.909,25,57,82,21,10,10,18,52,98
Isaiah Whitehead,PG,21,BRK,73,26,1643,204,508,0.402,44,149,0.295,160,359,0.446,0.445,91,113,0.805,32,152,184,192,42,36,142,175,543
Hassan Whiteside,C,27,MIA,77,77,2513,542,973,0.557,0,0,0.0,542,973,0.557,0.557,225,358,0.628,293,795,1088,57,57,161,154,226,1309
Andrew Wiggins,SF,21,MIN,82,82,3048,709,1570,0.452,103,289,0.35600000000000004,606,1281,0.473,0.484,412,542,0.76,102,226,328,189,82,30,187,183,1933
C.J. Wilcox,SG,26,ORL,22,0,108,8,31,0.258,3,15,0.2,5,16,0.313,0.306,2,2,1.0,4,8,12,12,2,1,6,8,21
Alan Williams,C,24,PHO,47,0,708,138,267,0.517,0,1,0.0,138,266,0.519,0.517,70,112,0.625,94,198,292,23,27,32,37,125,346
Deron Williams,PG,32,TOT,64,44,1657,263,600,0.43799999999999994,85,234,0.363,178,366,0.486,0.509,90,109,0.826,14,133,147,360,31,8,138,138,701
Derrick Williams,PF,25,TOT,50,11,804,108,244,0.44299999999999995,30,97,0.309,78,147,0.531,0.504,58,89,0.652,19,111,130,28,14,7,28,60,304
Lou Williams,SG,30,TOT,81,1,1994,428,998,0.429,163,446,0.365,265,552,0.48,0.511,402,457,0.88,26,176,202,239,80,20,160,92,1421
Marvin Williams,PF,30,CHO,76,76,2295,297,704,0.42200000000000004,124,354,0.35,173,350,0.494,0.51,131,150,0.873,89,411,500,106,58,53,60,134,849
Reggie Williams,SF,30,NOP,6,0,79,8,23,0.348,5,11,0.455,3,12,0.25,0.457,6,7,0.857,2,4,6,4,3,0,0,2,27
Troy Williams,SF,22,TOT,30,16,557,73,167,0.43700000000000006,18,62,0.29,55,105,0.524,0.491,21,32,0.6559999999999999,15,54,69,25,27,10,32,60,185
Kyle Wiltjer,PF,24,HOU,14,0,44,4,14,0.28600000000000003,4,13,0.308,0,1,0.0,0.429,1,2,0.5,4,6,10,2,3,1,5,4,13
Justise Winslow,SF,20,MIA,18,15,625,80,225,0.35600000000000004,7,35,0.2,73,190,0.384,0.371,29,47,0.617,23,71,94,66,26,6,33,52,196
Jeff Withey,C,26,UTA,51,1,432,55,103,0.534,0,1,0.0,55,102,0.539,0.534,36,48,0.75,52,69,121,7,16,32,14,52,146
Christian Wood,PF,21,CHO,13,0,107,12,23,0.522,0,5,0.0,12,18,0.667,0.522,11,15,0.733,14,15,29,2,3,6,7,11,35
Metta World Peace,SF,37,LAL,25,2,160,19,68,0.27899999999999997,9,38,0.237,10,30,0.33299999999999996,0.34600000000000003,10,16,0.625,5,15,20,11,10,2,7,18,57
Brandan Wright,PF,29,MEM,28,5,447,83,135,0.615,0,1,0.0,83,134,0.619,0.615,23,35,0.657,31,47,78,15,11,20,10,42,189
Delon Wright,PG,24,TOR,27,0,446,49,116,0.42200000000000004,10,30,0.33299999999999996,39,86,0.45299999999999996,0.466,42,55,0.764,16,32,48,57,27,11,25,31,150
James Young,SG,21,BOS,29,0,220,25,58,0.431,12,35,0.34299999999999997,13,23,0.565,0.534,6,9,0.667,6,20,26,4,10,2,4,15,68
Joe Young,PG,24,IND,33,0,135,26,72,0.361,5,23,0.217,21,49,0.429,0.396,11,15,0.733,1,16,17,15,4,0,5,5,68
Nick Young,SG,31,LAL,60,60,1556,272,633,0.43,170,421,0.40399999999999997,102,212,0.48100000000000004,0.564,77,90,0.856,25,113,138,58,37,14,36,137,791
Thaddeus Young,PF,28,IND,74,74,2237,362,687,0.527,45,118,0.381,317,569,0.557,0.56,45,86,0.523,131,317,448,122,113,29,95,135,814
Cody Zeller,C,24,CHO,62,58,1725,253,443,0.5710000000000001,0,1,0.0,253,442,0.5720000000000001,0.5710000000000001,133,196,0.679,135,270,405,99,62,58,65,189,639
Tyler Zeller,C,27,BOS,51,5,525,78,158,0.494,0,1,0.0,78,157,0.49700000000000005,0.494,22,39,0.564,43,81,124,42,7,21,20,61,178
Stephen Zimmerman,C,20,ORL,19,0,108,10,31,0.32299999999999995,0,0,0.0,10,31,0.32299999999999995,0.32299999999999995,3,5,0.6,11,24,35,4,2,5,3,17,23
Paul Zipser,SF,22,CHI,44,18,843,88,221,0.39799999999999996,33,99,0.33299999999999996,55,122,0.451,0.473,31,40,0.775,15,110,125,36,15,16,40,78,240
Ivica Zubac,C,19,LAL,38,11,609,126,238,0.529,0,3,0.0,126,235,0.536,0.529,32,49,0.653,41,118,159,30,14,33,30,66,284
