Player,Pos,Age,Tm,G,GS,MP,FG,FGA,FG%,3P,3PA,3P%,2P,2PA,2P%,eFG%,FT,FTA,FT%,ORB,DRB,TRB,AST,STL,BLK,TOV,PF,PTS
Shareef Abdur-Rahim,PF,27,TOT,85,56,2684,501,1054,0.475,9,34,0.265,492,1020,0.48200000000000004,0.48,373,429,0.8690000000000001,189,450,639,174,68,37,184,222,1384
Malik Allen,PF,25,MIA,45,6,616,83,198,0.419,0,0,0.0,83,198,0.419,0.419,25,33,0.758,42,77,119,16,12,28,27,81,191
Ray Allen*,SG,28,SEA,56,56,2152,447,1017,0.44,148,378,0.392,299,639,0.46799999999999997,0.512,245,271,0.904,69,217,286,268,71,11,156,132,1287
Rafer Alston,PG,27,MIA,82,28,2581,287,764,0.376,161,434,0.371,126,330,0.382,0.48100000000000004,103,134,0.769,26,200,226,372,114,18,128,212,838
Chris Andersen,PF,25,DEN,71,0,1029,90,203,0.44299999999999995,0,1,0.0,90,202,0.446,0.44299999999999995,63,107,0.589,89,209,298,35,34,114,48,119,243
Derek Anderson,SG,29,POR,51,46,1810,230,612,0.376,79,259,0.305,151,353,0.428,0.44,155,188,0.8240000000000001,26,156,182,228,66,3,90,79,694
Kenny Anderson,PG,33,IND,44,31,905,113,256,0.441,1,4,0.25,112,252,0.444,0.44299999999999995,35,48,0.7290000000000001,19,62,81,125,26,5,50,73,262
Shandon Anderson,SG,30,NYK,80,37,1974,238,564,0.42200000000000004,36,128,0.281,202,436,0.46299999999999997,0.45399999999999996,123,161,0.764,53,169,222,122,68,17,118,182,635
Carmelo Anthony,SF,19,DEN,82,82,2995,624,1465,0.426,69,214,0.322,555,1251,0.444,0.449,408,525,0.777,183,315,498,227,97,41,247,225,1725
Robert Archibald,C-PF,23,TOT,32,3,256,9,33,0.273,0,0,0.0,9,33,0.273,0.273,14,31,0.452,21,31,52,13,14,3,10,50,32
Gilbert Arenas,PG,22,WAS,55,52,2066,358,914,0.392,125,333,0.375,233,581,0.401,0.46,237,317,0.748,55,199,254,275,103,12,226,176,1078
Brandon Armstrong,SG,23,NJN,56,0,434,65,175,0.371,19,52,0.365,46,123,0.374,0.426,2,4,0.5,12,31,43,14,12,2,24,49,151
Darrell Armstrong,PG,35,NOH,79,22,2247,291,736,0.395,135,429,0.315,156,307,0.508,0.48700000000000004,123,144,0.8540000000000001,63,163,226,311,133,16,155,148,840
Carlos Arroyo,PG,24,UTA,71,71,2008,339,768,0.441,38,117,0.325,301,651,0.462,0.466,181,225,0.804,41,144,185,355,63,5,156,165,897
Chucky Atkins,PG,29,TOT,64,24,1544,192,484,0.397,81,241,0.336,111,243,0.457,0.48,73,97,0.753,9,84,93,223,45,2,92,102,538
Stacey Augmon,SF,35,NOH,69,24,1416,143,347,0.41200000000000003,1,7,0.14300000000000002,142,340,0.418,0.414,110,139,0.7909999999999999,52,122,174,85,55,15,76,114,397
Vin Baker,PF,32,TOT,54,33,1313,208,432,0.48100000000000004,1,3,0.33299999999999996,207,429,0.483,0.483,114,157,0.726,112,168,280,66,29,32,77,160,531
Marcus Banks,PG,22,BOS,81,2,1385,177,442,0.4,27,86,0.314,150,356,0.42100000000000004,0.431,99,131,0.7559999999999999,30,103,133,175,88,13,125,171,480
Leandro Barbosa,PG,21,PHO,70,46,1500,210,470,0.447,83,210,0.395,127,260,0.488,0.535,47,61,0.77,23,100,123,165,93,7,120,184,550
Matt Barnes,SF,23,LAC,38,9,724,63,138,0.457,2,13,0.154,61,125,0.488,0.46399999999999997,43,61,0.705,53,98,151,48,27,3,44,76,171
Dana Barros,SG,36,BOS,1,0,11,2,3,0.667,0,0,0.0,2,3,0.667,0.667,2,2,1.0,0,0,0,0,0,0,0,2,6
Brent Barry,SG,32,SEA,59,53,1803,215,427,0.504,114,252,0.452,101,175,0.5770000000000001,0.637,91,110,0.8270000000000001,21,183,204,342,85,16,139,121,635
Jon Barry,SG,34,DEN,57,9,1101,120,297,0.40399999999999997,51,138,0.37,69,159,0.434,0.49,60,71,0.845,25,98,123,147,57,8,53,66,351
Mengke Bateer,C,28,TOR,7,0,40,4,7,0.5710000000000001,0,0,0.0,4,7,0.5710000000000001,0.5710000000000001,0,0,0.0,5,3,8,1,1,0,2,10,8
Tony Battie,C,27,TOT,73,7,1478,170,384,0.44299999999999995,2,9,0.222,168,375,0.44799999999999995,0.445,66,89,0.742,118,241,359,58,26,67,63,159,408
Shane Battier,SF,25,MEM,79,1,1947,242,543,0.446,65,186,0.349,177,357,0.496,0.506,120,164,0.732,102,201,303,101,101,58,56,187,669
Lonny Baxter,C-PF,25,TOT,62,5,766,103,209,0.493,1,3,0.33299999999999996,102,206,0.495,0.495,44,76,0.579,64,123,187,20,17,29,38,123,251
Jerome Beasley,PF,23,MIA,2,0,5,1,3,0.33299999999999996,0,0,0.0,1,3,0.33299999999999996,0.33299999999999996,0,0,0.0,0,1,1,0,0,0,0,0,2
Raja Bell,SG,27,UTA,82,4,2020,329,805,0.409,62,166,0.373,267,639,0.418,0.447,195,248,0.7859999999999999,60,181,241,107,63,13,111,262,915
Troy Bell,PG,23,MEM,6,0,34,4,18,0.222,0,4,0.0,4,14,0.28600000000000003,0.222,3,3,1.0,3,1,4,4,1,0,6,6,11
Jonathan Bender,SF,23,IND,21,0,271,50,106,0.47200000000000003,9,22,0.409,41,84,0.488,0.514,39,47,0.83,9,31,40,9,5,11,33,23,148
Travis Best,PG,31,DAL,61,1,762,64,172,0.37200000000000005,3,20,0.15,61,152,0.401,0.381,40,46,0.87,17,51,68,112,31,4,33,66,171
Mike Bibby,PG,25,SAC,82,82,2980,527,1170,0.45,148,378,0.392,379,792,0.479,0.514,304,373,0.815,67,210,277,444,112,18,175,146,1506
Chauncey Billups,PG,27,DET,78,78,2758,392,996,0.39399999999999996,130,335,0.38799999999999996,262,661,0.396,0.45899999999999996,404,460,0.878,35,241,276,446,84,8,189,177,1318
Steve Blake,PG,23,WAS,75,14,1392,157,407,0.386,75,202,0.371,82,205,0.4,0.478,55,67,0.821,18,99,117,209,57,7,128,100,444
Corie Blount,PF-C,35,TOT,62,3,1050,115,253,0.455,0,3,0.0,115,250,0.46,0.455,15,27,0.556,98,177,275,55,49,24,43,135,245
Mark Blount,C,28,BOS,82,73,2402,342,604,0.5660000000000001,0,0,0.0,342,604,0.5660000000000001,0.5660000000000001,159,221,0.7190000000000001,207,382,589,75,80,106,150,253,843
Keith Bogans,SF,23,ORL,73,36,1787,183,454,0.40299999999999997,67,187,0.358,116,267,0.434,0.47700000000000004,65,103,0.631,106,211,317,98,46,10,75,128,498
Calvin Booth,C,27,SEA,71,35,1206,135,290,0.466,0,2,0.0,135,288,0.469,0.466,75,94,0.7979999999999999,86,194,280,28,17,101,45,150,345
Carlos Boozer,PF,22,CLE,75,75,2592,471,900,0.523,1,6,0.16699999999999998,470,894,0.526,0.524,219,285,0.768,230,627,857,148,74,55,134,199,1162
Curtis Borchardt,C,23,UTA,16,0,258,22,56,0.39299999999999996,0,1,0.0,22,55,0.4,0.39299999999999996,14,18,0.778,13,41,54,15,4,14,18,40,58
Chris Bosh,C,19,TOR,75,63,2510,327,712,0.45899999999999996,5,14,0.35700000000000004,322,698,0.461,0.46299999999999997,202,288,0.701,191,366,557,78,59,106,107,215,861
Ruben Boumtje-Boumtje,C,25,POR,9,0,26,1,5,0.2,0,0,0.0,1,5,0.2,0.2,2,2,1.0,0,1,1,1,0,1,0,2,4
Bruce Bowen,SF,32,SAS,82,82,2624,211,502,0.42,77,212,0.363,134,290,0.462,0.49700000000000005,66,114,0.579,45,208,253,113,84,33,90,166,565
Ryan Bowen,PF,28,DEN,52,1,392,18,53,0.34,0,0,0.0,18,53,0.34,0.34,10,12,0.833,39,48,87,18,18,16,6,47,46
Earl Boykins,SG,27,DEN,82,3,1849,321,766,0.419,55,171,0.322,266,595,0.447,0.455,142,162,0.877,42,101,143,295,51,3,100,84,839
Michael Bradley,C-PF,24,TOT,16,1,98,7,15,0.467,0,0,0.0,7,15,0.467,0.467,1,2,0.5,6,17,23,1,3,0,7,14,15
Shawn Bradley,C,31,DAL,66,5,773,89,188,0.473,0,1,0.0,89,187,0.47600000000000003,0.473,41,49,0.8370000000000001,72,101,173,20,33,74,17,130,219
Torraye Braggs,PF,27,TOT,15,0,154,16,33,0.485,0,0,0.0,16,33,0.485,0.485,8,12,0.667,18,21,39,7,4,2,13,29,40
Elton Brand,PF,24,LAC,69,68,2670,484,982,0.493,0,1,0.0,484,981,0.493,0.493,411,532,0.773,269,445,714,227,64,154,193,229,1379
J.R. Bremer,PG,23,TOT,36,2,443,43,158,0.272,19,74,0.257,24,84,0.28600000000000003,0.332,13,20,0.65,9,27,36,51,18,4,24,32,118
Jamison Brewer,PG,23,IND,13,1,160,13,35,0.371,5,14,0.35700000000000004,8,21,0.381,0.44299999999999995,1,6,0.16699999999999998,2,9,11,17,7,0,10,9,32
Primož Brezec,C,24,IND,18,0,72,12,26,0.462,0,0,0.0,12,26,0.462,0.462,4,6,0.667,5,10,15,3,0,3,6,13,28
Damone Brown,PF,24,NJN,3,0,17,1,10,0.1,0,0,0.0,1,10,0.1,0.1,1,2,0.5,3,2,5,0,2,0,1,2,3
Devin Brown,SG,25,SAS,58,0,627,85,196,0.434,4,14,0.28600000000000003,81,182,0.445,0.444,60,74,0.8109999999999999,38,92,130,33,15,4,38,61,234
Kedrick Brown,SF,22,TOT,55,26,969,117,254,0.461,38,99,0.384,79,155,0.51,0.535,17,27,0.63,41,105,146,64,30,7,29,80,289
Kwame Brown,PF,21,WAS,74,57,2239,288,589,0.489,1,2,0.5,287,587,0.489,0.49,228,334,0.6829999999999999,178,372,550,112,66,52,140,144,805
P.J. Brown,PF,34,NOH,80,80,2753,339,712,0.47600000000000003,0,1,0.0,339,711,0.47700000000000004,0.47600000000000003,158,185,0.8540000000000001,237,453,690,155,78,73,101,203,836
Tierre Brown,PG,24,NOH,3,0,17,2,4,0.5,0,0,0.0,2,4,0.5,0.5,2,4,0.5,0,1,1,2,0,0,7,1,6
Rick Brunson,PG,31,TOT,40,0,412,40,105,0.381,11,23,0.478,29,82,0.354,0.433,27,31,0.871,9,28,37,82,25,3,33,44,118
Kobe Bryant,SG,25,LAL,65,64,2447,516,1178,0.43799999999999994,71,217,0.327,445,961,0.46299999999999997,0.46799999999999997,454,533,0.852,103,256,359,330,112,28,171,176,1557
Greg Buckner,SG,27,PHI,53,3,703,66,175,0.377,12,44,0.273,54,131,0.41200000000000003,0.41100000000000003,20,27,0.741,28,75,103,45,21,4,34,77,164
Rodney Buford,SF,26,SAC,22,0,141,19,56,0.33899999999999997,0,2,0.0,19,54,0.35200000000000004,0.33899999999999997,3,6,0.5,6,9,15,7,6,1,4,9,41
Caron Butler,SF,23,MIA,68,56,2030,240,631,0.38,10,42,0.23800000000000002,230,589,0.39,0.38799999999999996,133,176,0.7559999999999999,92,234,326,126,75,13,91,162,623
Mitchell Butler,SG,33,WAS,41,4,552,54,124,0.435,11,30,0.36700000000000005,43,94,0.457,0.48,15,24,0.625,24,47,71,32,22,4,24,54,134
Rasual Butler,SF,24,MIA,45,0,675,119,250,0.47600000000000003,50,108,0.46299999999999997,69,142,0.486,0.5760000000000001,16,21,0.762,4,57,61,23,10,13,28,72,304
Žarko Čabarkapa,PF,22,PHO,49,4,570,81,197,0.41100000000000003,6,32,0.188,75,165,0.455,0.426,35,53,0.66,26,73,99,40,10,13,54,75,203
Marcus Camby,C,29,DEN,72,72,2162,262,549,0.47700000000000004,0,2,0.0,262,547,0.479,0.47700000000000004,98,136,0.721,211,516,727,132,86,187,98,239,622
Elden Campbell,C,35,DET,65,27,892,138,314,0.439,0,0,0.0,138,314,0.439,0.439,85,124,0.685,52,157,209,45,21,50,63,137,361
Brian Cardinal,PF,26,GSW,76,11,1634,220,466,0.47200000000000003,55,124,0.444,165,342,0.48200000000000004,0.531,238,271,0.878,100,217,317,103,66,20,84,206,733
Matt Carroll,SG,23,TOT,16,0,70,7,16,0.43799999999999994,1,3,0.33299999999999996,6,13,0.462,0.469,4,6,0.667,1,5,6,2,1,0,6,8,19
Anthony Carter,PG,28,SAS,5,2,87,11,37,0.297,0,3,0.0,11,34,0.324,0.297,0,0,0.0,2,9,11,12,4,0,12,9,22
Maurice Carter,SG,27,TOT,10,0,110,11,35,0.314,4,11,0.364,7,24,0.292,0.371,16,20,0.8,2,9,11,4,0,0,9,10,42
Vince Carter,SG,27,TOR,73,73,2785,608,1457,0.41700000000000004,93,243,0.38299999999999995,515,1214,0.424,0.449,336,417,0.8059999999999999,95,254,349,348,88,65,223,212,1645
Sam Cassell,PG,34,MIN,81,81,2838,620,1270,0.488,74,186,0.39799999999999996,546,1084,0.504,0.517,289,331,0.873,44,227,271,592,102,18,220,247,1603
Kelvin Cato,PF,29,HOU,69,67,1743,161,360,0.447,0,0,0.0,161,360,0.447,0.447,96,142,0.6759999999999999,153,319,472,72,52,96,84,203,418
Tyson Chandler,PF,21,CHI,35,8,782,67,158,0.424,0,1,0.0,67,157,0.42700000000000005,0.424,79,118,0.669,82,188,270,23,17,43,38,87,213
Calbert Cheaney,SF,32,GSW,79,7,2067,278,578,0.48100000000000004,0,10,0.0,278,568,0.489,0.48100000000000004,47,77,0.61,77,183,260,136,60,12,85,184,603
Doug Christie,SG,33,SAC,82,82,2780,317,688,0.461,49,142,0.345,268,546,0.491,0.496,148,172,0.86,69,260,329,347,151,41,155,186,831
Keon Clark,PF,28,UTA,2,0,27,2,6,0.33299999999999996,0,0,0.0,2,6,0.33299999999999996,0.33299999999999996,0,0,0.0,1,6,7,1,1,0,0,1,4
Speedy Claxton,PG,25,GSW,60,29,1595,224,524,0.42700000000000005,4,22,0.182,220,502,0.43799999999999994,0.431,182,224,0.813,38,118,156,267,97,9,102,146,634
Mateen Cleaves,PG,26,CLE,4,2,92,7,23,0.304,0,1,0.0,7,22,0.318,0.304,1,2,0.5,1,6,7,19,4,2,5,13,15
Derrick Coleman,C,36,PHI,34,30,843,107,259,0.413,8,36,0.222,99,223,0.444,0.429,49,65,0.754,45,147,192,46,23,26,57,79,271
Bimbo Coles,PG,35,MIA,22,1,170,12,34,0.353,0,0,0.0,12,34,0.353,0.353,4,6,0.667,2,8,10,15,3,0,9,27,28
Jason Collier,C,26,ATL,20,16,545,79,165,0.479,1,4,0.25,78,161,0.484,0.48200000000000004,67,85,0.7879999999999999,36,75,111,17,11,11,31,71,226
Jarron Collins,C,25,UTA,81,31,1732,147,295,0.498,0,1,0.0,147,294,0.5,0.498,188,262,0.718,117,199,316,77,26,18,79,255,482
Jason Collins,C,25,NJN,78,78,2220,163,384,0.424,0,2,0.0,163,382,0.42700000000000005,0.424,136,184,0.7390000000000001,143,257,400,153,67,56,97,251,462
Brian Cook,C,23,LAL,35,2,442,67,141,0.475,0,5,0.0,67,136,0.493,0.475,21,28,0.75,31,70,101,20,16,16,17,64,155
Omar Cook,PG,22,POR,17,0,139,7,27,0.259,0,1,0.0,7,26,0.26899999999999996,0.259,0,0,0.0,3,3,6,24,10,0,10,14,14
Chris Crawford,PF,28,ATL,56,25,1207,211,471,0.44799999999999995,44,113,0.389,167,358,0.466,0.495,103,119,0.866,58,117,175,45,37,20,55,131,569
Jamal Crawford,SG,23,CHI,80,73,2811,509,1318,0.386,165,521,0.317,344,797,0.43200000000000005,0.449,200,240,0.833,46,237,283,405,111,29,193,161,1383
Austin Croshere,PF,28,IND,77,0,1051,119,307,0.38799999999999996,56,144,0.389,63,163,0.387,0.479,93,104,0.894,60,183,243,52,24,14,55,101,387
Eddy Curry,PF,21,CHI,73,63,2154,417,840,0.496,1,1,1.0,416,839,0.496,0.49700000000000005,235,350,0.6709999999999999,143,308,451,68,24,83,177,258,1070
Michael Curry,SF,35,TOR,70,15,1229,76,196,0.38799999999999996,3,15,0.2,73,181,0.40299999999999997,0.395,49,58,0.845,22,65,87,53,23,5,48,153,204
Samuel Dalembert,C,22,PHI,82,53,2197,270,499,0.541,0,1,0.0,270,498,0.542,0.541,112,174,0.644,194,432,626,21,44,189,86,273,652
Erick Dampier,C,28,GSW,74,74,2403,348,650,0.535,0,2,0.0,348,648,0.537,0.535,217,332,0.654,344,543,887,60,33,137,131,227,913
Antonio Daniels,PG,28,SEA,71,32,1512,187,398,0.47,42,116,0.36200000000000004,145,282,0.514,0.523,155,184,0.8420000000000001,23,119,142,298,45,6,61,64,571
Marquis Daniels,SG,23,DAL,56,15,1039,203,411,0.494,11,36,0.306,192,375,0.512,0.507,60,78,0.769,66,80,146,116,53,12,44,51,477
Antonio Davis,C,35,TOT,80,79,2570,266,660,0.40299999999999997,0,0,0.0,266,660,0.40299999999999997,0.40299999999999997,176,230,0.765,207,464,671,137,37,65,114,206,708
Baron Davis,PG,24,NOH,67,66,2686,554,1402,0.395,187,582,0.321,367,820,0.44799999999999995,0.462,237,352,0.6729999999999999,66,221,287,501,158,27,215,178,1532
Dale Davis,C,34,POR,76,37,1682,133,281,0.473,0,0,0.0,133,281,0.473,0.473,65,106,0.613,158,240,398,72,43,62,40,154,331
Hubert Davis,SG,33,TOT,17,0,78,1,11,0.091,0,1,0.0,1,10,0.1,0.091,2,2,1.0,2,6,8,4,2,0,3,12,4
Josh Davis,PF,23,ATL,4,1,23,2,5,0.4,0,2,0.0,2,3,0.667,0.4,1,1,1.0,1,4,5,0,0,0,2,3,5
Ricky Davis,SF-SG,24,TOT,79,27,2474,446,950,0.469,52,140,0.371,394,810,0.486,0.49700000000000005,196,273,0.718,77,281,358,259,96,22,189,171,1140
Andrew DeClercq,C,30,ORL,71,53,1211,93,195,0.47700000000000004,0,0,0.0,93,195,0.47700000000000004,0.47700000000000004,44,54,0.815,131,186,317,44,47,32,54,217,230
Tony Delk,SG,30,DAL,33,11,509,70,184,0.38,20,66,0.303,50,118,0.424,0.435,37,44,0.841,16,43,59,28,27,7,17,46,197
Derrick Dial,SG,28,ORL,9,0,86,9,28,0.321,2,9,0.222,7,19,0.368,0.35700000000000004,6,8,0.75,5,8,13,2,6,0,1,6,26
Boris Diaw,SG,21,ATL,76,37,1919,140,313,0.447,6,26,0.231,134,287,0.467,0.457,56,93,0.602,111,231,342,182,59,37,126,191,342
Dan Dickau,PG,25,TOT,43,0,294,37,98,0.37799999999999995,10,30,0.33299999999999996,27,68,0.397,0.429,11,14,0.7859999999999999,7,19,26,38,17,0,26,44,95
Kaniel Dickens,PF,25,POR,3,0,12,3,3,1.0,0,0,0.0,3,3,1.0,1.0,1,2,0.5,2,0,2,0,0,0,1,3,7
DeSagana Diop,C,22,CLE,56,3,730,57,147,0.38799999999999996,0,0,0.0,57,147,0.38799999999999996,0.38799999999999996,12,20,0.6,72,127,199,34,26,51,29,116,126
Vlade Divac*,C,35,SAC,81,81,2317,314,668,0.47,2,13,0.154,312,655,0.47600000000000003,0.47200000000000003,170,260,0.654,136,327,463,432,57,77,173,222,800
Juan Dixon,SG,25,WAS,71,16,1478,247,637,0.38799999999999996,59,198,0.298,188,439,0.428,0.434,111,139,0.799,30,118,148,137,82,4,104,111,664
Michael Doleac,C,26,TOT,72,0,1029,140,322,0.435,0,0,0.0,140,322,0.435,0.435,45,52,0.865,88,177,265,44,23,36,48,142,325
Keyon Dooling,PG,23,LAC,58,24,1137,137,352,0.389,8,46,0.174,129,306,0.42200000000000004,0.401,78,94,0.83,17,62,79,130,45,6,65,108,360
Bryce Drew,PG,29,NOH,15,0,78,4,18,0.222,1,7,0.14300000000000002,3,11,0.273,0.25,3,3,1.0,0,6,6,13,4,0,8,1,12
Predrag Drobnjak,C,28,LAC,61,14,949,149,379,0.39299999999999996,11,36,0.306,138,343,0.402,0.408,73,86,0.8490000000000001,54,142,196,39,22,24,48,85,382
Tim Duncan,PF,27,SAS,69,68,2527,592,1181,0.501,2,12,0.16699999999999998,590,1169,0.505,0.502,352,588,0.599,227,632,859,213,62,185,183,164,1538
Mike Dunleavy,SF,23,GSW,75,69,2336,323,720,0.449,94,254,0.37,229,466,0.491,0.514,137,185,0.741,87,355,442,220,68,13,143,169,877
Ronald Dupree,SF,23,CHI,47,8,893,111,282,0.39399999999999996,4,9,0.444,107,273,0.392,0.401,66,105,0.629,55,112,167,55,32,18,51,134,292
Ndudi Ebi,SF,19,MIN,17,0,32,6,14,0.429,0,0,0.0,6,14,0.429,0.429,1,4,0.25,2,1,3,3,0,4,3,6,13
Howard Eisley,PG,31,TOT,67,23,1457,166,451,0.368,52,163,0.319,114,288,0.396,0.426,76,89,0.8540000000000001,20,109,129,273,56,5,98,137,460
Francisco Elson,C,27,DEN,62,14,875,94,199,0.47200000000000003,0,1,0.0,94,198,0.475,0.47200000000000003,30,45,0.667,65,138,203,32,35,39,35,145,218
Melvin Ely,PF,25,LAC,42,2,510,66,153,0.431,0,1,0.0,66,152,0.434,0.431,25,42,0.595,48,53,101,22,9,17,20,68,157
Reggie Evans,PF,23,SEA,75,27,1280,67,165,0.406,0,3,0.0,67,162,0.414,0.406,83,148,0.561,156,252,408,33,54,10,65,176,217
Desmond Ferguson,SF,26,POR,7,0,32,5,12,0.41700000000000004,3,8,0.375,2,4,0.5,0.542,0,2,0.0,0,4,4,1,0,0,1,0,13
Michael Finley,SG,30,DAL,72,72,2778,514,1159,0.44299999999999995,150,370,0.405,364,789,0.461,0.508,164,193,0.85,78,247,325,212,84,39,83,118,1342
Derek Fisher,SG,29,LAL,82,3,1769,203,576,0.35200000000000004,52,179,0.29100000000000004,151,397,0.38,0.39799999999999996,122,153,0.797,30,122,152,187,103,4,79,115,580
Marcus Fizer,SF,25,CHI,46,2,738,134,350,0.38299999999999995,2,17,0.11800000000000001,132,333,0.396,0.386,90,120,0.75,61,141,202,43,16,8,51,97,360
Alton Ford,PF,22,HOU,9,0,41,6,11,0.545,0,0,0.0,6,11,0.545,0.545,3,6,0.5,3,8,11,3,0,1,3,9,15
T.J. Ford,PG,20,MIL,55,55,1472,153,398,0.384,5,21,0.23800000000000002,148,377,0.39299999999999996,0.391,80,98,0.816,37,140,177,356,60,3,139,123,391
Danny Fortson,C,27,DAL,56,20,625,71,139,0.511,0,0,0.0,71,139,0.511,0.511,75,92,0.815,114,136,250,9,12,11,37,148,217
Jeff Foster,C,27,IND,82,79,1961,197,362,0.544,0,4,0.0,197,358,0.55,0.544,103,154,0.669,248,362,610,64,71,27,60,189,497
Tremaine Fowlkes,SF,27,DET,36,0,261,15,48,0.313,1,8,0.125,14,40,0.35,0.32299999999999995,13,18,0.722,18,35,53,14,9,3,12,37,44
Rick Fox,SF,34,LAL,38,34,846,73,186,0.392,15,61,0.24600000000000002,58,125,0.46399999999999997,0.433,22,30,0.733,29,73,102,98,29,4,48,99,183
Adonal Foyle,C,28,GSW,44,8,572,59,130,0.45399999999999996,0,0,0.0,59,130,0.45399999999999996,0.45399999999999996,19,35,0.5429999999999999,54,113,167,17,6,46,21,68,137
Richie Frahm,SF,26,SEA,54,0,469,63,139,0.45299999999999996,34,92,0.37,29,47,0.617,0.5760000000000001,23,26,0.885,12,44,56,24,16,4,7,50,183
Steve Francis,PG,26,HOU,79,79,3194,450,1117,0.40299999999999997,73,250,0.292,377,867,0.435,0.436,337,435,0.775,116,317,433,493,139,35,294,257,1310
Hiram Fuller,PF,22,ATL,4,0,43,3,8,0.375,0,0,0.0,3,8,0.375,0.375,2,6,0.33299999999999996,4,7,11,2,0,1,4,5,8
Dan Gadzuric,C,25,MIL,75,0,1260,183,349,0.524,0,1,0.0,183,348,0.526,0.524,58,118,0.49200000000000005,126,220,346,28,51,105,45,186,424
Reece Gaines,PG,23,ORL,38,1,364,25,86,0.29100000000000004,3,10,0.3,22,76,0.289,0.308,16,25,0.64,8,31,39,40,11,2,18,22,69
Alex Garcia,SG,23,SAS,2,0,13,1,7,0.14300000000000002,0,0,0.0,1,7,0.14300000000000002,0.14300000000000002,1,2,0.5,0,0,0,0,2,0,1,0,3
Kevin Garnett,PF,27,MIN,82,82,3231,804,1611,0.499,11,43,0.256,793,1568,0.506,0.502,368,465,0.7909999999999999,245,894,1139,409,120,178,212,202,1987
Pat Garrity,PF,27,ORL,2,0,22,1,3,0.33299999999999996,0,0,0.0,1,3,0.33299999999999996,0.33299999999999996,0,0,0.0,0,0,0,1,0,0,0,2,2
Pau Gasol,PF,23,MEM,78,78,2458,506,1049,0.48200000000000004,4,15,0.267,502,1034,0.485,0.484,365,511,0.7140000000000001,206,394,600,198,44,132,187,185,1381
Devean George,SF,26,LAL,82,48,1951,233,571,0.408,65,186,0.349,168,385,0.436,0.465,73,96,0.76,87,245,332,112,81,38,88,189,604
Eddie Gill,PG,25,POR,22,0,157,15,36,0.41700000000000004,3,8,0.375,12,28,0.429,0.45799999999999996,17,20,0.85,4,13,17,16,9,1,12,16,50
Kendall Gill,SG,35,CHI,56,35,1411,215,548,0.392,9,38,0.237,206,510,0.40399999999999997,0.401,100,136,0.735,61,129,190,89,65,16,83,107,539
Manu Ginóbili,SG,26,SAS,77,38,2260,330,789,0.418,88,245,0.359,242,544,0.445,0.474,239,298,0.802,86,258,344,291,136,16,161,181,987
Gordan Giriček,SF-SG,26,TOT,73,43,2041,316,724,0.436,60,152,0.395,256,572,0.44799999999999995,0.478,135,158,0.8540000000000001,51,175,226,122,56,15,103,144,827
Dion Glover,SG,25,TOT,69,30,1643,230,589,0.39,40,119,0.336,190,470,0.40399999999999997,0.424,120,156,0.769,58,208,266,130,50,19,102,123,620
Anthony Goldwire,PG,32,TOT,11,0,85,7,22,0.318,2,8,0.25,5,14,0.35700000000000004,0.364,1,1,1.0,1,6,7,11,5,0,3,5,17
Drew Gooden,PF,22,ORL,79,17,2134,369,829,0.445,9,42,0.214,360,787,0.457,0.451,167,262,0.637,160,356,516,89,62,72,126,196,914
Brian Grant,C,31,MIA,76,76,2303,289,613,0.47100000000000003,0,1,0.0,289,612,0.47200000000000003,0.47100000000000003,86,110,0.782,174,350,524,69,51,35,82,254,664
Horace Grant,PF,38,LAL,55,10,1106,92,224,0.41100000000000003,0,1,0.0,92,223,0.413,0.41100000000000003,39,54,0.722,79,154,233,71,24,21,29,70,223
Paul Grant,C,30,UTA,10,0,98,11,23,0.478,0,0,0.0,11,23,0.478,0.478,3,8,0.375,7,10,17,3,1,1,7,17,25
Willie Green,SG,22,PHI,53,0,767,143,357,0.401,19,61,0.311,124,296,0.419,0.42700000000000005,59,81,0.728,16,49,65,53,26,5,59,83,364
Adrian Griffin,SG,29,HOU,19,1,133,5,18,0.278,1,2,0.5,4,16,0.25,0.306,0,4,0.0,1,18,19,10,7,2,3,17,11
Tom Gugliotta,PF,34,TOT,55,27,819,70,203,0.345,1,4,0.25,69,199,0.34700000000000003,0.34700000000000003,20,28,0.7140000000000001,65,122,187,63,31,12,39,81,161
Marcus Haislip,PF,23,MIL,31,0,263,36,74,0.486,1,2,0.5,35,72,0.486,0.493,20,28,0.7140000000000001,21,32,53,4,6,12,9,25,93
Darvin Ham,SF,30,DET,54,2,484,37,75,0.493,1,2,0.5,36,73,0.493,0.5,21,35,0.6,47,46,93,16,13,8,31,63,96
Richard Hamilton,SG,25,DET,78,78,2772,530,1166,0.455,18,68,0.265,512,1098,0.466,0.462,297,342,0.868,78,201,279,310,103,17,210,222,1375
Zendon Hamilton,C,28,PHI,46,0,473,51,95,0.537,0,0,0.0,51,95,0.537,0.537,67,96,0.698,49,97,146,13,8,8,27,74,169
Ben Handlogten,C,30,UTA,17,0,172,25,47,0.532,0,0,0.0,25,47,0.532,0.532,18,27,0.667,22,33,55,6,3,4,10,32,68
Travis Hansen,SF,25,ATL,41,4,507,46,130,0.354,9,30,0.3,37,100,0.37,0.38799999999999996,22,27,0.815,30,40,70,19,10,9,15,67,123
Anfernee Hardaway,SG,32,TOT,76,14,2095,279,679,0.41100000000000003,30,79,0.38,249,600,0.415,0.433,111,138,0.804,69,218,287,176,70,20,107,146,699
Matt Harpring,SF,27,UTA,31,31,1134,193,410,0.47100000000000003,8,33,0.242,185,377,0.491,0.48,108,157,0.688,91,156,247,63,22,2,65,102,502
Al Harrington,PF,23,IND,79,15,2441,421,909,0.46299999999999997,21,77,0.273,400,832,0.48100000000000004,0.475,185,252,0.7340000000000001,163,345,508,131,80,22,163,250,1048
Othella Harrington,PF,30,NYK,56,3,872,100,202,0.495,0,0,0.0,100,202,0.495,0.495,58,78,0.7440000000000001,58,119,177,29,12,14,65,134,258
Lucious Harris,PG,33,NJN,69,15,1504,187,463,0.40399999999999997,38,101,0.376,149,362,0.41200000000000003,0.445,66,78,0.846,39,101,140,135,41,2,53,74,478
Jason Hart,PG,25,SAS,53,5,660,71,159,0.447,2,9,0.222,69,150,0.46,0.45299999999999996,33,43,0.767,10,69,79,81,28,5,29,59,177
Donnell Harvey,PF,23,TOT,60,8,783,89,201,0.44299999999999995,0,3,0.0,89,198,0.449,0.44299999999999995,61,83,0.735,48,116,164,21,24,27,45,129,239
Udonis Haslem,PF,23,MIA,75,24,1795,205,447,0.45899999999999996,0,3,0.0,205,444,0.462,0.45899999999999996,140,183,0.765,189,284,473,51,33,24,74,197,550
Trenton Hassell,SG,24,MIN,81,74,2264,177,381,0.465,4,13,0.308,173,368,0.47,0.47,48,61,0.787,68,189,257,133,36,54,46,200,406
Jarvis Hayes,SF,22,WAS,70,42,2044,278,695,0.4,40,131,0.305,238,564,0.42200000000000004,0.429,77,98,0.7859999999999999,71,193,264,106,71,11,110,157,673
Brendan Haywood,C,24,WAS,77,59,1484,200,388,0.515,0,1,0.0,200,387,0.517,0.515,137,234,0.585,186,201,387,43,32,100,80,154,537
Shane Heal,PG,33,SAS,6,0,72,7,24,0.292,4,18,0.222,3,6,0.5,0.375,4,5,0.8,1,3,4,5,1,0,5,2,22
Alan Henderson,PF,31,ATL,6,0,68,10,21,0.47600000000000003,0,0,0.0,10,21,0.47600000000000003,0.47600000000000003,4,6,0.667,11,10,21,2,1,2,3,1,24
Nenê Hilário,PF,21,DEN,77,77,2504,334,630,0.53,0,2,0.0,334,628,0.532,0.53,240,352,0.682,154,349,503,168,116,41,183,280,908
Tyrone Hill,PF,35,MIA,5,0,38,3,5,0.6,0,0,0.0,3,5,0.6,0.6,3,4,0.75,5,3,8,0,0,1,2,10,9
Kirk Hinrich,PG,23,CHI,76,66,2706,318,823,0.386,144,369,0.39,174,454,0.38299999999999995,0.474,135,168,0.804,42,217,259,517,101,21,204,276,915
Fred Hoiberg,SG,31,MIN,79,3,1804,178,383,0.465,76,172,0.442,102,211,0.483,0.564,98,116,0.845,21,247,268,109,66,10,44,136,530
Robert Horry,PF,33,SAS,81,1,1290,141,348,0.405,41,108,0.38,100,240,0.41700000000000004,0.46399999999999997,69,107,0.645,108,164,272,101,48,49,55,165,392
Eddie House,SG,25,LAC,60,10,1188,161,449,0.359,51,136,0.375,110,313,0.35100000000000003,0.415,36,45,0.8,28,110,138,148,65,4,63,92,409
Allan Houston,SG,32,NYK,50,50,1799,340,781,0.435,87,202,0.431,253,579,0.43700000000000006,0.491,157,172,0.9129999999999999,20,101,121,99,38,2,102,105,924
Josh Howard,SF,23,DAL,67,29,1589,229,532,0.43,20,66,0.303,209,466,0.44799999999999995,0.449,97,138,0.703,149,219,368,97,69,54,67,168,575
Juwan Howard,PF,30,ORL,81,77,2877,529,1169,0.45299999999999996,0,1,0.0,529,1168,0.45299999999999996,0.45299999999999996,318,393,0.809,171,399,570,158,54,22,178,284,1376
Troy Hudson,PG,27,MIN,29,1,503,80,207,0.386,31,77,0.40299999999999997,49,130,0.377,0.461,27,33,0.818,4,31,35,70,7,0,34,32,218
Larry Hughes,SG,25,WAS,61,61,2061,401,1009,0.397,79,232,0.341,322,777,0.414,0.43700000000000006,267,335,0.797,96,230,326,148,95,26,152,147,1148
Ryan Humphrey,PF,24,MEM,2,0,11,1,4,0.25,0,1,0.0,1,3,0.33299999999999996,0.25,0,0,0.0,2,1,3,1,1,0,2,3,2
Brandon Hunter,PF,23,BOS,36,12,406,53,116,0.457,0,3,0.0,53,113,0.469,0.457,19,43,0.442,50,68,118,19,13,1,22,40,125
Lindsey Hunter,SG,33,DET,33,8,661,49,143,0.34299999999999997,14,50,0.28,35,93,0.376,0.392,5,8,0.625,13,54,67,85,39,6,34,45,117
Steven Hunter,C,22,ORL,59,23,789,82,155,0.529,0,0,0.0,82,155,0.529,0.529,23,69,0.33299999999999996,54,116,170,12,5,73,29,101,187
Zydrunas Ilgauskas,C,28,CLE,81,81,2539,466,965,0.483,2,7,0.28600000000000003,464,958,0.484,0.484,303,406,0.746,279,374,653,109,39,201,163,277,1237
Allen Iverson*,SG,28,PHI,48,47,2040,435,1125,0.387,57,199,0.28600000000000003,378,926,0.408,0.41200000000000003,339,455,0.745,34,144,178,324,115,5,209,87,1266
Bobby Jackson,SG,30,SAC,50,0,1185,263,592,0.444,81,219,0.37,182,373,0.488,0.513,82,109,0.752,55,119,174,105,49,8,63,106,689
Jim Jackson,SF,33,HOU,80,80,3119,382,900,0.424,162,405,0.4,220,495,0.444,0.514,107,127,0.843,52,435,487,226,86,23,175,227,1033
Marc Jackson,PF,29,PHI,22,13,598,71,171,0.415,0,1,0.0,71,170,0.418,0.415,64,81,0.79,45,81,126,18,12,6,24,45,206
Mark Jackson,PG,38,HOU,42,3,577,34,100,0.34,7,41,0.171,27,59,0.45799999999999996,0.375,28,39,0.718,10,60,70,119,17,1,53,41,103
Stephen Jackson,SF,25,ATL,80,78,2940,536,1261,0.425,145,427,0.34,391,834,0.469,0.483,233,297,0.785,97,273,370,244,142,20,223,216,1450
Casey Jacobsen,SF,22,PHO,78,13,1828,150,360,0.41700000000000004,75,180,0.41700000000000004,75,180,0.41700000000000004,0.521,91,111,0.82,42,159,201,98,48,9,68,144,466
Jerome James,C,28,SEA,65,24,990,129,259,0.498,0,0,0.0,129,259,0.498,0.498,66,100,0.66,78,152,230,32,20,60,82,180,324
LeBron James,SG,19,CLE,79,79,3122,622,1492,0.41700000000000004,63,217,0.29,559,1275,0.43799999999999994,0.43799999999999994,347,460,0.754,99,333,432,465,130,58,273,149,1654
Mike James,PG,28,TOT,81,55,2196,272,657,0.414,106,281,0.377,166,376,0.441,0.495,103,127,0.8109999999999999,28,206,234,339,96,3,124,156,753
Antawn Jamison,SF,27,DAL,82,2,2376,488,913,0.535,16,40,0.4,472,873,0.541,0.5429999999999999,220,294,0.748,233,287,520,70,83,30,81,174,1212
Marko Jarić,PG,25,LAC,58,50,1760,185,477,0.38799999999999996,51,150,0.34,134,327,0.41,0.441,74,101,0.733,44,131,175,281,93,20,115,132,495
Chris Jefferies,SF-SG,23,TOT,21,2,195,27,72,0.375,17,42,0.405,10,30,0.33299999999999996,0.493,13,20,0.65,5,24,29,7,4,7,19,36,84
Richard Jefferson,SF,23,NJN,82,82,3133,555,1115,0.498,48,132,0.364,507,983,0.516,0.519,357,468,0.763,109,355,464,315,92,28,198,224,1515
Jared Jeffries,PF,22,WAS,82,38,1913,177,469,0.377,5,30,0.16699999999999998,172,439,0.392,0.38299999999999995,105,171,0.614,180,244,424,93,48,28,107,212,464
Britton Johnsen,C,24,ORL,20,4,290,17,59,0.28800000000000003,1,12,0.083,16,47,0.34,0.297,7,16,0.43799999999999994,15,30,45,12,7,1,14,28,42
Anthony Johnson,PG,29,IND,73,7,1598,167,411,0.406,41,122,0.336,126,289,0.436,0.456,75,94,0.7979999999999999,28,102,130,202,64,8,75,138,450
Avery Johnson,PG,38,GSW,46,1,637,80,199,0.402,0,3,0.0,80,196,0.408,0.402,52,78,0.667,3,30,33,111,26,3,51,34,212
DerMarr Johnson,SF,23,NYK,21,1,287,36,97,0.371,13,36,0.361,23,61,0.377,0.43799999999999994,28,31,0.903,5,34,39,11,8,7,16,32,113
Ervin Johnson,C,36,MIN,66,47,965,55,103,0.534,0,1,0.0,55,102,0.539,0.534,17,28,0.607,61,171,232,24,27,43,30,156,127
Joe Johnson,SG,22,PHO,82,77,3331,555,1291,0.43,83,272,0.305,472,1019,0.46299999999999997,0.462,174,232,0.75,80,305,385,362,93,26,199,177,1367
Linton Johnson,SF,23,CHI,41,20,734,72,203,0.355,7,33,0.212,65,170,0.382,0.37200000000000005,22,37,0.595,59,124,183,27,37,32,37,90,173
Dahntay Jones,SG,23,MEM,20,0,154,15,53,0.28300000000000003,1,4,0.25,14,49,0.28600000000000003,0.292,5,11,0.455,7,16,23,12,5,6,12,23,36
Damon Jones,PG,27,MIL,82,26,2016,210,524,0.401,98,273,0.359,112,251,0.446,0.494,55,72,0.764,15,155,170,478,30,4,103,92,573
Eddie Jones,SG,32,MIA,81,81,2998,473,1156,0.409,177,479,0.37,296,677,0.43700000000000006,0.486,278,333,0.835,38,270,308,258,92,34,129,226,1401
Fred Jones,SG,24,IND,81,2,1508,123,311,0.395,27,89,0.303,96,222,0.43200000000000005,0.439,124,149,0.8320000000000001,25,101,126,173,65,18,73,132,397
James Jones,SF,23,IND,6,0,26,2,9,0.222,1,4,0.25,1,5,0.2,0.278,2,2,1.0,0,2,2,0,1,0,0,1,7
Jumaine Jones,SG,24,BOS,42,2,373,33,96,0.344,13,44,0.295,20,52,0.385,0.41100000000000003,14,23,0.609,24,44,68,14,12,9,19,48,93
Popeye Jones,PF,33,GSW,5,0,10,0,2,0.0,0,0,0.0,0,2,0.0,0.0,0,0,0.0,1,0,1,0,0,0,0,2,0
Chris Kaman,C,21,LAC,82,61,1843,200,435,0.46,0,2,0.0,200,433,0.462,0.46,99,142,0.6970000000000001,126,335,461,85,23,73,155,211,499
Jason Kapono,SF,22,CLE,41,3,427,52,129,0.40299999999999997,21,44,0.47700000000000004,31,85,0.365,0.484,20,24,0.833,19,36,55,14,13,2,21,41,145
Jason Kidd*,PG,30,NJN,67,66,2450,368,959,0.384,94,293,0.321,274,666,0.41100000000000003,0.433,206,249,0.8270000000000001,85,343,428,618,122,14,214,110,1036
Andrei Kirilenko,PF,22,UTA,78,78,2895,412,931,0.44299999999999995,68,201,0.33799999999999997,344,730,0.47100000000000003,0.479,392,496,0.79,226,403,629,244,150,215,215,174,1284
Kerry Kittles,SG,29,NJN,82,82,2842,434,959,0.45299999999999996,97,276,0.35100000000000003,337,683,0.493,0.503,107,136,0.787,56,271,327,206,125,40,95,144,1072
Brevin Knight,PG,28,TOT,56,13,1037,105,246,0.42700000000000005,2,8,0.25,103,238,0.433,0.431,49,65,0.754,14,98,112,204,84,1,72,107,261
Kyle Korver,SF,22,PHI,74,0,882,115,327,0.35200000000000004,81,207,0.391,34,120,0.28300000000000003,0.47600000000000003,19,24,0.792,30,81,111,40,25,8,41,102,330
Toni Kukoč,PF,35,MIL,73,0,1522,211,506,0.41700000000000004,49,168,0.292,162,338,0.479,0.465,145,199,0.7290000000000001,60,211,271,200,59,21,110,110,616
Christian Laettner,PF,34,WAS,48,18,984,119,256,0.465,6,21,0.28600000000000003,113,235,0.48100000000000004,0.47700000000000004,40,50,0.8,50,182,232,89,37,28,42,102,284
Raef LaFrentz,C,27,BOS,17,1,328,57,124,0.46,8,40,0.2,49,84,0.583,0.49200000000000005,10,13,0.769,30,49,79,24,8,13,11,47,132
Maciej Lampe,C,18,PHO,21,0,224,43,88,0.489,0,4,0.0,43,84,0.512,0.489,10,13,0.769,9,35,44,9,3,3,15,28,96
Sean Lampley,SF,24,GSW,10,0,63,13,20,0.65,0,0,0.0,13,20,0.65,0.65,8,12,0.667,2,9,11,2,0,1,3,2,34
Dan Langhi,SF,26,TOT,6,0,37,5,14,0.35700000000000004,1,2,0.5,4,12,0.33299999999999996,0.39299999999999996,2,2,1.0,0,4,4,0,0,0,2,7,13
Rusty LaRue,PG,30,GSW,4,0,22,1,3,0.33299999999999996,1,1,1.0,0,2,0.0,0.5,1,2,0.5,0,3,3,2,2,0,4,2,4
Voshon Lenard,SG,30,DEN,73,70,2233,394,933,0.42200000000000004,106,289,0.36700000000000005,288,644,0.447,0.479,144,182,0.7909999999999999,46,154,200,151,61,12,101,177,1038
Quincy Lewis,SF,26,MIN,14,0,65,7,20,0.35,2,5,0.4,5,15,0.33299999999999996,0.4,0,0,0.0,1,6,7,2,2,2,3,10,16
Rashard Lewis,SF,24,SEA,80,80,2931,535,1229,0.435,145,386,0.376,390,843,0.46299999999999997,0.494,206,270,0.763,133,385,518,175,99,54,135,233,1421
Randy Livingston,PG,28,LAC,4,0,48,2,10,0.2,0,3,0.0,2,7,0.28600000000000003,0.2,4,6,0.667,2,5,7,4,2,0,4,7,8
Raül López,PG,23,UTA,82,11,1617,223,517,0.431,25,85,0.294,198,432,0.45799999999999996,0.456,101,117,0.863,24,131,155,305,62,2,174,200,572
Tyronn Lue,PG,26,ORL,76,69,2332,309,714,0.433,80,209,0.38299999999999995,229,505,0.45299999999999996,0.489,101,131,0.7709999999999999,26,161,187,317,61,5,124,185,799
George Lynch,SF,33,NOH,78,51,1701,149,375,0.397,43,139,0.309,106,236,0.449,0.455,34,51,0.667,96,216,312,117,48,18,64,159,375
Mark Madsen,C,28,MIN,72,12,1246,101,204,0.495,0,6,0.0,101,198,0.51,0.495,57,118,0.483,134,138,272,28,33,18,47,175,259
Corey Maggette,SF,24,LAC,73,72,2628,453,1013,0.447,76,231,0.32899999999999996,377,782,0.48200000000000004,0.485,526,620,0.848,96,334,430,224,65,16,207,217,1508
Jamaal Magloire,C,25,NOH,82,82,2777,383,809,0.473,0,1,0.0,383,808,0.474,0.473,353,470,0.7509999999999999,268,579,847,86,43,101,201,278,1119
Karl Malone*,PF,40,LAL,42,42,1373,193,400,0.483,0,1,0.0,193,399,0.484,0.483,168,225,0.747,61,306,367,163,50,20,103,116,554
Stephon Marbury,PG,26,TOT,81,81,3254,598,1386,0.431,87,274,0.318,511,1112,0.46,0.46299999999999997,356,436,0.8170000000000001,58,205,263,719,129,9,249,172,1639
Shawn Marion,SF,25,PHO,79,79,3217,590,1341,0.44,90,265,0.34,500,1076,0.465,0.474,228,268,0.851,212,525,737,214,167,104,156,203,1498
Donyell Marshall,PF,30,TOT,82,74,2988,470,1020,0.461,131,325,0.40299999999999997,339,695,0.488,0.525,134,182,0.736,210,598,808,122,93,124,117,247,1205
Darrick Martin,PG,32,MIN,16,0,172,20,67,0.299,6,26,0.231,14,41,0.341,0.34299999999999997,9,9,1.0,2,5,7,23,2,1,7,23,55
Kenyon Martin,PF,26,NJN,65,62,2252,439,900,0.488,7,25,0.28,432,875,0.494,0.49200000000000005,201,294,0.684,133,484,617,160,95,82,168,230,1086
Jamal Mashburn,SF,31,NOH,19,18,730,156,398,0.392,19,67,0.284,137,331,0.414,0.41600000000000004,65,80,0.813,19,98,117,47,14,5,37,42,396
Desmond Mason,SF,26,MIL,82,31,2534,409,867,0.47200000000000003,9,39,0.231,400,828,0.483,0.47700000000000004,356,463,0.769,93,266,359,152,60,24,148,191,1183
Roger Mason,SG,23,TOT,26,3,328,32,98,0.327,13,39,0.33299999999999996,19,59,0.322,0.39299999999999996,19,22,0.8640000000000001,1,30,31,26,11,6,20,36,96
Tony Massenburg,PF,36,SAC,59,0,789,104,219,0.475,0,1,0.0,104,218,0.47700000000000004,0.475,43,63,0.6829999999999999,57,131,188,29,14,18,45,144,251
Walter McCarty,PF,29,BOS,77,23,1900,203,523,0.38799999999999996,137,366,0.374,66,157,0.42,0.519,62,82,0.7559999999999999,28,211,239,124,72,22,91,179,605
Amal McCaskill,C,30,PHI,59,3,636,47,117,0.402,0,1,0.0,47,116,0.405,0.402,19,27,0.7040000000000001,48,85,133,20,12,20,25,89,113
Jelani McCoy,C,26,CLE,2,0,12,0,0,0.0,0,0,0.0,0,0,0.0,0.0,0,0,0.0,1,3,4,0,0,0,1,4,0
Antonio McDyess,PF,29,TOT,42,20,927,126,268,0.47,0,0,0.0,126,268,0.47,0.47,38,69,0.551,70,187,257,36,37,24,57,117,290
Tracy McGrady*,SG,24,ORL,67,67,2675,653,1566,0.41700000000000004,174,513,0.33899999999999997,479,1053,0.455,0.473,398,500,0.7959999999999999,95,307,402,370,93,42,179,129,1878
Jeff McInnis,SG-PG,29,TOT,70,57,2365,334,747,0.447,46,127,0.36200000000000004,288,620,0.465,0.478,114,143,0.797,33,143,176,430,72,6,120,163,828
Aaron McKie,SF,31,PHI,75,41,2112,265,577,0.45899999999999996,75,172,0.436,190,405,0.469,0.524,84,111,0.757,45,208,253,195,85,23,103,142,689
Keith McLeod,PG,24,MIN,33,0,391,27,82,0.32899999999999996,1,10,0.1,26,72,0.361,0.335,33,43,0.767,5,29,34,59,16,1,29,39,88
Stanislav Medvedenko,PF,24,LAL,68,38,1442,237,537,0.441,0,3,0.0,237,534,0.444,0.441,89,116,0.767,148,195,343,57,38,18,59,191,563
Ron Mercer,SG,27,SAS,39,0,516,90,211,0.42700000000000005,2,7,0.28600000000000003,88,204,0.431,0.431,13,17,0.765,10,39,49,22,14,5,26,37,195
Chris Mihm,C-PF,24,TOT,76,17,1330,186,381,0.488,0,0,0.0,186,381,0.488,0.488,110,166,0.6629999999999999,156,257,413,21,37,63,90,208,482
Darius Miles,SF,22,TOT,79,56,2079,365,753,0.485,7,40,0.175,358,713,0.502,0.489,124,193,0.642,112,247,359,162,67,61,130,168,861
Darko Miličić,C,18,DET,34,0,159,17,65,0.262,0,1,0.0,17,64,0.266,0.262,14,24,0.583,11,32,43,7,7,15,13,33,48
Andre Miller,PG,27,DEN,82,82,2838,430,941,0.457,12,65,0.185,418,876,0.47700000000000004,0.46299999999999997,342,411,0.8320000000000001,127,239,366,501,142,25,215,194,1214
Brad Miller,PF,27,SAC,72,53,2621,373,731,0.51,12,38,0.316,361,693,0.521,0.518,256,329,0.778,191,552,743,312,68,86,144,247,1014
Mike Miller,SF,23,MEM,65,65,1770,270,616,0.43799999999999994,80,215,0.37200000000000005,190,401,0.474,0.503,102,141,0.723,42,174,216,232,59,14,107,162,722
Oliver Miller,C,33,MIN,48,1,506,53,100,0.53,0,1,0.0,53,99,0.535,0.53,15,23,0.652,46,84,130,36,19,26,33,91,121
Reggie Miller*,SG,38,IND,80,80,2254,260,594,0.43799999999999994,134,334,0.401,126,260,0.485,0.551,146,165,0.885,18,170,188,249,65,11,68,96,800
Yao Ming*,C,23,HOU,82,82,2692,535,1025,0.522,0,2,0.0,535,1023,0.523,0.522,361,446,0.809,197,538,735,122,22,156,204,273,1431
Cuttino Mobley,SG,28,HOU,80,80,3229,460,1081,0.426,164,420,0.39,296,661,0.44799999999999995,0.501,176,217,0.8109999999999999,40,322,362,258,107,33,180,179,1260
Nazr Mohammed,C,26,TOT,80,24,1611,246,472,0.521,0,0,0.0,246,472,0.521,0.521,100,169,0.5920000000000001,178,296,474,36,55,52,96,195,592
Jérôme Moïso,PF,25,TOR,35,1,417,40,84,0.47600000000000003,0,1,0.0,40,83,0.48200000000000004,0.47600000000000003,22,38,0.579,41,72,113,8,17,12,25,42,102
Mikki Moore,PF-C,28,TOT,32,0,395,50,99,0.505,0,0,0.0,50,99,0.505,0.505,30,35,0.857,29,55,84,19,7,13,22,65,130
Alonzo Mourning*,C,33,NJN,12,0,215,33,71,0.465,0,0,0.0,33,71,0.465,0.465,30,34,0.882,8,19,27,8,2,6,10,32,96
Troy Murphy,PF,23,GSW,28,0,610,107,243,0.44,5,17,0.294,102,226,0.451,0.451,60,80,0.75,48,125,173,20,12,17,34,58,279
Lamond Murray,SF,30,TOR,33,4,518,76,215,0.353,21,60,0.35,55,155,0.355,0.402,24,35,0.6859999999999999,14,76,90,28,15,7,38,47,197
Ronald Murray,PG,24,SEA,82,18,2021,389,915,0.425,67,229,0.293,322,686,0.469,0.462,168,235,0.715,45,159,204,205,81,28,149,158,1013
Tracy Murray,SF,32,POR,7,0,35,3,12,0.25,2,5,0.4,1,7,0.14300000000000002,0.33299999999999996,0,1,0.0,3,2,5,1,1,0,2,3,8
Dikembe Mutombo*,C,37,NYK,65,56,1494,141,295,0.478,0,0,0.0,141,295,0.478,0.478,81,119,0.6809999999999999,145,292,437,25,17,123,54,141,363
Mamadou N'Diaye,C,28,TOT,28,1,366,27,69,0.391,0,0,0.0,27,69,0.391,0.391,44,59,0.746,43,69,112,0,8,25,18,59,98
Boštjan Nachbar,SF,23,HOU,45,3,516,47,132,0.35600000000000004,23,63,0.365,24,69,0.348,0.44299999999999995,21,29,0.7240000000000001,8,62,70,30,14,14,23,72,138
Lee Nailon,PF-SF,28,TOT,57,4,780,147,327,0.45,0,3,0.0,147,324,0.45399999999999996,0.45,47,58,0.81,64,79,143,38,15,8,45,93,341
Eduardo Nájera,SF,27,DAL,58,7,720,72,162,0.444,2,4,0.5,70,158,0.44299999999999995,0.451,30,46,0.652,67,89,156,25,35,19,29,90,176
Steve Nash*,PG,29,DAL,78,78,2612,397,845,0.47,104,257,0.405,293,588,0.498,0.531,230,251,0.9159999999999999,59,173,232,687,67,8,209,139,1128
Rasho Nesterović,C,27,SAS,82,82,2353,328,700,0.469,0,0,0.0,328,700,0.469,0.469,54,114,0.474,257,376,633,114,51,165,107,247,710
Ira Newble,SF,29,CLE,64,25,1245,108,276,0.391,2,19,0.105,106,257,0.41200000000000003,0.395,36,46,0.7829999999999999,65,90,155,72,25,19,54,109,254
Moochie Norris,PG,30,TOT,66,0,847,80,217,0.369,20,58,0.345,60,159,0.377,0.415,54,71,0.7609999999999999,10,55,65,121,44,5,64,51,234
Dirk Nowitzki,C,25,DAL,77,77,2915,605,1310,0.462,99,290,0.341,506,1020,0.496,0.5,371,423,0.877,90,580,670,207,92,104,135,216,1680
Jermaine O'Neal,PF,25,IND,78,78,2788,608,1400,0.434,2,18,0.111,606,1382,0.43799999999999994,0.435,348,460,0.757,193,585,778,164,59,199,181,248,1566
Shaquille O'Neal*,C,31,LAL,67,67,2464,554,948,0.584,0,0,0.0,554,948,0.584,0.584,331,676,0.49,246,523,769,196,34,166,195,225,1439
Charles Oakley,PF,40,HOU,7,0,25,2,6,0.33299999999999996,0,0,0.0,2,6,0.33299999999999996,0.33299999999999996,5,6,0.833,0,5,5,2,0,0,1,8,9
Lamar Odom,PF,24,MIA,80,80,3003,485,1127,0.43,61,205,0.298,424,922,0.46,0.457,340,458,0.742,160,616,776,327,85,71,236,273,1371
Mehmet Okur,PF,24,DET,71,33,1580,251,542,0.46299999999999997,18,48,0.375,233,494,0.47200000000000003,0.48,162,209,0.775,160,261,421,69,36,63,101,138,682
Kevin Ollie,PG,31,CLE,82,7,1401,95,257,0.37,4,9,0.444,91,248,0.36700000000000005,0.377,147,176,0.835,23,147,170,234,51,8,81,119,341
Michael Olowokandi,C,28,MIN,43,25,925,121,285,0.425,0,0,0.0,121,285,0.425,0.425,36,61,0.59,78,167,245,24,16,68,54,137,278
Greg Ostertag,C,30,UTA,78,51,2153,208,437,0.47600000000000003,0,1,0.0,208,436,0.47700000000000004,0.47600000000000003,113,195,0.579,221,357,578,123,30,139,99,228,529
Bo Outlaw,PF,32,MEM,82,1,1606,159,312,0.51,0,4,0.0,159,308,0.516,0.51,61,116,0.526,125,217,342,90,73,70,69,170,379
Travis Outlaw,PF,19,POR,8,0,19,3,7,0.429,0,0,0.0,3,7,0.429,0.429,2,4,0.5,2,2,4,1,1,0,1,1,8
Doug Overton,PG,34,TOT,61,11,1033,99,245,0.40399999999999997,3,23,0.13,96,222,0.43200000000000005,0.41,23,31,0.742,16,70,86,138,26,2,58,89,224
Zaza Pachulia,C,19,ORL,59,2,664,68,175,0.389,0,0,0.0,68,175,0.389,0.389,58,90,0.644,69,105,174,13,21,12,34,87,194
Robert Pack,PG,34,NJN,26,0,220,22,52,0.423,0,0,0.0,22,52,0.423,0.423,5,6,0.833,4,14,18,27,12,1,16,20,49
Scott Padgett,PF,27,HOU,58,5,547,74,167,0.44299999999999995,28,65,0.431,46,102,0.451,0.527,24,32,0.75,46,93,139,23,12,13,22,73,200
Milt Palacio,PG,25,TOR,59,13,1211,104,298,0.349,4,26,0.154,100,272,0.368,0.35600000000000004,45,68,0.662,15,87,102,184,41,11,87,90,257
Jannero Pargo,PG,24,TOT,31,1,479,81,199,0.40700000000000003,22,62,0.355,59,137,0.431,0.462,23,27,0.852,8,29,37,70,13,6,47,50,207
Tony Parker,PG,21,SAS,75,75,2577,423,946,0.447,62,199,0.312,361,747,0.483,0.48,191,272,0.7020000000000001,43,194,237,411,61,7,179,148,1099
Cherokee Parks,C,31,GSW,12,0,64,4,10,0.4,0,0,0.0,4,10,0.4,0.4,4,6,0.667,4,6,10,1,0,3,2,7,12
Ruben Patterson,SF,28,POR,73,1,1651,200,395,0.506,2,12,0.16699999999999998,198,383,0.517,0.509,105,190,0.5529999999999999,129,139,268,139,84,21,105,152,507
Sasha Pavlović,SF,20,UTA,79,14,1144,149,376,0.396,19,70,0.271,130,306,0.425,0.42200000000000004,65,84,0.774,44,115,159,60,41,16,67,187,382
Gary Payton*,PG,35,LAL,82,82,2825,482,1024,0.47100000000000003,55,165,0.33299999999999996,427,859,0.49700000000000005,0.498,180,252,0.7140000000000001,72,270,342,449,96,19,151,169,1199
Anthony Peeler,SG,34,SAC,75,0,1391,156,348,0.44799999999999995,68,141,0.48200000000000004,88,207,0.425,0.546,51,61,0.836,31,122,153,120,56,10,77,103,431
Desmond Penigar,PF,22,ORL,10,0,89,14,28,0.5,0,0,0.0,14,28,0.5,0.5,4,4,1.0,6,18,24,3,2,2,6,14,32
Kirk Penney,SG,23,MIA,2,0,18,1,6,0.16699999999999998,1,3,0.33299999999999996,0,3,0.0,0.25,0,0,0.0,0,1,1,1,1,0,3,1,3
Kendrick Perkins,C,19,BOS,10,0,35,8,15,0.5329999999999999,0,0,0.0,8,15,0.5329999999999999,0.5329999999999999,6,9,0.667,5,9,14,3,0,2,5,6,22
Wesley Person,SG,32,TOT,58,0,1037,126,314,0.401,55,138,0.39899999999999997,71,176,0.40299999999999997,0.489,31,39,0.795,16,101,117,66,19,9,38,38,338
Morris Peterson,SF,26,TOR,82,29,2148,238,587,0.405,126,340,0.371,112,247,0.45299999999999996,0.513,76,94,0.809,35,226,261,113,88,14,69,206,678
Eric Piatkowski,SF,33,HOU,49,0,703,72,191,0.377,43,122,0.35200000000000004,29,69,0.42,0.49,14,16,0.875,10,63,73,26,16,5,29,42,201
Paul Pierce,SG,26,BOS,80,80,3099,602,1497,0.402,115,384,0.299,487,1113,0.43799999999999994,0.441,517,631,0.8190000000000001,69,453,522,410,131,52,303,234,1836
Mickaël Piétrus,PG,21,GSW,53,22,748,96,231,0.41600000000000004,35,105,0.33299999999999996,61,126,0.484,0.491,52,75,0.693,48,71,119,27,32,12,40,100,279
Scottie Pippen*,SF,38,CHI,23,6,412,53,140,0.379,13,48,0.271,40,92,0.435,0.425,17,27,0.63,20,48,68,50,21,9,29,38,136
Zoran Planinić,SG,21,NJN,49,1,473,53,129,0.41100000000000003,9,32,0.281,44,97,0.45399999999999996,0.446,38,60,0.633,14,41,55,68,13,3,36,70,153
Scot Pollard,C,28,IND,61,3,678,47,114,0.41200000000000003,0,0,0.0,47,114,0.41200000000000003,0.41200000000000003,12,21,0.5710000000000001,67,97,164,10,23,26,22,110,106
Olden Polynice,C,39,LAC,2,0,12,0,0,0.0,0,0,0.0,0,0,0.0,0.0,0,0,0.0,1,1,2,1,1,0,4,2,0
Mark Pope,PF,31,DEN,4,0,20,1,2,0.5,0,0,0.0,1,2,0.5,0.5,0,1,0.0,0,3,3,0,1,0,3,8,2
James Posey,SG,27,MEM,82,82,2451,368,770,0.478,112,290,0.386,256,480,0.5329999999999999,0.551,278,335,0.83,92,311,403,122,137,40,112,248,1126
Vitaly Potapenko,C,28,SEA,65,39,1419,200,409,0.489,0,0,0.0,200,409,0.489,0.489,59,92,0.6409999999999999,101,188,289,53,22,28,77,161,459
Tayshaun Prince,SF,23,DET,82,80,2701,338,723,0.467,57,157,0.363,281,566,0.496,0.507,108,141,0.7659999999999999,93,297,390,191,63,69,119,149,841
Joel Przybilla,C,24,TOT,17,12,347,18,50,0.36,0,0,0.0,18,50,0.36,0.36,13,31,0.419,32,79,111,7,5,17,18,53,49
Vladimir Radmanović,PF,23,SEA,77,38,2321,345,812,0.425,140,377,0.371,205,435,0.47100000000000003,0.511,95,127,0.748,104,302,406,142,80,42,109,187,925
Zach Randolph,PF,22,POR,81,80,3067,663,1368,0.485,1,5,0.2,662,1363,0.486,0.485,299,393,0.7609999999999999,242,609,851,163,68,41,247,227,1626
Theo Ratliff,C,30,TOT,85,83,2664,266,549,0.485,0,0,0.0,266,549,0.485,0.485,140,217,0.645,195,419,614,71,54,307,120,300,672
Željko Rebrača,C,31,TOT,24,2,273,34,77,0.442,0,0,0.0,34,77,0.442,0.442,23,30,0.767,23,35,58,6,5,11,17,52,91
Michael Redd,SG,24,MIL,82,82,3021,633,1439,0.44,127,363,0.35,506,1076,0.47,0.484,383,441,0.868,118,289,407,185,81,6,116,152,1776
Glen Rice,SF,36,LAC,18,0,262,22,76,0.289,5,28,0.179,17,48,0.354,0.322,17,17,1.0,9,32,41,24,6,0,13,22,66
Jason Richardson,SG,23,GSW,78,78,2936,563,1284,0.43799999999999994,77,273,0.282,486,1011,0.48100000000000004,0.46799999999999997,258,377,0.684,124,400,524,226,86,41,196,182,1461
Quentin Richardson,SG,23,LAC,65,64,2338,425,1068,0.39799999999999996,120,341,0.35200000000000004,305,727,0.42,0.45399999999999996,151,204,0.74,146,268,414,139,67,19,141,130,1121
Luke Ridnour,PG,22,SEA,69,6,1114,145,350,0.414,27,80,0.33799999999999997,118,270,0.43700000000000006,0.45299999999999996,65,79,0.823,35,73,108,163,52,7,80,105,382
Clifford Robinson,PF,37,GSW,82,82,2846,366,945,0.387,112,314,0.35700000000000004,254,631,0.40299999999999997,0.447,123,173,0.711,54,268,322,271,68,73,173,237,967
Eddie Robinson,SF,27,CHI,51,4,1024,157,326,0.48200000000000004,1,5,0.2,156,321,0.486,0.483,28,43,0.6509999999999999,27,77,104,58,33,10,45,57,343
Glenn Robinson,SF,31,PHI,42,42,1336,275,614,0.44799999999999995,34,100,0.34,241,514,0.469,0.47600000000000003,114,137,0.8320000000000001,46,143,189,57,42,9,106,96,698
Rodney Rogers,PF,32,NJN,69,15,1409,207,505,0.41,50,152,0.32899999999999996,157,353,0.445,0.45899999999999996,75,98,0.765,100,207,307,137,59,27,98,183,539
Sean Rooks,C,34,TOT,55,0,595,54,151,0.358,0,1,0.0,54,150,0.36,0.358,33,37,0.892,24,73,97,29,14,10,22,89,141
Jalen Rose,PG-SF,31,TOT,66,64,2497,383,952,0.402,69,202,0.342,314,750,0.419,0.439,187,231,0.81,34,232,266,329,51,22,208,184,1022
Malik Rose,PF,29,SAS,67,13,1256,173,404,0.428,0,3,0.0,173,401,0.431,0.428,183,225,0.813,110,210,320,69,36,24,112,164,529
Michael Ruffin,PF,27,UTA,41,23,733,38,117,0.325,0,0,0.0,38,117,0.325,0.325,16,38,0.42100000000000004,78,129,207,41,22,21,42,103,92
Kareem Rush,SG,23,LAL,72,15,1244,190,432,0.44,48,138,0.348,142,294,0.483,0.495,31,52,0.596,20,77,97,59,33,20,48,109,459
Bryon Russell,SF,33,LAL,72,1,945,98,244,0.402,43,112,0.384,55,132,0.41700000000000004,0.49,50,65,0.769,32,114,146,71,32,12,37,110,289
John Salmons,SG,24,PHI,77,24,1603,161,416,0.387,50,147,0.34,111,269,0.413,0.447,71,92,0.772,38,158,196,134,62,16,77,122,443
Jamal Sampson,C,20,LAL,10,2,130,11,23,0.478,0,0,0.0,11,23,0.478,0.478,7,12,0.583,23,29,52,7,2,4,6,16,29
Daniel Santiago,C,27,MIL,54,28,708,78,163,0.479,0,0,0.0,78,163,0.479,0.479,61,90,0.6779999999999999,35,97,132,24,19,21,32,98,217
Brian Scalabrine,PF,25,NJN,69,2,928,86,218,0.39399999999999996,10,41,0.244,76,177,0.429,0.41700000000000004,58,70,0.8290000000000001,42,131,173,65,21,14,42,113,240
Ansu Sesay,SF,27,SEA,57,2,583,81,178,0.455,6,21,0.28600000000000003,75,157,0.478,0.47200000000000003,32,46,0.696,43,49,92,19,19,20,23,66,200
Paul Shirley,PF,26,CHI,7,0,86,10,23,0.435,0,1,0.0,10,22,0.455,0.435,1,3,0.33299999999999996,8,8,16,4,1,1,9,9,21
Bobby Simmons,SF,23,LAC,56,8,1376,147,373,0.39399999999999996,2,12,0.16699999999999998,145,361,0.402,0.397,141,169,0.8340000000000001,115,147,262,96,51,17,73,169,437
Brian Skinner,C,27,MIL,56,54,1577,255,513,0.49700000000000005,0,0,0.0,255,513,0.49700000000000005,0.49700000000000005,79,138,0.5720000000000001,119,292,411,49,30,61,78,165,589
Tamar Slay,SG,23,NJN,22,0,165,21,60,0.35,4,12,0.33299999999999996,17,48,0.354,0.38299999999999995,7,14,0.5,10,15,25,14,7,1,11,20,53
Jabari Smith,C,26,SAC,31,0,168,26,70,0.371,0,3,0.0,26,67,0.38799999999999996,0.371,12,20,0.6,11,20,31,11,2,6,7,25,64
Joe Smith,PF,28,MIL,76,76,2254,311,708,0.439,1,5,0.2,310,703,0.441,0.44,207,241,0.8590000000000001,230,413,643,78,47,94,82,209,830
Leon Smith,C,23,SEA,1,0,4,1,2,0.5,0,0,0.0,1,2,0.5,0.5,0,0,0.0,1,1,2,0,0,0,0,1,2
Steve Smith,SG,34,NOH,71,4,929,119,293,0.406,43,107,0.402,76,186,0.409,0.48,77,83,0.9279999999999999,27,54,81,56,15,6,42,91,358
Theron Smith,SF,23,MEM,20,0,178,16,43,0.37200000000000005,6,12,0.5,10,31,0.32299999999999995,0.442,6,8,0.75,13,28,41,7,5,5,14,18,44
Eric Snow,PG,30,PHI,82,82,2966,295,715,0.413,2,18,0.111,293,697,0.42,0.414,252,316,0.797,62,219,281,563,97,6,187,213,844
Darius Songaila,PF,25,SAC,73,7,976,133,273,0.48700000000000004,0,0,0.0,133,273,0.48700000000000004,0.48700000000000004,71,88,0.807,91,134,225,48,42,12,43,126,337
Latrell Sprewell,SF,33,MIN,82,82,3100,518,1266,0.409,99,299,0.331,419,967,0.433,0.44799999999999995,240,295,0.8140000000000001,56,254,310,286,88,21,158,101,1375
Jerry Stackhouse,SF,29,WAS,26,17,774,128,321,0.39899999999999997,23,65,0.354,105,256,0.41,0.435,83,103,0.8059999999999999,16,78,94,103,24,3,88,49,362
Vladimir Stepania,C,27,POR,42,2,453,43,103,0.41700000000000004,0,0,0.0,43,103,0.41700000000000004,0.41700000000000004,22,36,0.611,50,75,125,23,11,15,19,61,108
DeShawn Stevenson,SG-SF,22,TOT,80,78,2444,376,871,0.43200000000000005,19,71,0.268,357,800,0.446,0.44299999999999995,138,204,0.6759999999999999,79,219,298,158,52,17,120,140,909
Michael Stewart,C-PF,28,TOT,25,2,147,5,12,0.41700000000000004,0,0,0.0,5,12,0.41700000000000004,0.41700000000000004,3,4,0.75,8,21,29,0,2,10,3,34,13
Peja Stojaković,SF,26,SAC,81,81,3264,665,1386,0.48,240,554,0.433,425,832,0.511,0.5660000000000001,394,425,0.927,91,417,508,173,108,14,153,159,1964
Damon Stoudamire,PG,30,POR,82,82,3118,408,1018,0.401,156,427,0.365,252,591,0.426,0.47700000000000004,127,145,0.8759999999999999,52,256,308,500,99,9,180,173,1099
Amar'e Stoudemire,PF,21,PHO,55,53,2025,411,865,0.475,1,5,0.2,410,860,0.47700000000000004,0.47600000000000003,310,435,0.713,157,339,496,78,64,89,177,188,1133
Erick Strickland,PG,30,MIL,43,0,571,79,196,0.40299999999999997,29,66,0.439,50,130,0.385,0.47700000000000004,44,51,0.863,13,58,71,90,26,2,54,63,231
Rod Strickland,PG,37,TOT,61,10,1197,150,353,0.425,10,36,0.278,140,317,0.442,0.439,72,98,0.735,34,121,155,244,35,11,85,76,382
Bruno Šundov,C,23,TOT,5,0,33,4,10,0.4,0,0,0.0,4,10,0.4,0.4,3,6,0.5,2,8,10,1,0,0,3,9,11
Bob Sura,SG,30,TOT,80,18,1663,202,485,0.41600000000000004,21,79,0.266,181,406,0.446,0.43799999999999994,171,226,0.757,100,226,326,233,62,14,105,158,596
Mike Sweetney,PF,21,NYK,42,1,494,69,140,0.493,0,1,0.0,69,139,0.496,0.493,42,58,0.7240000000000001,68,89,157,14,18,12,32,57,180
Stromile Swift,PF,24,MEM,77,10,1528,268,571,0.469,1,4,0.25,267,567,0.47100000000000003,0.47,190,262,0.725,141,237,378,38,56,118,88,188,727
Wally Szczerbiak,SF,26,MIN,28,0,622,106,236,0.449,20,46,0.435,86,190,0.45299999999999996,0.49200000000000005,53,64,0.828,24,64,88,33,12,1,28,42,285
Maurice Taylor,PF,27,HOU,75,10,2081,367,765,0.48,0,2,0.0,367,763,0.48100000000000004,0.48,128,174,0.736,131,253,384,107,43,47,149,253,862
Jason Terry,PG,26,ATL,81,78,3018,499,1196,0.41700000000000004,146,421,0.34700000000000003,353,775,0.455,0.478,215,260,0.8270000000000001,49,287,336,437,124,16,229,192,1359
Etan Thomas,C,25,WAS,79,15,1901,257,526,0.489,0,0,0.0,257,526,0.489,0.489,191,295,0.647,183,345,528,68,36,123,113,219,705
Kenny Thomas,PF,26,PHI,74,72,2699,381,813,0.469,1,5,0.2,380,808,0.47,0.469,243,323,0.752,261,489,750,111,82,33,172,219,1006
Kurt Thomas,PF,31,NYK,80,75,2548,392,829,0.473,0,3,0.0,392,826,0.475,0.473,106,127,0.835,145,517,662,149,56,80,132,298,890
Tim Thomas,SF,26,TOT,66,65,2089,363,813,0.446,73,194,0.376,290,619,0.46799999999999997,0.491,171,218,0.784,64,256,320,124,64,20,116,196,970
Jamaal Tinsley,PG,25,IND,52,43,1378,153,370,0.414,77,207,0.37200000000000005,76,163,0.466,0.518,49,67,0.731,28,108,136,303,84,17,110,132,432
Robert Traylor,C,26,NOH,71,0,942,145,287,0.505,2,5,0.4,143,282,0.507,0.509,70,128,0.547,106,156,262,43,39,37,62,161,362
Gary Trent,C,29,MIN,68,2,1025,155,328,0.473,0,6,0.0,155,322,0.48100000000000004,0.473,69,91,0.758,83,133,216,49,12,17,54,129,379
Jeff Trepagnier,SG,24,DEN,11,0,96,10,38,0.263,2,4,0.5,8,34,0.235,0.289,3,6,0.5,6,9,15,4,3,0,6,7,25
Cezary Trybański,C,24,TOT,7,0,15,0,4,0.0,0,0,0.0,0,4,0.0,0.0,1,2,0.5,0,1,1,0,1,1,2,3,1
Jake Tsakalidis,C,24,MEM,40,28,533,67,133,0.504,0,0,0.0,67,133,0.504,0.504,36,61,0.59,37,91,128,18,9,22,23,79,170
Nikoloz Tskitishvili,PF,20,DEN,39,0,307,40,122,0.32799999999999996,3,11,0.273,37,111,0.33299999999999996,0.34,23,29,0.7929999999999999,24,39,63,10,6,8,17,50,106
Hedo Türkoğlu,SF,24,SAS,80,44,2073,262,645,0.406,101,241,0.419,161,404,0.39899999999999997,0.484,114,161,0.708,52,306,358,154,80,32,94,165,739
Ime Udoka,SF,26,LAL,4,0,28,3,9,0.33299999999999996,0,1,0.0,3,8,0.375,0.33299999999999996,2,4,0.5,1,4,5,2,2,1,3,3,8
Nick Van Exel,PG,32,GSW,39,29,1255,187,479,0.39,46,150,0.307,141,329,0.429,0.43799999999999994,70,99,0.7070000000000001,16,88,104,206,20,2,78,57,490
Keith Van Horn,SF,28,TOT,72,62,2340,410,903,0.45399999999999996,93,233,0.39899999999999997,317,670,0.473,0.506,249,290,0.8590000000000001,149,352,501,120,68,33,169,215,1162
Jacque Vaughn,PG,28,ATL,71,6,1271,107,277,0.386,3,20,0.15,104,257,0.405,0.392,53,68,0.779,12,104,116,195,44,2,84,126,270
Jake Voskuhl,C,26,PHO,66,43,1606,152,300,0.507,0,0,0.0,152,300,0.507,0.507,134,181,0.74,123,220,343,57,42,25,77,258,438
Slavko Vraneš,C,21,POR,1,0,3,0,1,0.0,0,0,0.0,0,1,0.0,0.0,0,0,0.0,0,0,0,0,0,0,0,1,0
Dwyane Wade,PG,22,MIA,61,56,2126,371,798,0.465,16,53,0.302,355,745,0.47700000000000004,0.475,233,312,0.747,85,162,247,275,86,34,196,140,991
Dajuan Wagner,SG,20,CLE,44,4,708,112,306,0.366,31,86,0.36,81,220,0.368,0.41700000000000004,32,47,0.6809999999999999,9,49,58,51,26,7,41,89,287
Antoine Walker,PF,27,DAL,82,82,2840,483,1129,0.428,82,305,0.26899999999999996,401,824,0.48700000000000004,0.46399999999999997,103,186,0.5539999999999999,198,486,684,369,65,65,202,212,1151
Samaki Walker,PF,27,MIA,33,0,418,38,99,0.384,0,2,0.0,38,97,0.392,0.384,29,44,0.659,42,70,112,6,9,11,15,54,105
Ben Wallace,C,29,DET,81,81,3050,315,748,0.42100000000000004,1,8,0.125,314,740,0.424,0.42200000000000004,142,290,0.49,324,682,1006,138,143,246,123,162,773
Gerald Wallace,SF,21,SAC,37,1,337,32,89,0.36,0,2,0.0,32,87,0.368,0.36,11,24,0.45799999999999996,35,39,74,19,14,14,8,37,75
John Wallace,SF,29,MIA,37,0,368,61,145,0.42100000000000004,5,13,0.385,56,132,0.424,0.43799999999999994,31,40,0.775,12,47,59,14,5,8,24,38,158
Rasheed Wallace,PF,29,TOT,68,66,2390,425,974,0.436,82,248,0.331,343,726,0.47200000000000003,0.478,156,212,0.736,102,357,459,156,61,122,119,190,1088
Luke Walton,PF,23,LAL,72,2,730,65,153,0.425,13,39,0.33299999999999996,52,114,0.456,0.467,31,44,0.705,39,88,127,113,28,8,44,70,174
Charlie Ward,PG,33,TOT,71,10,1252,160,390,0.41,84,206,0.408,76,184,0.413,0.518,20,27,0.741,12,132,144,215,64,11,96,107,424
Earl Watson,PG,24,MEM,81,14,1669,172,464,0.371,26,106,0.245,146,358,0.408,0.39899999999999997,90,138,0.652,49,129,178,402,91,19,146,175,460
Clarence Weatherspoon,PF,33,TOT,52,1,868,104,211,0.493,0,1,0.0,104,210,0.495,0.493,53,72,0.736,74,130,204,30,30,15,35,75,261
Chris Webber,PF,30,SAC,23,23,831,174,421,0.413,1,5,0.2,173,416,0.41600000000000004,0.414,81,114,0.711,48,152,200,105,31,20,60,76,430
Bonzi Wells,SG,27,TOT,72,27,1872,363,850,0.42700000000000005,22,69,0.319,341,781,0.43700000000000006,0.44,138,183,0.754,78,182,260,139,91,19,161,197,886
Jiří Welsch,SG,24,BOS,81,68,2179,262,612,0.428,69,181,0.381,193,431,0.44799999999999995,0.484,153,206,0.743,60,236,296,183,101,7,129,176,746
David Wesley,SG,33,NOH,61,60,2001,311,800,0.389,92,285,0.32299999999999995,219,515,0.425,0.446,137,182,0.753,28,106,134,175,71,14,100,147,851
David West,PF,23,NOH,71,1,930,108,228,0.474,0,2,0.0,108,226,0.478,0.474,57,80,0.713,117,180,297,60,27,28,48,117,273
Jahidi White,C,27,TOT,62,17,865,99,190,0.521,0,0,0.0,99,190,0.521,0.521,63,126,0.5,97,164,261,7,25,51,66,176,261
Rodney White,SF,23,DEN,72,0,985,215,468,0.45899999999999996,33,87,0.379,182,381,0.478,0.495,78,104,0.75,44,121,165,60,32,20,78,105,541
Chris Whitney,PG,32,WAS,16,5,186,17,45,0.37799999999999995,8,18,0.444,9,27,0.33299999999999996,0.467,5,5,1.0,3,12,15,14,6,2,6,6,47
Chris Wilcox,C,21,LAC,65,17,1340,227,436,0.521,0,1,0.0,227,435,0.522,0.521,105,150,0.7,125,180,305,51,29,20,80,183,559
Mike Wilks,PG,24,HOU,26,0,145,17,36,0.47200000000000003,6,10,0.6,11,26,0.423,0.556,10,12,0.833,3,13,16,17,3,0,7,15,50
Aaron Williams,C,32,NJN,72,7,1337,172,342,0.503,1,3,0.33299999999999996,171,339,0.504,0.504,105,155,0.677,101,193,294,81,34,46,89,187,450
Alvin Williams,SG,29,TOR,56,54,1730,201,496,0.405,26,89,0.292,175,407,0.43,0.431,66,85,0.7759999999999999,18,132,150,224,55,10,78,114,494
Eric Williams,SF,31,TOT,71,36,1886,231,598,0.386,35,127,0.276,196,471,0.41600000000000004,0.41600000000000004,215,283,0.76,65,221,286,120,70,9,88,180,712
Frank Williams,PG,23,NYK,56,3,714,80,208,0.385,18,60,0.3,62,148,0.419,0.428,41,48,0.8540000000000001,8,45,53,121,25,6,63,58,219
Jason Williams,PG,28,MEM,72,68,2115,290,713,0.40700000000000003,120,364,0.33,170,349,0.48700000000000004,0.491,82,98,0.8370000000000001,25,122,147,492,92,5,136,97,782
Jerome Williams,PF,30,TOT,68,44,1637,158,336,0.47,0,8,0.0,158,328,0.48200000000000004,0.47,106,155,0.684,177,298,475,72,90,8,74,134,422
Mo Williams,SG,21,UTA,57,0,772,115,303,0.38,10,39,0.256,105,264,0.39799999999999996,0.396,44,56,0.7859999999999999,23,49,72,76,28,2,51,87,284
Scott Williams,C,35,TOT,43,21,527,90,186,0.484,2,3,0.667,88,183,0.48100000000000004,0.489,16,27,0.593,38,94,132,17,20,16,16,95,198
Shammond Williams,SG-PG,28,TOT,53,4,763,87,232,0.375,30,100,0.3,57,132,0.43200000000000005,0.44,51,58,0.879,9,51,60,116,37,2,47,62,255
Corliss Williamson,PF,30,DET,79,0,1574,304,602,0.505,0,0,0.0,304,602,0.505,0.505,144,197,0.731,88,168,256,57,30,20,113,204,752
Kevin Willis,C,41,SAS,48,0,373,70,150,0.467,0,1,0.0,70,149,0.47,0.467,24,39,0.615,37,61,98,11,21,9,32,61,164
Loren Woods,C,25,MIA,38,2,506,44,96,0.45799999999999996,0,0,0.0,44,96,0.45799999999999996,0.45799999999999996,33,55,0.6,65,69,134,10,11,19,26,52,121
Qyntel Woods,SF,22,POR,62,8,673,88,237,0.371,10,29,0.345,78,208,0.375,0.392,38,60,0.633,46,90,136,46,20,14,52,88,224
Metta World Peace,SF,24,IND,73,71,2714,468,1112,0.42100000000000004,75,242,0.31,393,870,0.452,0.455,322,439,0.733,100,285,385,272,152,50,202,194,1333
Lorenzen Wright,C,28,MEM,65,46,1674,257,586,0.439,0,5,0.0,257,581,0.442,0.439,96,131,0.733,144,301,445,71,45,58,77,192,610
Wang Zhizhi,C,26,TOT,16,0,114,17,46,0.37,4,14,0.28600000000000003,13,32,0.406,0.413,9,10,0.9,4,14,18,2,3,5,6,13,47
