Player,Pos,Age,Tm,G,GS,MP,FG,FGA,FG%,3P,3PA,3P%,2P,2PA,2P%,eFG%,FT,FTA,FT%,ORB,DRB,TRB,AST,STL,BLK,TOV,PF,PTS
Tariq Abdul-Wahad,SG,25,TOT,61,56,1578,274,646,0.424,3,23,0.13,271,623,0.435,0.426,146,193,0.7559999999999999,101,190,291,98,59,28,106,147,697
Shareef Abdur-Rahim,SF,23,VAN,82,82,3223,594,1277,0.465,29,96,0.302,565,1181,0.478,0.47700000000000004,446,551,0.809,218,607,825,271,89,87,249,244,1663
Cory Alexander,PG,26,DEN,29,2,329,28,98,0.28600000000000003,9,35,0.257,19,63,0.302,0.332,17,22,0.773,8,34,42,58,24,2,28,39,82
Ray Allen*,SG,24,MIL,82,82,3070,642,1411,0.455,172,407,0.423,470,1004,0.46799999999999997,0.516,353,398,0.887,83,276,359,308,110,19,183,187,1809
Rafer Alston,PG,23,MIL,27,0,361,27,95,0.284,3,14,0.214,24,81,0.29600000000000004,0.3,3,4,0.75,5,18,23,70,12,0,29,29,60
John Amaechi,C,29,ORL,80,53,1684,306,700,0.43700000000000006,1,6,0.16699999999999998,305,694,0.439,0.43799999999999994,223,291,0.7659999999999999,62,204,266,95,35,37,139,161,836
Derek Anderson,SG,25,LAC,64,58,2201,377,860,0.43799999999999994,55,178,0.309,322,682,0.47200000000000003,0.47,271,309,0.877,80,178,258,220,90,11,167,149,1080
Kenny Anderson,PG,29,BOS,82,82,2593,434,986,0.44,85,220,0.386,349,766,0.456,0.483,196,253,0.775,55,170,225,420,139,8,130,230,1149
Nick Anderson,SG,32,SAC,72,72,2094,306,782,0.391,132,397,0.332,174,385,0.452,0.47600000000000003,37,76,0.48700000000000004,83,256,339,123,94,16,95,118,781
Shandon Anderson,SF,26,HOU,82,82,2700,368,778,0.473,79,225,0.35100000000000003,289,553,0.523,0.524,194,253,0.767,91,293,384,239,96,32,194,182,1009
Chris Anstey,C,25,CHI,73,11,1007,161,364,0.442,1,6,0.16699999999999998,160,358,0.447,0.444,116,147,0.789,90,190,280,65,29,25,80,180,439
Greg Anthony,PG,32,POR,82,3,1548,169,416,0.406,88,233,0.37799999999999995,81,183,0.44299999999999995,0.512,88,114,0.772,17,116,133,208,59,9,85,143,514
B.J. Armstrong,PG,32,CHI,27,18,583,83,186,0.446,13,29,0.44799999999999995,70,157,0.446,0.48100000000000004,22,25,0.88,2,45,47,78,7,1,40,34,201
Darrell Armstrong,PG,31,ORL,82,82,2590,484,1119,0.433,137,403,0.34,347,716,0.485,0.494,225,247,0.9109999999999999,65,205,270,501,169,9,248,137,1330
Chucky Atkins,PG,25,ORL,82,0,1626,314,741,0.424,57,163,0.35,257,578,0.445,0.462,97,133,0.7290000000000001,20,106,126,306,52,3,142,137,782
Stacey Augmon,SG,31,POR,59,0,692,83,175,0.474,0,2,0.0,83,173,0.48,0.474,37,55,0.6729999999999999,42,74,116,53,27,11,38,69,203
Isaac Austin,C,30,WAS,59,23,1173,151,352,0.429,1,4,0.25,150,348,0.431,0.43,94,137,0.6859999999999999,64,218,282,74,17,38,107,128,397
Anthony Avent,PF,30,LAC,49,3,377,29,96,0.302,0,0,0.0,29,96,0.302,0.302,23,32,0.7190000000000001,23,51,74,11,16,15,24,62,81
William Avery,PG,20,MIN,59,1,484,56,181,0.309,18,63,0.28600000000000003,38,118,0.322,0.359,24,36,0.667,8,32,40,88,14,2,42,60,154
Toby Bailey,SG,24,PHO,46,2,449,58,140,0.414,2,10,0.2,56,130,0.431,0.42100000000000004,45,65,0.6920000000000001,26,46,72,30,13,4,24,55,163
Vin Baker,C,28,SEA,79,75,2849,514,1129,0.455,2,8,0.25,512,1121,0.457,0.456,281,412,0.682,227,378,605,148,47,66,213,288,1311
Charles Barkley*,PF,36,HOU,20,18,620,106,222,0.47700000000000004,6,26,0.231,100,196,0.51,0.491,71,110,0.645,71,138,209,63,14,4,44,48,289
Dana Barros,PG,32,BOS,72,0,1139,196,435,0.451,59,144,0.41,137,291,0.47100000000000003,0.518,66,76,0.868,13,86,99,133,31,4,66,80,517
Brent Barry,SG,28,SEA,80,74,2726,327,707,0.46299999999999997,164,399,0.41100000000000003,163,308,0.529,0.579,127,157,0.809,50,322,372,291,103,31,142,228,945
Drew Barry,PG,26,TOT,16,0,159,15,33,0.455,7,18,0.389,8,15,0.5329999999999999,0.561,4,5,0.8,0,12,12,33,2,0,13,23,41
Jon Barry,SG,30,SAC,62,1,1281,161,346,0.465,66,154,0.429,95,192,0.495,0.561,107,116,0.922,38,121,159,150,75,7,85,104,495
Tony Battie,C,23,BOS,82,4,1505,219,459,0.47700000000000004,1,8,0.125,218,451,0.483,0.478,102,151,0.675,152,258,410,63,47,70,67,249,541
Jonathan Bender,SF,19,IND,24,1,130,23,70,0.32899999999999996,2,12,0.16699999999999998,21,58,0.36200000000000004,0.34299999999999997,16,24,0.667,4,17,21,3,1,5,7,18,64
Benoit Benjamin,C,35,CLE,3,0,8,1,3,0.33299999999999996,0,0,0.0,1,3,0.33299999999999996,0.33299999999999996,0,0,0.0,0,1,1,0,0,1,0,1,2
Corey Benjamin,SG,21,CHI,48,10,862,145,350,0.414,31,89,0.348,114,261,0.43700000000000006,0.45899999999999996,49,82,0.598,21,67,88,54,31,22,74,122,370
Mario Bennett,PF,26,LAC,1,0,3,0,3,0.0,0,0,0.0,0,3,0.0,0.0,0,0,0.0,1,1,2,0,0,0,0,1,0
Travis Best,PG,27,IND,82,0,1691,271,561,0.483,35,93,0.376,236,468,0.504,0.514,156,190,0.821,16,126,142,272,76,5,107,204,733
Mike Bibby,PG,21,VAN,82,82,3155,459,1031,0.445,77,212,0.363,382,819,0.466,0.483,195,250,0.78,73,233,306,665,132,15,247,171,1190
Chauncey Billups,SG,23,DEN,13,5,305,34,101,0.337,7,41,0.171,27,60,0.45,0.371,37,44,0.841,8,26,34,39,10,2,24,27,112
Mookie Blaylock,PG,32,GSW,73,72,2459,327,837,0.391,101,301,0.336,226,536,0.42200000000000004,0.451,67,95,0.705,55,215,270,489,146,22,143,122,822
Corie Blount,PF,31,PHO,38,1,446,44,89,0.494,0,2,0.0,44,87,0.506,0.494,19,33,0.5760000000000001,52,61,113,10,15,7,28,78,107
Muggsy Bogues,PG,35,TOR,80,5,1731,157,358,0.439,17,51,0.33299999999999996,140,307,0.456,0.462,79,87,0.9079999999999999,25,110,135,299,65,4,59,119,410
Etdrick Bohannon,PF,26,TOT,13,0,118,7,13,0.5379999999999999,0,0,0.0,7,13,0.5379999999999999,0.5379999999999999,15,24,0.625,13,18,31,5,2,6,10,25,29
Calvin Booth,C,23,WAS,11,0,143,16,46,0.348,0,0,0.0,16,46,0.348,0.348,10,14,0.7140000000000001,15,17,32,7,3,14,6,23,42
Lazaro Borrell,SF,27,SEA,17,6,167,28,63,0.444,0,3,0.0,28,60,0.467,0.444,6,11,0.545,14,26,40,10,6,3,6,9,62
Cal Bowdler,SF,22,ATL,46,0,423,49,115,0.426,0,1,0.0,49,114,0.43,0.426,24,38,0.632,22,63,85,14,14,9,21,46,122
Bruce Bowen,SF,28,TOT,69,2,878,72,194,0.371,27,58,0.466,45,136,0.331,0.441,25,43,0.581,27,69,96,34,23,15,19,118,196
Ryan Bowen,SF,24,DEN,52,0,589,46,117,0.39299999999999996,1,9,0.111,45,108,0.41700000000000004,0.397,38,53,0.7170000000000001,75,39,114,20,39,13,14,95,131
Ira Bowman,SG,26,PHI,11,0,20,2,2,1.0,0,0,0.0,2,2,1.0,1.0,1,2,0.5,0,2,2,1,1,0,1,0,5
Earl Boykins,PG,23,TOT,26,0,261,56,116,0.483,8,20,0.4,48,96,0.5,0.517,18,23,0.7829999999999999,12,14,26,48,12,1,17,23,138
Shawn Bradley,C,27,DAL,77,54,1901,266,555,0.479,1,5,0.2,265,550,0.48200000000000004,0.48,114,149,0.765,160,337,497,60,71,190,74,260,647
A.J. Bramlett,C,23,CLE,8,0,61,4,21,0.19,0,0,0.0,4,21,0.19,0.19,0,0,0.0,12,10,22,0,1,0,3,13,8
Elton Brand,PF,20,CHI,81,80,2999,630,1306,0.48200000000000004,0,2,0.0,630,1304,0.483,0.48200000000000004,367,536,0.685,348,462,810,155,66,132,228,259,1627
Terrell Brandon,PG,29,MIN,71,71,2587,486,1042,0.466,53,132,0.402,433,910,0.47600000000000003,0.49200000000000005,187,208,0.899,44,194,238,629,134,30,184,158,1212
Chucky Brown,PF,31,TOT,63,29,1096,148,328,0.451,2,10,0.2,146,318,0.45899999999999996,0.45399999999999996,36,52,0.6920000000000001,35,132,167,66,20,18,45,114,334
Dee Brown,PG,31,TOR,38,12,673,93,258,0.36,67,187,0.358,26,71,0.366,0.49,11,16,0.688,9,45,54,86,24,5,39,62,264
Marcus Brown,SG,25,DET,6,0,45,4,14,0.28600000000000003,0,7,0.0,4,7,0.5710000000000001,0.28600000000000003,2,2,1.0,3,4,7,3,0,0,3,8,10
P.J. Brown,PF,30,MIA,80,80,2302,322,671,0.48,0,1,0.0,322,670,0.48100000000000004,0.48,120,159,0.755,216,384,600,145,65,61,100,264,764
Randy Brown,PG,31,CHI,59,55,1625,157,435,0.361,3,6,0.5,154,429,0.359,0.364,62,84,0.738,23,121,144,202,61,15,105,120,379
Rick Brunson,PG,27,NYK,37,0,289,29,70,0.414,2,13,0.154,27,57,0.474,0.429,11,18,0.611,3,24,27,49,9,1,31,35,71
Kobe Bryant,SG,21,LAL,66,62,2524,554,1183,0.46799999999999997,46,144,0.319,508,1039,0.489,0.488,331,403,0.821,108,308,416,323,106,62,182,220,1485
Mark Bryant,PF,34,CLE,75,50,1712,174,346,0.503,0,0,0.0,174,346,0.503,0.503,76,94,0.809,126,226,352,61,31,31,87,250,424
Greg Buckner,SG,23,DAL,48,1,923,111,233,0.47600000000000003,10,26,0.385,101,207,0.488,0.498,43,63,0.6829999999999999,56,118,174,55,38,20,36,148,275
Jud Buechler,SF,31,DET,58,5,657,55,156,0.353,18,83,0.217,37,73,0.507,0.41,2,7,0.28600000000000003,30,61,91,33,25,16,13,50,130
Rodney Buford,SG,22,MIA,34,0,386,62,151,0.41100000000000003,7,29,0.24100000000000002,55,122,0.451,0.434,16,22,0.727,10,38,48,21,10,8,9,44,147
Matt Bullard,PF,32,HOU,56,27,1024,139,340,0.409,79,177,0.446,60,163,0.368,0.525,25,30,0.833,13,125,138,63,19,13,36,85,382
Scott Burrell,SF,29,NJN,74,9,1336,165,419,0.39399999999999996,82,232,0.353,83,187,0.444,0.49200000000000005,39,50,0.78,65,191,256,72,67,44,38,173,451
Jason Caffey,PF,26,GSW,71,56,2159,323,675,0.479,0,2,0.0,323,673,0.48,0.479,206,345,0.597,189,293,482,119,62,20,170,269,852
Michael Cage,C,38,NJN,20,7,242,12,24,0.5,0,0,0.0,12,24,0.5,0.5,3,3,1.0,33,48,81,9,8,8,4,30,27
Marcus Camby,C,25,NYK,59,11,1548,226,471,0.48,1,2,0.5,225,469,0.48,0.48100000000000004,148,221,0.67,174,287,461,49,43,116,72,204,601
Elden Campbell,C,31,CHH,78,77,2538,370,829,0.446,0,6,0.0,370,823,0.45,0.446,247,358,0.69,168,422,590,129,56,150,127,269,987
Antoine Carr,SF,38,VAN,21,0,221,28,64,0.43799999999999994,0,0,0.0,28,64,0.43799999999999994,0.43799999999999994,11,14,0.7859999999999999,8,24,32,7,3,6,9,42,67
Chris Carr,SF-SG,25,TOT,57,2,1166,196,496,0.395,32,101,0.317,164,395,0.415,0.42700000000000005,107,125,0.856,41,132,173,84,30,15,117,113,531
Anthony Carter,PG,24,MIA,79,30,1859,201,509,0.395,3,23,0.13,198,486,0.40700000000000003,0.39799999999999996,93,124,0.75,48,151,199,378,93,5,173,167,498
Vince Carter,SF,23,TOR,82,82,3126,788,1696,0.465,95,236,0.40299999999999997,693,1460,0.475,0.493,436,551,0.7909999999999999,150,326,476,322,110,92,178,263,2107
Sam Cassell,PG,30,MIL,81,81,2899,545,1170,0.466,26,90,0.289,519,1080,0.48100000000000004,0.47700000000000004,390,445,0.8759999999999999,69,232,301,729,102,8,267,255,1506
Kelvin Cato,C,25,HOU,65,32,1581,216,402,0.537,0,4,0.0,216,398,0.5429999999999999,0.537,135,208,0.649,102,287,389,26,33,124,71,175,567
Duane Causwell,C,31,MIA,25,2,185,20,37,0.541,0,0,0.0,20,37,0.541,0.541,26,38,0.684,11,36,47,2,2,16,10,42,66
Cedric Ceballos,SF,30,DAL,69,25,2064,447,1002,0.446,44,134,0.32799999999999996,403,868,0.46399999999999997,0.46799999999999997,209,248,0.843,172,290,462,90,56,24,125,165,1147
John Celestand,PG,22,LAL,16,0,185,15,45,0.33299999999999996,2,9,0.222,13,36,0.361,0.35600000000000004,5,6,0.833,1,10,11,20,7,0,16,22,37
Rex Chapman,SG,32,PHO,53,19,957,124,320,0.38799999999999996,41,123,0.33299999999999996,83,197,0.42100000000000004,0.452,59,78,0.7559999999999999,10,70,80,62,22,1,38,70,348
Calbert Cheaney,SG,28,BOS,67,19,1309,120,273,0.44,18,54,0.33299999999999996,102,219,0.466,0.473,9,21,0.429,23,115,138,80,44,14,46,158,267
Pete Chilcutt,PF,31,TOT,56,2,601,53,127,0.41700000000000004,6,26,0.231,47,101,0.465,0.441,8,8,1.0,46,85,131,27,15,10,20,73,120
Chris Childs,PG,32,NYK,71,2,1675,146,357,0.409,37,104,0.35600000000000004,109,253,0.431,0.461,47,59,0.797,17,130,147,285,36,4,105,240,376
Doug Christie,SG,29,TOR,73,73,2264,311,764,0.40700000000000003,99,275,0.36,212,489,0.434,0.47200000000000003,182,216,0.843,63,222,285,321,102,43,144,167,903
Keon Clark,C,24,DEN,81,20,1850,286,528,0.542,1,8,0.125,285,520,0.5479999999999999,0.5429999999999999,121,176,0.688,162,343,505,71,45,114,125,231,694
Keith Closs,C,23,LAC,57,6,820,96,197,0.48700000000000004,0,3,0.0,96,194,0.495,0.48700000000000004,46,78,0.59,65,114,179,25,13,73,34,80,238
Derrick Coleman,PF,32,CHH,74,64,2347,446,979,0.456,51,141,0.36200000000000004,395,838,0.47100000000000003,0.48200000000000004,296,377,0.785,124,508,632,175,34,130,173,195,1239
Bimbo Coles,PG,31,ATL,80,54,1924,276,607,0.455,8,39,0.205,268,568,0.47200000000000003,0.461,85,104,0.8170000000000001,30,142,172,290,58,11,103,178,645
Marty Conlon,C,32,LAC,3,0,9,1,2,0.5,0,0,0.0,1,2,0.5,0.5,0,0,0.0,1,1,2,0,0,0,0,1,2
Tyrone Corbin,SF,37,SAC,54,5,941,88,247,0.35600000000000004,10,44,0.22699999999999998,78,203,0.384,0.377,33,39,0.846,40,125,165,60,36,5,29,99,219
Chris Crawford,PF,24,ATL,55,11,668,91,229,0.397,7,27,0.259,84,202,0.41600000000000004,0.413,63,81,0.778,51,48,99,33,17,16,37,83,252
Austin Croshere,PF,24,IND,81,14,1885,288,653,0.441,63,174,0.36200000000000004,225,479,0.47,0.489,196,231,0.848,135,381,516,89,44,60,121,203,835
John Crotty,PG,30,DET,69,0,937,106,251,0.42200000000000004,33,80,0.413,73,171,0.42700000000000005,0.488,80,93,0.86,17,58,75,128,27,5,54,104,325
Terry Cummings,PF,38,GSW,22,0,398,76,177,0.429,0,0,0.0,76,177,0.429,0.429,32,39,0.821,45,62,107,21,13,8,27,74,184
Vonteego Cummings,PG,23,GSW,75,11,1793,265,655,0.405,49,151,0.325,216,504,0.429,0.442,127,169,0.7509999999999999,57,127,184,247,91,13,132,174,706
Bill Curley,SF-PF,27,TOT,28,0,309,29,68,0.426,0,1,0.0,29,67,0.433,0.426,18,25,0.72,18,32,50,14,13,4,21,61,76
Dell Curry,SG,35,TOR,67,9,1095,194,454,0.42700000000000005,95,242,0.39299999999999996,99,212,0.467,0.532,24,32,0.75,11,89,100,89,32,9,40,66,507
Michael Curry,SG,31,DET,82,3,1611,182,379,0.48,1,5,0.2,181,374,0.484,0.48200000000000004,141,168,0.8390000000000001,21,83,104,87,33,5,73,209,506
Erick Dampier,C,24,GSW,21,12,495,70,173,0.405,0,0,0.0,70,173,0.405,0.405,27,51,0.529,48,86,134,19,8,15,29,75,167
Antonio Daniels,SG,24,SAS,68,1,1195,163,344,0.474,22,66,0.33299999999999996,141,278,0.507,0.506,72,101,0.713,16,70,86,177,55,5,58,73,420
Kornél Dávid,SF,28,TOT,32,5,474,67,157,0.42700000000000005,0,3,0.0,67,154,0.435,0.42700000000000005,45,56,0.804,26,55,81,17,17,3,33,56,179
Antonio Davis,C,31,TOR,79,78,2479,313,712,0.44,0,0,0.0,313,712,0.44,0.44,284,371,0.765,235,461,696,105,38,100,121,267,910
Baron Davis,PG,20,CHH,82,0,1523,182,433,0.42,25,111,0.225,157,322,0.488,0.449,97,153,0.634,48,117,165,309,97,19,140,201,486
Ben Davis,PF,27,PHO,5,0,22,2,6,0.33299999999999996,0,0,0.0,2,6,0.33299999999999996,0.33299999999999996,0,0,0.0,3,6,9,2,1,1,3,2,4
Dale Davis,C,30,IND,74,72,2127,302,602,0.502,0,0,0.0,302,602,0.502,0.502,139,203,0.685,256,473,729,64,52,94,91,203,743
Emanual Davis,PG,31,SEA,54,2,701,80,220,0.364,31,103,0.301,49,117,0.419,0.434,26,38,0.684,15,85,100,70,38,5,44,72,217
Hubert Davis,PG,29,DAL,79,15,1817,217,464,0.46799999999999997,82,167,0.491,135,297,0.455,0.556,67,77,0.87,17,117,134,141,24,3,70,109,583
Mark Davis,SF,26,GSW,23,7,464,56,137,0.409,0,2,0.0,56,135,0.415,0.409,31,47,0.66,31,53,84,38,25,4,40,52,143
Ricky Davis,SG,20,CHH,48,4,570,94,187,0.503,0,4,0.0,94,183,0.514,0.503,39,51,0.765,29,54,83,62,30,8,46,39,227
Todd Day,SG,30,PHO,58,1,941,130,330,0.39399999999999996,64,165,0.38799999999999996,66,165,0.4,0.491,72,108,0.667,31,98,129,65,44,22,50,127,396
Andrew DeClercq,C,26,CLE,82,31,1831,225,443,0.508,0,0,0.0,225,443,0.508,0.508,94,160,0.588,156,283,439,58,63,66,108,275,544
Vinny Del Negro,PG,33,MIL,67,0,1211,153,325,0.47100000000000003,8,24,0.33299999999999996,145,301,0.48200000000000004,0.483,35,39,0.897,9,98,107,160,36,0,48,81,349
Tony Delk,PG,26,SAC,46,1,682,120,279,0.43,9,40,0.225,111,239,0.46399999999999997,0.446,47,59,0.797,36,52,88,55,35,5,32,58,296
Derrick Dial,SG,24,SAS,8,0,95,17,46,0.37,3,12,0.25,14,34,0.41200000000000003,0.402,3,5,0.6,14,12,26,5,1,1,6,10,40
Michael Dickerson,SG,24,VAN,82,82,3103,554,1270,0.436,119,291,0.409,435,979,0.444,0.483,269,324,0.83,78,201,279,208,116,45,165,226,1496
Vlade Divac*,C,31,SAC,82,81,2374,384,764,0.503,7,26,0.26899999999999996,377,738,0.511,0.507,230,333,0.691,174,482,656,244,103,103,190,251,1005
Michael Doleac,C,22,ORL,81,29,1335,242,535,0.452,1,2,0.5,241,533,0.452,0.45299999999999996,80,95,0.8420000000000001,89,245,334,63,29,34,65,224,565
Sherman Douglas,PG,33,NJN,20,2,309,45,90,0.5,5,16,0.313,40,74,0.541,0.528,25,28,0.893,13,16,29,34,17,0,24,26,120
Bryce Drew,PG,25,HOU,72,5,1293,158,413,0.38299999999999995,59,163,0.36200000000000004,99,250,0.396,0.45399999999999996,45,53,0.8490000000000001,23,80,103,162,41,1,66,79,420
Chris Dudley,C,34,NYK,47,3,459,23,67,0.34299999999999997,0,0,0.0,23,67,0.34299999999999997,0.34299999999999997,9,27,0.33299999999999996,63,73,136,5,7,21,18,95,55
Tim Duncan,PF,23,SAS,74,74,2875,628,1281,0.49,1,11,0.091,627,1270,0.494,0.491,459,603,0.7609999999999999,262,656,918,234,66,165,242,210,1716
Howard Eisley,PG,27,UTA,82,5,2096,282,675,0.418,60,163,0.368,222,512,0.434,0.462,84,102,0.8240000000000001,23,147,170,347,59,9,132,223,708
Obinna Ekezie,PF,24,VAN,39,0,351,41,88,0.466,0,0,0.0,41,88,0.466,0.466,43,64,0.672,34,58,92,8,9,4,26,61,125
Mario Elie,SF,36,SAS,79,79,2217,195,457,0.42700000000000005,74,186,0.39799999999999996,121,271,0.446,0.508,126,149,0.846,48,201,249,193,73,9,130,156,590
Sean Elliott,SF,31,SAS,19,19,391,38,106,0.358,13,37,0.35100000000000003,25,69,0.36200000000000004,0.42,25,32,0.7809999999999999,6,41,47,28,12,2,19,34,114
Dale Ellis,SG,39,TOT,42,5,564,66,159,0.415,37,100,0.37,29,59,0.49200000000000005,0.531,9,13,0.6920000000000001,13,43,56,14,13,0,20,45,178
LaPhonso Ellis,PF,29,ATL,58,8,1309,209,464,0.45,3,21,0.14300000000000002,206,443,0.465,0.45399999999999996,66,95,0.695,98,192,290,59,32,25,52,133,487
Pervis Ellison,C,32,BOS,30,5,269,19,43,0.442,0,0,0.0,19,43,0.442,0.442,15,21,0.7140000000000001,29,38,67,13,10,8,13,67,53
Evan Eschmeyer,C,24,NJN,31,5,373,38,72,0.528,0,0,0.0,38,72,0.528,0.528,15,30,0.5,40,68,108,21,8,21,21,84,91
Patrick Ewing*,C,37,NYK,62,62,2035,361,775,0.466,0,2,0.0,361,773,0.467,0.466,207,283,0.731,140,464,604,58,36,84,142,196,929
Tony Farmer,PF,30,GSW,74,9,1199,127,312,0.40700000000000003,8,44,0.182,119,268,0.444,0.42,203,265,0.7659999999999999,118,177,295,74,66,16,82,167,465
Jamie Feick,C,25,NJN,81,17,2241,181,423,0.428,3,3,1.0,178,420,0.424,0.431,94,133,0.7070000000000001,264,491,755,68,43,38,59,206,459
Danny Ferry,PF,33,CLE,63,3,1326,189,380,0.49700000000000005,33,75,0.44,156,305,0.511,0.541,52,57,0.912,55,183,238,67,22,24,55,181,463
Michael Finley,SF,26,DAL,82,82,3464,748,1636,0.457,99,247,0.401,649,1389,0.467,0.48700000000000004,260,317,0.82,122,396,518,438,109,32,196,171,1855
Derek Fisher,PG,25,LAL,78,22,1803,167,483,0.34600000000000003,52,166,0.313,115,317,0.363,0.4,105,145,0.7240000000000001,22,121,143,216,80,3,75,150,491
Danny Fortson,PF,23,BOS,55,5,856,140,265,0.528,0,0,0.0,140,265,0.528,0.528,139,189,0.735,141,225,366,29,20,5,67,180,419
Greg Foster,PF,31,SEA,60,5,718,91,224,0.406,3,15,0.2,88,209,0.42100000000000004,0.413,18,28,0.643,16,91,107,41,10,18,28,105,203
Jeff Foster,C,23,IND,19,0,86,13,23,0.565,0,1,0.0,13,22,0.591,0.565,17,25,0.68,12,20,32,5,5,1,2,18,43
Rick Fox,SF,30,LAL,82,1,1473,206,498,0.414,59,181,0.326,147,317,0.46399999999999997,0.473,63,78,0.8079999999999999,63,135,198,138,52,26,87,203,534
Adonal Foyle,C,24,GSW,76,59,1654,193,380,0.508,0,0,0.0,193,380,0.508,0.508,34,90,0.37799999999999995,174,250,424,42,26,136,71,218,420
Steve Francis,PG,22,HOU,77,77,2776,497,1117,0.445,107,310,0.345,390,807,0.483,0.493,287,365,0.7859999999999999,152,257,409,507,118,29,306,231,1388
Todd Fuller,C,25,CHH,41,2,399,51,122,0.418,0,0,0.0,51,122,0.418,0.418,32,53,0.604,36,74,110,5,9,8,27,46,134
Lawrence Funderburke,PF,29,SAC,75,1,1026,184,352,0.523,0,2,0.0,184,350,0.526,0.523,115,163,0.706,98,136,234,33,32,20,40,91,483
Kevin Garnett,PF,23,MIN,81,81,3243,759,1526,0.49700000000000005,30,81,0.37,729,1445,0.504,0.507,309,404,0.765,223,733,956,401,120,126,268,205,1857
Dean Garrett,C,33,MIN,56,23,604,48,108,0.444,0,0,0.0,48,108,0.444,0.444,18,26,0.6920000000000001,41,99,140,19,8,40,21,94,114
Kiwane Garris,SG,25,ORL,3,0,23,2,10,0.2,0,1,0.0,2,9,0.222,0.2,0,0,0.0,0,1,1,2,0,0,1,0,4
Pat Garrity,SF,23,ORL,82,1,1479,258,585,0.441,79,197,0.401,179,388,0.461,0.509,80,111,0.721,44,166,210,58,31,19,85,197,675
Chris Gatling,PF,32,TOT,85,0,1811,365,802,0.455,18,70,0.257,347,732,0.474,0.466,266,373,0.713,154,348,502,71,82,23,169,246,1014
Matt Geiger,C,30,PHI,65,20,1406,260,589,0.441,0,4,0.0,260,585,0.444,0.441,109,140,0.779,154,233,387,39,29,22,91,194,629
Devean George,SF,22,LAL,49,1,345,56,144,0.389,16,47,0.34,40,97,0.41200000000000003,0.444,27,41,0.659,29,46,75,12,10,4,21,54,155
Kendall Gill,SF,31,NJN,76,75,2355,396,956,0.414,20,78,0.256,376,878,0.428,0.425,181,255,0.71,82,201,283,210,139,41,89,211,993
Armen Gilliam,PF,35,UTA,50,0,782,133,305,0.436,0,1,0.0,133,304,0.43799999999999994,0.436,67,86,0.779,72,137,209,42,12,16,55,83,333
Dion Glover,SG,21,ATL,30,1,446,66,171,0.386,12,45,0.267,54,126,0.429,0.42100000000000004,51,70,0.7290000000000001,15,23,38,27,15,4,28,28,195
Brian Grant,PF,27,POR,63,14,1322,173,352,0.491,1,2,0.5,172,350,0.491,0.493,112,166,0.675,121,223,344,64,32,28,84,166,459
Gary Grant,PG,34,POR,3,0,24,6,14,0.429,0,0,0.0,6,14,0.429,0.429,0,0,0.0,0,3,3,1,1,0,2,3,12
Horace Grant,PF,34,SEA,76,76,2688,266,599,0.444,0,4,0.0,266,595,0.447,0.444,80,111,0.721,167,424,591,188,55,60,61,192,612
Devin Gray,SF,27,HOU,21,2,124,15,37,0.405,0,0,0.0,15,37,0.405,0.405,19,29,0.655,11,14,25,5,5,3,4,22,49
A.C. Green,PF,36,LAL,82,82,1929,173,387,0.447,1,4,0.25,172,383,0.449,0.44799999999999995,66,95,0.695,160,326,486,80,53,18,53,127,413
Adrian Griffin,SG,25,BOS,72,47,1927,175,413,0.424,16,57,0.281,159,356,0.447,0.44299999999999995,119,158,0.753,128,244,372,177,116,15,93,222,485
Tom Gugliotta,PF,30,PHO,54,54,1767,310,645,0.48100000000000004,1,8,0.125,309,637,0.485,0.48100000000000004,117,151,0.775,141,284,425,124,80,31,106,152,738
Darvin Ham,SF,26,MIL,35,21,792,71,128,0.555,0,1,0.0,71,127,0.5589999999999999,0.555,35,78,0.449,85,87,172,42,29,29,29,102,177
Richard Hamilton,SG,21,WAS,71,12,1373,254,605,0.42,28,77,0.364,226,528,0.428,0.44299999999999995,103,133,0.774,38,91,129,108,28,6,84,142,639
Thomas Hamilton,C,24,HOU,22,7,273,35,79,0.44299999999999995,0,0,0.0,35,79,0.44299999999999995,0.44299999999999995,12,23,0.522,31,59,90,15,4,14,28,25,82
Tom Hammonds,PF,32,MIN,56,0,372,42,97,0.433,0,0,0.0,42,97,0.433,0.433,33,56,0.589,34,67,101,10,8,3,21,55,117
Anfernee Hardaway,SG,28,PHO,60,60,2253,378,798,0.474,33,102,0.324,345,696,0.496,0.494,226,286,0.79,91,256,347,315,94,38,153,164,1015
Tim Hardaway,PG,33,MIA,52,52,1672,246,638,0.386,94,256,0.36700000000000005,152,382,0.39799999999999996,0.45899999999999996,110,133,0.8270000000000001,25,125,150,385,49,4,119,112,696
Ron Harper,PG,36,LAL,80,78,2042,212,531,0.39899999999999997,33,106,0.311,179,425,0.42100000000000004,0.43,100,147,0.68,96,241,337,270,85,39,132,164,557
Matt Harpring,SF,23,ORL,4,0,63,4,17,0.235,2,2,1.0,2,15,0.133,0.294,6,7,0.857,5,7,12,8,5,1,1,7,16
Al Harrington,PF,19,IND,50,0,854,121,264,0.45799999999999996,8,34,0.235,113,230,0.491,0.473,78,111,0.703,47,112,159,38,25,9,65,130,328
Othella Harrington,PF,26,VAN,82,82,2677,420,830,0.506,0,2,0.0,420,828,0.507,0.506,236,298,0.792,196,367,563,97,36,58,217,287,1076
Lucious Harris,SG,29,NJN,77,11,1510,198,463,0.428,38,115,0.33,160,348,0.46,0.469,79,99,0.7979999999999999,53,134,187,100,65,6,42,98,513
Antonio Harvey,PF,29,POR,19,0,137,17,30,0.5670000000000001,0,0,0.0,17,30,0.5670000000000001,0.5670000000000001,7,12,0.583,8,25,33,5,1,6,12,20,41
Hersey Hawkins,SG,33,CHI,61,49,1622,159,375,0.424,55,141,0.39,104,234,0.444,0.49700000000000005,107,119,0.899,31,144,175,134,74,15,100,146,480
Michael Hawkins,PG,27,CHH,12,0,36,3,13,0.231,1,5,0.2,2,8,0.25,0.26899999999999996,1,2,0.5,0,7,7,13,0,0,3,2,8
Alan Henderson,PF,27,ATL,82,82,2775,429,930,0.461,1,10,0.1,428,920,0.465,0.462,224,334,0.6709999999999999,265,306,571,77,81,54,139,233,1083
Cedric Henderson,SF,24,CLE,61,7,1107,129,326,0.396,1,15,0.067,128,311,0.41200000000000003,0.397,69,104,0.6629999999999999,34,106,140,55,39,17,68,99,328
Mark Hendrickson,PF,25,TOT,15,0,71,5,8,0.625,0,0,0.0,5,8,0.625,0.625,3,4,0.75,3,10,13,6,2,1,3,8,13
Chris Herren,PG,24,DEN,45,1,597,45,124,0.363,24,67,0.358,21,57,0.368,0.46,27,40,0.675,12,40,52,111,15,2,42,74,141
Grant Hill*,SF,27,DET,74,74,2776,696,1422,0.489,34,98,0.34700000000000003,662,1324,0.5,0.501,480,604,0.795,97,393,490,385,103,43,240,190,1906
Tyrone Hill,PF,31,PHI,68,65,2155,318,656,0.485,0,1,0.0,318,655,0.485,0.485,179,259,0.691,220,405,625,52,64,27,124,243,815
Fred Hoiberg,SG,27,CHI,31,11,845,89,230,0.387,32,94,0.34,57,136,0.419,0.457,69,76,0.9079999999999999,7,103,110,85,40,2,43,66,279
Derek Hood,PF,23,CHH,2,0,4,0,3,0.0,0,0,0.0,0,3,0.0,0.0,0,0,0.0,0,1,1,0,0,0,0,0,0
Jeff Hornacek,SG,36,UTA,77,77,2133,358,728,0.49200000000000005,66,138,0.478,292,590,0.495,0.537,171,180,0.95,49,133,182,202,66,16,113,149,953
Robert Horry,PF,29,LAL,76,0,1685,159,363,0.43799999999999994,29,94,0.309,130,269,0.483,0.478,89,113,0.7879999999999999,133,228,361,118,84,80,73,189,436
Allan Houston,SG,28,NYK,82,82,3169,614,1271,0.483,106,243,0.436,508,1028,0.494,0.525,280,334,0.838,38,233,271,224,65,14,186,219,1614
Juwan Howard,PF,26,WAS,82,82,2909,509,1108,0.45899999999999996,0,7,0.0,509,1101,0.462,0.45899999999999996,202,275,0.735,132,338,470,247,67,21,225,299,1220
Troy Hudson,PG,23,LAC,62,38,1592,204,541,0.377,60,193,0.311,144,348,0.414,0.433,77,95,0.8109999999999999,28,120,148,242,43,0,108,65,545
Larry Hughes,SG,21,TOT,82,37,2324,459,1147,0.4,29,125,0.23199999999999998,430,1022,0.42100000000000004,0.413,279,377,0.74,113,236,349,205,115,28,195,191,1226
Rick Hughes,PF,26,DAL,21,0,224,35,72,0.486,0,1,0.0,35,71,0.493,0.486,12,26,0.462,24,25,49,9,3,1,14,30,82
Lindsey Hunter,PG,29,DET,82,82,2919,379,892,0.425,168,389,0.43200000000000005,211,503,0.419,0.519,117,154,0.76,35,215,250,327,129,22,145,216,1043
Allen Iverson*,SG,24,PHI,70,70,2853,729,1733,0.42100000000000004,89,261,0.341,640,1472,0.435,0.446,442,620,0.713,71,196,267,328,144,5,230,162,1989
Bobby Jackson,PG,26,MIN,73,10,1034,140,346,0.405,13,46,0.28300000000000003,127,300,0.423,0.423,76,98,0.7759999999999999,50,103,153,172,48,7,58,114,369
Jaren Jackson,SG,32,SAS,81,12,1691,186,488,0.381,108,306,0.353,78,182,0.429,0.49200000000000005,33,51,0.647,34,147,181,118,54,7,66,157,513
Jermaine Jackson,SG,23,DET,7,0,73,1,11,0.091,0,1,0.0,1,10,0.1,0.091,5,8,0.625,1,10,11,4,3,0,7,7,7
Jim Jackson,SF,29,ATL,79,76,2767,507,1235,0.41100000000000003,117,303,0.386,390,932,0.418,0.45799999999999996,186,212,0.877,101,293,394,230,57,10,185,167,1317
Mark Jackson,PG,34,IND,81,81,2190,246,570,0.43200000000000005,89,221,0.40299999999999997,157,349,0.45,0.51,79,98,0.8059999999999999,63,233,296,650,76,10,174,111,660
Randell Jackson,PF,24,DAL,1,0,1,0,0,0.0,0,0,0.0,0,0,0.0,0.0,0,0,0.0,0,0,0,0,0,0,0,0,0
Sam Jacobson,PG,24,TOT,52,5,681,108,212,0.509,9,24,0.375,99,188,0.527,0.531,30,41,0.732,25,46,71,32,30,3,33,113,255
Tim James,SF,23,MIA,4,0,23,5,14,0.35700000000000004,0,0,0.0,5,14,0.35700000000000004,0.35700000000000004,1,3,0.33299999999999996,3,1,4,2,0,3,2,1,11
Antawn Jamison,SF,23,GSW,43,41,1556,356,756,0.47100000000000003,2,7,0.28600000000000003,354,749,0.473,0.47200000000000003,127,208,0.611,172,187,359,90,30,15,113,115,841
Harold Jamison,PF,23,MIA,12,0,74,7,20,0.35,0,0,0.0,7,20,0.35,0.35,4,18,0.222,16,5,21,4,2,1,4,17,18
Anthony Johnson,PG,25,TOT,56,6,637,62,164,0.37799999999999995,2,11,0.182,60,153,0.392,0.384,28,39,0.718,21,30,51,72,33,4,32,58,154
Avery Johnson,PG,34,SAS,82,82,2571,402,850,0.473,1,9,0.111,401,841,0.47700000000000004,0.474,114,155,0.735,33,125,158,491,76,18,140,150,919
DeMarco Johnson,PF,24,NYK,5,0,37,3,9,0.33299999999999996,0,0,0.0,3,9,0.33299999999999996,0.33299999999999996,0,0,0.0,3,4,7,0,1,0,3,5,6
Ervin Johnson,C,32,MIL,80,74,2129,144,279,0.516,0,1,0.0,144,278,0.518,0.516,95,157,0.605,233,415,648,44,81,127,80,298,383
Kevin Johnson,PG,33,PHO,6,0,113,16,28,0.5710000000000001,1,1,1.0,15,27,0.556,0.589,7,7,1.0,0,16,16,24,2,0,7,6,40
Larry Johnson,PF,30,NYK,70,68,2281,282,652,0.433,58,174,0.33299999999999996,224,478,0.469,0.47700000000000004,128,167,0.7659999999999999,87,293,380,175,42,7,94,205,750
Charles Jones,PG,24,LAC,56,0,662,66,201,0.32799999999999996,39,118,0.331,27,83,0.325,0.425,17,23,0.7390000000000001,17,45,62,94,30,5,28,46,188
Damon Jones,PG,23,TOT,55,1,612,80,208,0.385,41,114,0.36,39,94,0.415,0.483,32,48,0.667,12,43,55,96,18,1,40,34,233
Eddie Jones,SG,28,CHH,72,72,2807,478,1119,0.42700000000000005,128,341,0.375,350,778,0.45,0.484,362,419,0.8640000000000001,81,262,343,305,192,49,160,176,1446
Jumaine Jones,SF,20,PHI,33,0,138,22,58,0.379,2,4,0.5,20,54,0.37,0.397,11,18,0.611,16,22,38,5,6,5,14,10,57
Popeye Jones,PF,29,DEN,40,1,330,44,104,0.423,2,3,0.667,42,101,0.41600000000000004,0.433,14,19,0.737,41,62,103,19,3,6,13,50,104
Reggie Jordan,PG,32,WAS,36,0,243,17,53,0.321,0,1,0.0,17,52,0.327,0.321,7,13,0.5379999999999999,16,25,41,32,12,2,19,29,41
Adam Keefe,C,29,UTA,62,3,604,53,130,0.408,0,1,0.0,53,129,0.41100000000000003,0.408,29,36,0.8059999999999999,45,91,136,34,17,13,46,90,135
Shawn Kemp,C,30,CLE,82,82,2492,484,1160,0.41700000000000004,2,6,0.33299999999999996,482,1154,0.418,0.418,493,635,0.7759999999999999,231,494,725,138,100,96,291,371,1463
Steve Kerr,PG,34,SAS,32,0,268,32,74,0.43200000000000005,16,31,0.516,16,43,0.37200000000000005,0.541,9,11,0.818,3,16,19,12,4,0,7,14,89
Jerome Kersey,SF,37,SAS,72,18,1310,146,354,0.41200000000000003,0,9,0.0,146,345,0.423,0.41200000000000003,29,41,0.7070000000000001,58,167,225,69,67,47,51,161,321
Lari Ketner,PF,22,TOT,22,0,132,13,32,0.406,0,0,0.0,13,32,0.406,0.406,8,12,0.667,12,22,34,1,4,3,10,20,34
Jason Kidd*,PG,26,PHO,67,67,2616,350,855,0.409,56,166,0.337,294,689,0.42700000000000005,0.442,203,245,0.8290000000000001,96,387,483,678,134,28,226,148,959
Gerard King,SF,27,WAS,62,28,1060,139,277,0.502,0,0,0.0,139,277,0.502,0.502,49,66,0.742,84,166,250,49,34,15,41,132,327
Kerry Kittles,SG,25,NJN,62,61,1896,305,698,0.43700000000000006,96,240,0.4,209,458,0.456,0.506,101,127,0.795,46,179,225,142,79,19,56,120,807
Joe Kleine,C,38,POR,7,0,31,4,11,0.364,0,0,0.0,4,11,0.364,0.364,3,3,1.0,0,6,6,2,1,0,2,7,11
Brevin Knight,PG,24,CLE,65,46,1754,230,558,0.41200000000000003,2,10,0.2,228,548,0.41600000000000004,0.414,140,184,0.7609999999999999,38,155,193,458,107,21,157,185,602
Travis Knight,C,25,LAL,63,0,410,46,118,0.39,0,0,0.0,46,118,0.39,0.39,17,28,0.607,46,83,129,23,6,23,26,88,109
Toni Kukoč,SF,31,TOT,56,31,1784,297,728,0.408,44,168,0.262,253,560,0.452,0.43799999999999994,192,265,0.725,75,198,273,265,77,28,146,112,830
Christian Laettner,C,30,DET,82,82,2443,379,801,0.473,7,24,0.292,372,777,0.479,0.478,237,292,0.812,175,378,553,186,83,45,186,326,1002
Raef LaFrentz,C,23,DEN,81,80,2435,392,879,0.446,60,183,0.32799999999999996,332,696,0.47700000000000004,0.48,162,236,0.6859999999999999,170,471,641,97,42,180,96,292,1006
Andrew Lang,C,33,NYK,19,10,244,28,64,0.43799999999999994,0,0,0.0,28,64,0.43799999999999994,0.43799999999999994,3,7,0.429,16,44,60,3,8,6,5,31,59
Antonio Lang,SF,27,TOT,10,0,38,1,6,0.16699999999999998,0,0,0.0,1,6,0.16699999999999998,0.16699999999999998,4,5,0.8,0,5,5,2,4,1,2,8,6
Trajan Langdon,SG,23,CLE,10,0,145,15,40,0.375,8,19,0.42100000000000004,7,21,0.33299999999999996,0.475,11,11,1.0,4,11,15,11,5,0,6,16,49
Rusty LaRue,PG,26,CHI,4,1,129,15,43,0.349,2,14,0.14300000000000002,13,29,0.44799999999999995,0.37200000000000005,5,7,0.7140000000000001,1,9,10,11,7,0,7,9,37
Tim Legler,SG,33,GSW,23,4,284,28,78,0.359,7,21,0.33299999999999996,21,57,0.368,0.40399999999999997,14,18,0.778,4,19,23,24,4,1,6,33,77
Voshon Lenard,SG,26,MIA,53,13,1434,228,560,0.40700000000000003,89,228,0.39,139,332,0.419,0.48700000000000004,84,106,0.792,37,116,153,136,41,15,80,127,629
Quincy Lewis,SG,22,UTA,74,0,896,111,298,0.37200000000000005,23,63,0.365,88,235,0.374,0.41100000000000003,38,52,0.731,46,67,113,40,24,15,46,158,283
Rashard Lewis,SF,20,SEA,82,8,1575,275,566,0.486,40,120,0.33299999999999996,235,446,0.527,0.521,84,123,0.6829999999999999,127,209,336,70,62,36,78,163,674
Randy Livingston,PG,24,PHO,79,15,1081,155,373,0.41600000000000004,19,55,0.345,136,318,0.428,0.441,52,62,0.8390000000000001,25,105,130,170,49,13,92,129,381
Grant Long,PF,33,VAN,42,1,920,74,167,0.44299999999999995,0,4,0.0,74,163,0.45399999999999996,0.44299999999999995,55,71,0.775,86,148,234,43,45,10,49,108,203
Luc Longley,C,31,PHO,72,68,1417,186,399,0.466,0,0,0.0,186,399,0.466,0.466,80,97,0.825,100,223,323,77,22,42,136,221,452
Felipe López,SG,25,VAN,65,0,781,111,261,0.425,3,18,0.16699999999999998,108,243,0.444,0.431,67,109,0.615,59,65,124,44,32,17,53,94,292
Tyronn Lue,PG,22,LAL,8,0,146,19,39,0.48700000000000004,4,8,0.5,15,31,0.484,0.5379999999999999,6,8,0.75,2,10,12,17,3,0,9,17,48
George Lynch,SF,29,PHI,75,75,2416,297,644,0.461,15,36,0.41700000000000004,282,608,0.46399999999999997,0.473,113,183,0.617,216,366,582,136,119,38,120,231,722
Todd MacCulloch,C,24,PHI,56,6,528,89,161,0.5529999999999999,0,0,0.0,89,161,0.5529999999999999,0.5529999999999999,28,54,0.519,48,98,146,13,11,37,26,94,206
Sam Mack,SF,29,GSW,23,5,333,37,122,0.303,21,64,0.32799999999999996,16,58,0.276,0.389,19,20,0.95,7,32,39,24,18,1,19,45,114
Don MacLean,PF,30,PHO,16,0,143,18,49,0.36700000000000005,2,6,0.33299999999999996,16,43,0.37200000000000005,0.38799999999999996,4,6,0.667,6,17,23,8,2,1,8,24,42
Corey Maggette,SF,20,ORL,77,5,1370,224,469,0.478,2,11,0.182,222,458,0.485,0.48,196,261,0.7509999999999999,123,180,303,61,24,26,138,169,646
Dan Majerle,SG,34,MIA,69,69,2308,170,422,0.40299999999999997,110,304,0.36200000000000004,60,118,0.508,0.5329999999999999,56,69,0.812,27,306,333,206,89,17,62,156,506
Karl Malone*,PF,36,UTA,82,82,2947,752,1476,0.509,2,8,0.25,750,1468,0.511,0.51,589,739,0.797,169,610,779,304,79,71,231,229,2095
Matt Maloney,PG,28,CHI,51,12,1175,114,318,0.358,62,174,0.35600000000000004,52,144,0.361,0.456,37,45,0.8220000000000001,10,54,64,138,32,3,63,42,327
Danny Manning,PF,33,MIL,72,0,1217,149,339,0.44,1,4,0.25,148,335,0.442,0.441,34,52,0.654,50,158,208,73,62,29,55,183,333
Stephon Marbury,PG,22,NJN,74,74,2881,569,1317,0.43200000000000005,66,233,0.28300000000000003,503,1084,0.46399999999999997,0.457,436,536,0.813,61,179,240,622,112,15,270,195,1640
Shawn Marion,SF,21,PHO,51,38,1260,222,471,0.47100000000000003,4,22,0.182,218,449,0.486,0.47600000000000003,72,85,0.847,105,227,332,69,38,53,51,113,520
Sean Marks,PF,24,TOR,5,0,12,2,6,0.33299999999999996,0,1,0.0,2,5,0.4,0.33299999999999996,4,4,1.0,0,2,2,0,1,1,3,3,8
Donny Marshall,SF,27,CLE,6,0,39,3,11,0.273,0,3,0.0,3,8,0.375,0.273,5,6,0.833,0,1,1,0,2,0,3,7,11
Donyell Marshall,PF,26,GSW,64,51,2071,331,840,0.39399999999999996,49,138,0.355,282,702,0.402,0.423,199,255,0.78,189,448,637,167,68,68,123,180,910
Darrick Martin,PG,28,SAC,71,1,893,133,350,0.38,38,124,0.306,95,226,0.42,0.434,98,119,0.8240000000000001,7,37,44,122,28,2,62,89,402
Jamal Mashburn,SF,27,MIA,76,76,2828,515,1158,0.445,112,278,0.40299999999999997,403,880,0.45799999999999996,0.493,186,239,0.778,64,317,381,298,79,14,180,215,1328
Anthony Mason,SF,33,CHH,82,81,3133,317,661,0.48,0,1,0.0,317,660,0.48,0.48,314,421,0.746,145,554,699,367,74,29,160,220,948
Tony Massenburg,PF,32,HOU,10,0,109,16,36,0.444,0,0,0.0,16,36,0.444,0.444,14,16,0.875,7,20,27,3,2,5,9,13,46
Vernon Maxwell,SG,34,SEA,47,0,989,169,490,0.345,67,223,0.3,102,267,0.382,0.413,108,148,0.73,15,64,79,75,38,9,53,83,513
Walter McCarty,PF,25,BOS,61,5,879,78,230,0.33899999999999997,34,110,0.309,44,120,0.36700000000000005,0.413,39,54,0.722,33,77,110,70,24,23,67,83,229
George McCloud,SF,32,DEN,78,11,2118,266,638,0.41700000000000004,107,283,0.37799999999999995,159,355,0.44799999999999995,0.501,148,181,0.818,72,213,285,246,48,26,134,180,787
Jelani McCoy,C,22,SEA,58,2,746,102,177,0.5760000000000001,0,0,0.0,102,177,0.5760000000000001,0.5760000000000001,45,91,0.495,54,125,179,24,15,46,45,127,249
Antonio McDyess,PF,25,DEN,81,81,2698,614,1211,0.507,0,2,0.0,614,1209,0.508,0.507,323,516,0.626,234,451,685,159,69,139,230,316,1551
Tracy McGrady*,SF,20,TOR,79,34,2462,459,1018,0.451,18,65,0.27699999999999997,441,953,0.46299999999999997,0.46,277,392,0.7070000000000001,188,313,501,263,90,151,160,201,1213
Jim McIlvaine,C,27,NJN,66,53,1048,64,154,0.41600000000000004,0,0,0.0,64,154,0.41600000000000004,0.41600000000000004,29,56,0.518,106,124,230,36,26,117,38,205,157
Jeff McInnis,PG,25,LAC,25,10,597,80,186,0.43,7,21,0.33299999999999996,73,165,0.442,0.449,13,17,0.765,18,54,72,89,15,2,27,55,180
Derrick McKey,SF,33,IND,32,0,634,43,108,0.39799999999999996,10,23,0.435,33,85,0.38799999999999996,0.444,43,56,0.768,29,106,135,35,29,13,19,81,139
Aaron McKie,SG,27,PHI,82,14,1952,244,593,0.41100000000000003,44,121,0.364,200,472,0.424,0.449,121,146,0.8290000000000001,47,199,246,240,108,18,113,194,653
Roshown McLeod,SF,24,ATL,44,20,860,131,332,0.395,2,13,0.154,129,319,0.40399999999999997,0.39799999999999996,54,70,0.7709999999999999,41,97,138,52,16,5,59,84,318
Ron Mercer,SG,23,TOT,68,68,2377,460,1080,0.426,15,48,0.313,445,1032,0.431,0.433,213,270,0.789,64,186,250,158,75,23,151,151,1148
Andre Miller,PG,23,CLE,82,36,2093,339,755,0.449,10,49,0.204,329,706,0.466,0.456,226,292,0.774,85,195,280,476,84,17,166,194,914
Anthony Miller,PF,28,HOU,35,14,476,52,97,0.536,0,0,0.0,52,97,0.536,0.536,26,51,0.51,49,115,164,16,11,10,19,68,130
Brad Miller,C,23,CHH,55,4,961,135,293,0.461,0,2,0.0,135,291,0.46399999999999997,0.461,153,195,0.785,113,180,293,45,23,35,48,111,423
Oliver Miller,C,29,PHO,51,9,1088,137,233,0.588,0,0,0.0,137,233,0.588,0.588,49,73,0.6709999999999999,87,174,261,68,42,80,74,132,323
Reggie Miller*,SG,34,IND,81,81,2987,466,1041,0.44799999999999995,165,404,0.408,301,637,0.473,0.527,373,406,0.919,50,189,239,187,85,25,129,126,1470
Chris Mills,SF,30,GSW,20,11,649,123,292,0.42100000000000004,8,30,0.267,115,262,0.439,0.435,68,84,0.81,46,77,123,47,18,4,25,60,322
Terry Mills,PF,32,DET,82,78,1842,214,488,0.439,95,242,0.39299999999999996,119,246,0.484,0.536,25,34,0.735,50,340,390,85,38,24,46,242,548
Jason Miskiri,PG,24,CHH,1,0,3,0,1,0.0,0,1,0.0,0,0,0.0,0.0,0,0,0.0,0,0,0,1,0,0,0,2,0
Sam Mitchell,SF,36,MIN,66,24,1227,168,376,0.447,10,23,0.435,158,353,0.44799999999999995,0.46,81,92,0.88,28,110,138,111,27,14,44,116,427
Cuttino Mobley,SG,24,HOU,81,8,2496,437,1016,0.43,104,292,0.35600000000000004,333,724,0.46,0.48100000000000004,299,353,0.847,59,229,288,208,87,32,186,171,1277
Nazr Mohammed,C,22,PHI,28,3,190,21,54,0.389,0,0,0.0,21,54,0.389,0.389,12,22,0.545,16,34,50,2,4,12,18,29,54
Eric Montross,C,28,DET,51,0,332,17,55,0.309,0,0,0.0,17,55,0.309,0.309,6,12,0.5,18,54,72,7,6,9,22,81,40
Mikki Moore,C,24,DET,29,0,488,87,140,0.621,0,0,0.0,87,140,0.621,0.621,54,68,0.794,44,68,112,17,9,31,23,104,228
Alonzo Mourning*,C,29,MIA,79,78,2748,652,1184,0.551,0,4,0.0,652,1180,0.5529999999999999,0.551,414,582,0.711,215,538,753,123,40,294,217,308,1718
Chris Mullin*,SG,36,IND,47,2,582,80,187,0.428,45,110,0.409,35,77,0.455,0.5479999999999999,37,41,0.902,14,62,76,37,28,9,28,60,242
Eric Murdock,PG,31,LAC,40,15,693,79,205,0.385,16,42,0.381,63,163,0.387,0.424,51,80,0.638,15,62,77,108,47,5,58,67,225
Gheorghe Mureșan,C,28,NJN,30,2,267,41,90,0.456,0,0,0.0,41,90,0.456,0.456,23,38,0.605,24,44,68,9,0,12,16,52,105
Lamond Murray,SF,26,CLE,74,72,2365,460,1019,0.451,51,139,0.36700000000000005,409,880,0.465,0.47600000000000003,204,268,0.7609999999999999,127,296,423,132,105,36,184,208,1175
Tracy Murray,SF,28,WAS,80,8,1831,290,670,0.433,113,263,0.43,177,407,0.435,0.517,120,141,0.851,63,208,271,72,45,24,84,185,813
Dikembe Mutombo*,C,33,ATL,82,82,2984,322,573,0.562,0,0,0.0,322,573,0.562,0.562,298,421,0.708,304,853,1157,105,27,269,174,248,942
Steve Nash*,PG,25,DAL,56,27,1532,173,363,0.47700000000000004,60,149,0.40299999999999997,113,214,0.528,0.5589999999999999,75,85,0.882,34,87,121,272,37,3,102,122,481
Tyrone Nesby,SG,24,LAC,73,39,2317,364,915,0.39799999999999996,94,281,0.335,270,634,0.426,0.449,151,191,0.7909999999999999,82,193,275,121,75,31,102,205,973
Rasho Nesterović,C,23,MIN,82,55,1723,206,433,0.47600000000000003,0,2,0.0,206,431,0.478,0.47600000000000003,59,103,0.573,135,244,379,93,21,85,71,262,471
Johnny Newman,SF,36,NJN,82,9,1763,278,623,0.446,72,190,0.379,206,433,0.47600000000000003,0.504,192,229,0.838,39,115,154,65,53,11,89,207,820
Moochie Norris,PG,26,HOU,30,0,502,69,159,0.434,12,29,0.414,57,130,0.43799999999999994,0.47200000000000003,57,73,0.7809999999999999,16,52,68,94,23,1,30,32,207
Dirk Nowitzki,PF,21,DAL,82,81,2938,515,1118,0.461,116,306,0.379,399,812,0.491,0.513,289,348,0.83,102,430,532,203,63,68,141,256,1435
Jermaine O'Neal,C,21,POR,70,8,859,108,222,0.486,0,1,0.0,108,221,0.489,0.486,57,98,0.5820000000000001,97,132,229,18,11,55,47,127,273
Shaquille O'Neal*,C,27,LAL,79,79,3163,956,1665,0.574,0,1,0.0,956,1664,0.575,0.574,432,824,0.524,336,742,1078,299,36,239,223,255,2344
Charles Oakley,PF,36,TOR,80,80,2431,234,560,0.418,14,41,0.341,220,519,0.424,0.43,66,85,0.7759999999999999,117,423,540,253,102,45,154,294,548
Lamar Odom,SF,20,LAC,76,70,2767,449,1024,0.43799999999999994,59,164,0.36,390,860,0.45299999999999996,0.467,302,420,0.7190000000000001,159,436,595,317,91,95,258,291,1259
Hakeem Olajuwon*,C,37,HOU,44,28,1049,193,421,0.45799999999999996,0,2,0.0,193,419,0.461,0.45799999999999996,69,112,0.616,65,209,274,61,41,70,73,88,455
Kevin Ollie,PG,27,PHI,40,0,290,22,49,0.449,0,0,0.0,22,49,0.449,0.449,28,37,0.757,4,27,31,46,10,0,10,27,72
Michael Olowokandi,C,24,LAC,80,77,2493,330,756,0.43700000000000006,0,0,0.0,330,756,0.43700000000000006,0.43700000000000006,123,189,0.6509999999999999,194,462,656,38,35,140,177,304,783
Greg Ostertag,C,26,UTA,81,3,1606,124,267,0.46399999999999997,0,1,0.0,124,266,0.466,0.46399999999999997,119,187,0.636,172,310,482,18,20,172,79,196,367
Bo Outlaw,PF,28,ORL,82,55,2326,204,339,0.602,0,3,0.0,204,336,0.607,0.602,82,162,0.506,202,323,525,245,113,148,133,203,490
Doug Overton,PG,30,BOS,48,0,432,61,154,0.396,10,28,0.35700000000000004,51,126,0.405,0.429,20,21,0.9520000000000001,14,19,33,53,10,0,20,46,152
Billy Owens,PF-SF,30,TOT,62,11,1305,150,358,0.419,11,34,0.324,139,324,0.429,0.434,63,106,0.594,99,202,301,97,33,21,85,166,374
Robert Pack,PG,30,DAL,29,22,665,96,230,0.41700000000000004,4,11,0.364,92,219,0.42,0.426,63,78,0.8079999999999999,7,35,42,168,31,3,76,44,259
Scott Padgett,PF,23,UTA,47,9,432,44,140,0.314,13,44,0.295,31,96,0.32299999999999995,0.361,19,27,0.7040000000000001,24,64,88,25,14,8,22,55,120
Milt Palacio,PG,21,VAN,53,0,394,43,98,0.439,0,2,0.0,43,96,0.44799999999999995,0.439,22,37,0.595,17,34,51,48,20,0,44,32,108
Anthony Parker,SG,24,ORL,16,0,185,24,57,0.42100000000000004,1,14,0.071,23,43,0.535,0.43,8,11,0.727,5,22,27,10,8,4,11,13,57
Cherokee Parks,C,27,VAN,56,14,808,72,145,0.49700000000000005,0,1,0.0,72,144,0.5,0.49700000000000005,24,37,0.649,55,128,183,35,29,45,28,115,168
Andrae Patterson,PF,24,MIN,5,0,20,3,4,0.75,0,0,0.0,3,4,0.75,0.75,0,0,0.0,1,1,2,1,1,0,1,4,6
Ruben Patterson,SF,24,SEA,81,74,2097,354,661,0.536,12,27,0.444,342,634,0.539,0.545,222,321,0.6920000000000001,218,216,434,126,94,40,144,190,942
Gary Payton*,PG,31,SEA,82,82,3425,747,1666,0.44799999999999995,177,520,0.34,570,1146,0.49700000000000005,0.502,311,423,0.735,100,429,529,732,153,18,224,178,1982
Anthony Peeler,SG,30,MIN,82,22,2073,316,725,0.436,85,255,0.33299999999999996,231,470,0.491,0.494,87,109,0.7979999999999999,58,174,232,195,62,10,85,171,804
Will Perdue,C,34,CHI,67,15,1012,59,168,0.35100000000000003,0,0,0.0,59,168,0.35100000000000003,0.35100000000000003,50,105,0.47600000000000003,88,174,262,65,14,42,78,126,168
Sam Perkins,PF,38,IND,81,0,1620,184,441,0.41700000000000004,89,218,0.408,95,223,0.426,0.518,80,97,0.825,64,225,289,68,31,33,63,136,537
Elliot Perry,PG,30,NJN,60,5,803,128,294,0.435,11,39,0.282,117,255,0.45899999999999996,0.45399999999999996,50,62,0.8059999999999999,13,48,61,139,39,1,60,47,317
Chuck Person,SF,35,SEA,37,0,340,37,123,0.301,24,95,0.253,13,28,0.46399999999999997,0.39799999999999996,4,8,0.5,6,47,53,22,5,2,12,56,102
Wesley Person,SG,28,CLE,79,38,2056,280,654,0.428,106,250,0.424,174,404,0.431,0.509,61,77,0.792,44,223,267,146,40,19,60,119,727
Bobby Phills,SG,30,CHH,28,9,825,152,335,0.45399999999999996,30,91,0.33,122,244,0.5,0.499,47,65,0.723,17,54,71,79,41,8,48,72,381
Eric Piatkowski,SF,29,LAC,75,23,1712,238,573,0.415,93,243,0.38299999999999995,145,330,0.439,0.49700000000000005,85,100,0.85,74,148,222,81,44,13,57,140,654
Paul Pierce,SF,22,BOS,73,72,2583,486,1099,0.442,96,280,0.34299999999999997,390,819,0.47600000000000003,0.486,359,450,0.7979999999999999,83,313,396,221,152,62,178,237,1427
Scottie Pippen*,SF,34,POR,82,82,2749,388,860,0.451,86,263,0.327,302,597,0.506,0.501,160,223,0.7170000000000001,114,399,513,406,117,41,208,208,1022
Scot Pollard,C,24,SAC,76,5,1336,149,283,0.527,0,0,0.0,149,283,0.527,0.527,114,159,0.7170000000000001,168,236,404,43,55,59,50,213,412
Olden Polynice,C,35,UTA,82,79,1819,203,398,0.51,1,2,0.5,202,396,0.51,0.511,28,90,0.311,166,287,453,37,30,84,70,260,435
Terry Porter,PG,36,SAS,68,8,1613,207,463,0.447,90,207,0.435,117,256,0.457,0.544,137,170,0.8059999999999999,24,167,191,221,50,9,100,79,641
James Posey,SF,23,DEN,81,77,2052,230,536,0.429,82,220,0.373,148,316,0.46799999999999997,0.506,120,150,0.8,85,232,317,146,98,33,95,207,662
Vitaly Potapenko,C,24,BOS,79,72,1797,307,615,0.499,0,1,0.0,307,614,0.5,0.499,109,160,0.6809999999999999,182,317,499,77,41,29,145,239,723
Brent Price,PG,31,VAN,41,0,424,41,119,0.345,25,68,0.368,16,51,0.314,0.45,34,39,0.872,8,29,37,69,17,1,47,63,141
Laron Profit,SG,22,WAS,33,1,225,21,59,0.35600000000000004,3,17,0.17600000000000002,18,42,0.429,0.381,4,10,0.4,2,24,26,25,7,4,19,26,49
Aleksandar Radojević,C,23,TOR,3,0,24,2,7,0.28600000000000003,0,0,0.0,2,7,0.28600000000000003,0.28600000000000003,3,6,0.5,2,6,8,1,2,1,5,5,7
Theo Ratliff,PF,26,PHI,57,56,1795,247,491,0.503,0,0,0.0,247,491,0.503,0.503,182,236,0.7709999999999999,140,295,435,36,32,171,108,185,676
Eldridge Recasner,PG,32,CHH,7,0,28,3,7,0.429,1,4,0.25,2,3,0.667,0.5,0,0,0.0,0,4,4,5,0,0,0,1,7
Bryant Reeves,C,26,VAN,69,67,1773,252,562,0.44799999999999995,0,4,0.0,252,558,0.452,0.44799999999999995,107,165,0.648,126,264,390,82,33,38,119,245,611
Khalid Reeves,PG,27,CHI,3,0,48,3,12,0.25,0,3,0.0,3,9,0.33299999999999996,0.25,5,5,1.0,2,2,4,13,2,0,6,8,11
Don Reid,PF,26,TOT,38,3,498,60,112,0.536,0,0,0.0,60,112,0.536,0.536,24,34,0.706,31,71,102,11,24,31,23,118,144
J.R. Reid,PF,31,MIL,34,7,602,53,127,0.41700000000000004,1,7,0.14300000000000002,52,120,0.433,0.42100000000000004,43,56,0.768,29,88,117,18,19,5,20,81,150
Rodrick Rhodes,SF,26,DAL,1,0,8,0,3,0.0,0,0,0.0,0,3,0.0,0.0,0,0,0.0,1,0,1,0,2,0,2,0,0
Glen Rice,SF,32,LAL,80,80,2530,421,980,0.43,84,229,0.36700000000000005,337,751,0.449,0.47200000000000003,346,396,0.8740000000000001,56,271,327,176,47,12,114,179,1272
Mitch Richmond*,SG,34,WAS,74,69,2397,447,1049,0.426,93,241,0.386,354,808,0.43799999999999994,0.47,298,340,0.8759999999999999,37,176,213,185,110,13,154,191,1285
Isaiah Rider,SG,28,ATL,60,47,2084,449,1072,0.419,56,180,0.311,393,892,0.441,0.445,204,260,0.785,63,195,258,219,41,6,168,132,1158
Stanley Roberts,C,29,PHI,5,1,51,5,16,0.313,0,1,0.0,5,15,0.33299999999999996,0.313,0,3,0.0,6,9,15,3,1,1,2,15,10
Ryan Robertson,SG,23,SAC,1,0,25,2,6,0.33299999999999996,0,2,0.0,2,4,0.5,0.33299999999999996,1,1,1.0,0,0,0,0,0,0,0,0,5
Clifford Robinson,SF,33,PHO,80,67,2839,530,1142,0.46399999999999997,120,324,0.37,410,818,0.501,0.517,298,381,0.782,105,254,359,224,90,61,166,239,1478
David Robinson*,C,34,SAS,80,80,2557,528,1031,0.512,0,2,0.0,528,1029,0.513,0.512,371,511,0.726,193,577,770,142,97,183,164,247,1427
Eddie Robinson,SF,23,CHH,67,8,1112,212,386,0.5489999999999999,0,4,0.0,212,382,0.555,0.5489999999999999,47,64,0.7340000000000001,54,130,184,32,48,25,39,67,471
Glenn Robinson,SF,27,MIL,81,81,2909,690,1461,0.47200000000000003,86,237,0.363,604,1224,0.493,0.502,227,283,0.802,107,378,485,193,78,41,223,212,1693
Dennis Rodman*,PF,38,DAL,12,12,389,12,31,0.387,0,1,0.0,12,30,0.4,0.387,10,14,0.7140000000000001,48,123,171,14,2,1,19,41,34
Carlos Rogers,C,28,HOU,53,15,1101,170,324,0.525,1,14,0.071,169,310,0.545,0.526,81,137,0.591,98,177,275,42,14,34,63,77,422
Rodney Rogers,PF,28,PHO,82,7,2286,428,881,0.486,115,262,0.439,313,619,0.506,0.551,159,249,0.639,138,309,447,170,94,47,163,290,1130
Roy Rogers,PF,26,DEN,40,0,355,35,88,0.39799999999999996,0,1,0.0,35,87,0.402,0.39799999999999996,19,41,0.46299999999999997,33,47,80,9,2,38,10,36,89
Sean Rooks,C,30,DAL,71,13,1001,122,283,0.431,0,0,0.0,122,283,0.431,0.431,65,89,0.73,82,166,248,68,29,52,70,169,309
Jalen Rose,SF,27,IND,80,80,2978,563,1196,0.47100000000000003,77,196,0.39299999999999996,486,1000,0.486,0.503,254,307,0.8270000000000001,42,345,387,320,84,49,188,234,1457
Malik Rose,PF,25,SAS,74,3,1341,176,385,0.457,1,3,0.33299999999999996,175,382,0.45799999999999996,0.45799999999999996,143,198,0.722,133,202,335,47,35,52,99,232,496
Michael Ruffin,PF,23,CHI,71,6,975,58,138,0.42,0,0,0.0,58,138,0.42,0.42,43,88,0.489,117,133,250,44,26,26,59,170,159
Bryon Russell,SF,29,UTA,82,70,2900,408,914,0.446,106,268,0.396,302,646,0.467,0.504,237,316,0.75,99,328,427,158,128,23,101,255,1159
Arvydas Sabonis*,C,35,POR,66,61,1688,302,598,0.505,7,19,0.368,295,579,0.509,0.511,167,198,0.843,97,416,513,118,43,78,97,184,778
John Salley,C,35,LAL,45,3,303,25,69,0.36200000000000004,0,0,0.0,25,69,0.36200000000000004,0.36200000000000004,21,28,0.75,20,45,65,26,8,14,18,67,71
Detlef Schrempf,SF,37,POR,77,6,1662,187,433,0.43200000000000005,21,52,0.40399999999999997,166,381,0.436,0.456,179,215,0.833,79,253,332,197,37,17,100,182,574
Dennis Scott,SF,31,VAN,66,0,1263,125,333,0.375,71,189,0.376,54,144,0.375,0.48200000000000004,48,57,0.8420000000000001,16,90,106,69,28,9,30,104,369
Malik Sealy,SF,29,MIN,82,61,2392,371,780,0.47600000000000003,10,35,0.28600000000000003,361,745,0.485,0.48200000000000004,177,218,0.812,119,233,352,197,76,19,110,197,929
Brian Shaw,SG,33,LAL,74,2,1249,123,322,0.382,18,58,0.31,105,264,0.39799999999999996,0.41,41,54,0.759,45,171,216,201,35,14,75,105,305
Dickey Simpkins,PF,27,CHI,69,48,1651,111,274,0.405,0,1,0.0,111,273,0.40700000000000003,0.405,65,120,0.542,124,248,372,100,22,22,128,217,287
Brian Skinner,PF,23,LAC,33,9,775,68,134,0.507,0,0,0.0,68,134,0.507,0.507,43,65,0.662,63,138,201,11,16,44,37,75,179
Joe Smith,C,24,MIN,78,9,1975,289,623,0.46399999999999997,1,1,1.0,288,622,0.46299999999999997,0.465,195,258,0.7559999999999999,186,298,484,88,45,85,119,302,774
Michael Smith,SF,27,WAS,46,46,1145,108,192,0.563,0,1,0.0,108,191,0.565,0.563,73,101,0.723,121,210,331,56,27,23,45,127,289
Steve Smith,SG,30,POR,82,81,2689,420,900,0.467,96,241,0.39799999999999996,324,659,0.49200000000000005,0.52,289,340,0.85,123,190,313,209,71,31,117,214,1225
Rik Smits,C,33,IND,79,79,1852,431,890,0.484,0,1,0.0,431,889,0.485,0.484,156,211,0.7390000000000001,94,307,401,85,20,100,108,249,1018
Eric Snow,PG,26,PHI,82,80,2866,257,597,0.43,11,45,0.244,246,552,0.446,0.44,126,177,0.7120000000000001,42,219,261,624,140,8,162,243,651
Felton Spencer,C,32,SAS,26,0,149,15,33,0.455,0,0,0.0,15,33,0.455,0.455,20,30,0.667,15,24,39,3,6,8,9,32,50
Latrell Sprewell,SF,29,NYK,82,82,3276,568,1305,0.435,44,127,0.34600000000000003,524,1178,0.445,0.452,344,397,0.866,49,300,349,332,109,22,226,184,1524
Ryan Stack,PF,24,CLE,25,0,198,17,51,0.33299999999999996,0,1,0.0,17,50,0.34,0.33299999999999996,18,27,0.667,15,30,45,5,4,11,17,47,52
Jerry Stackhouse,SG,25,DET,82,82,3148,619,1447,0.428,83,288,0.28800000000000003,536,1159,0.462,0.456,618,758,0.815,118,197,315,365,103,36,311,188,1939
John Starks,SG,34,TOT,37,30,1190,203,542,0.375,59,171,0.345,144,371,0.38799999999999996,0.429,50,59,0.847,10,91,101,181,42,4,67,102,515
Vladimir Stepania,C,23,SEA,30,1,202,29,79,0.36700000000000005,0,6,0.0,29,73,0.397,0.36700000000000005,17,36,0.47200000000000003,21,26,47,3,10,11,22,44,75
Joe Stephens,SF,27,VAN,13,0,181,19,51,0.373,0,8,0.0,19,43,0.442,0.373,3,4,0.75,13,23,36,11,7,3,6,9,41
Michael Stewart,C,24,TOR,42,1,389,20,53,0.377,0,0,0.0,20,53,0.377,0.377,18,32,0.563,33,61,94,6,5,19,17,81,58
Bryant Stith,SG,29,DEN,45,6,691,86,189,0.455,17,56,0.304,69,133,0.519,0.5,64,77,0.831,23,61,84,61,18,12,33,56,253
John Stockton*,PG,37,UTA,82,82,2432,363,725,0.501,43,121,0.355,320,604,0.53,0.53,221,257,0.86,45,170,215,703,143,15,179,192,990
Peja Stojaković,SF,22,SAC,74,11,1749,321,717,0.44799999999999995,100,267,0.375,221,450,0.491,0.517,135,153,0.882,74,202,276,106,52,7,88,97,877
Damon Stoudamire,PG,26,POR,78,78,2372,386,894,0.43200000000000005,80,212,0.377,306,682,0.449,0.47700000000000004,122,145,0.841,61,182,243,405,77,1,149,173,974
Erick Strickland,SG,26,DAL,68,67,2025,316,730,0.433,73,186,0.392,243,544,0.447,0.483,162,195,0.831,69,254,323,211,105,13,102,190,867
Mark Strickland,SF,29,MIA,58,5,663,122,224,0.545,0,0,0.0,122,224,0.545,0.545,40,56,0.7140000000000001,44,96,140,22,15,18,24,68,284
Rod Strickland,PG,33,WAS,69,67,2188,327,762,0.429,1,21,0.048,326,741,0.44,0.43,214,305,0.7020000000000001,73,186,259,519,94,18,187,147,869
Derek Strong,PF,31,ORL,20,0,148,21,48,0.43799999999999994,1,4,0.25,20,44,0.455,0.44799999999999995,11,14,0.7859999999999999,11,33,44,4,5,2,12,15,54
Bruno Šundov,C,19,DAL,14,0,61,12,31,0.387,0,0,0.0,12,31,0.387,0.387,2,2,1.0,5,7,12,2,2,2,4,16,26
Bob Sura,SG,26,CLE,73,45,2216,356,815,0.43700000000000006,122,332,0.36700000000000005,234,483,0.484,0.512,175,251,0.6970000000000001,50,238,288,284,91,19,148,201,1009
Wally Szczerbiak,SF,22,MIN,73,53,2171,342,669,0.511,28,78,0.359,314,591,0.531,0.532,133,161,0.826,89,183,272,201,58,23,83,175,845
Žan Tabak,C,29,IND,18,0,114,16,34,0.47100000000000003,0,0,0.0,16,34,0.47100000000000003,0.47100000000000003,5,8,0.625,16,16,32,4,3,9,11,13,37
Johnny Taylor,SF,25,TOT,6,0,34,5,14,0.35700000000000004,1,1,1.0,4,13,0.308,0.39299999999999996,0,0,0.0,2,4,6,1,1,1,2,5,11
Maurice Taylor,PF,23,LAC,62,60,2227,458,988,0.46399999999999997,1,8,0.125,457,980,0.466,0.46399999999999997,143,201,0.711,96,304,400,101,51,48,169,217,1060
Jason Terry,PG,22,ATL,81,27,1888,249,600,0.415,46,157,0.293,203,443,0.45799999999999996,0.45299999999999996,113,140,0.807,24,142,166,346,90,10,156,133,657
Jamel Thomas,SF,26,TOT,7,0,46,8,18,0.444,0,3,0.0,8,15,0.5329999999999999,0.444,1,1,1.0,1,4,5,6,1,0,5,2,17
John Thomas,C,24,TOR,55,6,477,49,107,0.45799999999999996,0,1,0.0,49,106,0.462,0.45799999999999996,16,41,0.39,37,38,75,9,12,14,14,106,114
Kenny Thomas,PF,22,HOU,72,29,1797,212,531,0.39899999999999997,32,122,0.262,180,409,0.44,0.429,138,209,0.66,147,290,437,113,54,22,112,167,594
Kurt Thomas,PF,27,NYK,80,21,1971,270,535,0.505,1,3,0.33299999999999996,269,532,0.506,0.506,100,128,0.7809999999999999,144,361,505,82,51,42,105,278,641
Tim Thomas,SF,22,MIL,80,1,2093,347,753,0.461,63,182,0.34600000000000003,284,571,0.49700000000000005,0.503,188,243,0.774,100,232,332,113,59,31,129,227,945
Otis Thorpe,PF,37,MIA,51,1,777,125,243,0.514,0,3,0.0,125,240,0.521,0.514,29,48,0.604,56,110,166,33,26,9,59,136,279
Robert Traylor,PF,22,MIL,44,16,447,58,122,0.475,0,4,0.0,58,118,0.49200000000000005,0.475,41,68,0.603,50,65,115,20,25,25,27,79,157
Gary Trent,SF,25,DAL,11,11,301,70,142,0.493,0,2,0.0,70,140,0.5,0.493,11,21,0.524,20,32,52,22,8,3,25,28,151
Mirsad Türkcan,PF,23,TOT,17,0,90,14,38,0.368,0,6,0.0,14,32,0.43799999999999994,0.368,5,8,0.625,13,20,33,5,3,1,8,14,33
Wayne Turner,PG,23,BOS,3,0,41,1,6,0.16699999999999998,0,0,0.0,1,6,0.16699999999999998,0.16699999999999998,2,6,0.33299999999999996,1,2,3,5,0,0,3,4,4
Nick Van Exel,PG,28,DEN,79,79,2950,473,1213,0.39,133,401,0.332,340,812,0.419,0.445,196,240,0.8170000000000001,34,277,311,714,68,11,221,148,1275
Keith Van Horn,PF,24,NJN,80,80,2782,559,1257,0.445,84,228,0.368,475,1029,0.462,0.478,333,393,0.847,200,476,676,158,64,60,245,258,1535
Jacque Vaughn,PG,24,UTA,78,0,884,109,262,0.41600000000000004,14,34,0.41200000000000003,95,228,0.41700000000000004,0.44299999999999995,57,76,0.75,11,54,65,121,32,0,77,92,289
Loy Vaught,PF,31,DET,43,0,292,32,89,0.36,0,3,0.0,32,86,0.37200000000000005,0.36,11,16,0.688,26,65,91,11,6,4,11,45,75
Fred Vinson,SG,29,SEA,8,0,40,5,17,0.294,2,7,0.28600000000000003,3,10,0.3,0.353,1,2,0.5,0,1,1,0,3,0,4,2,13
Antoine Walker,PF,23,BOS,82,82,3003,648,1506,0.43,73,285,0.256,575,1221,0.47100000000000003,0.455,311,445,0.6990000000000001,199,453,652,305,117,32,259,263,1680
Samaki Walker,PF,23,SAS,71,7,980,137,305,0.449,0,0,0.0,137,305,0.449,0.449,86,126,0.6829999999999999,77,195,272,38,10,35,64,108,360
Ben Wallace,PF,25,ORL,81,81,1959,168,334,0.503,0,0,0.0,168,334,0.503,0.503,54,114,0.474,211,454,665,67,72,130,67,162,390
John Wallace,SF,25,NYK,60,0,798,155,332,0.467,0,3,0.0,155,329,0.47100000000000003,0.467,82,102,0.804,42,93,135,22,10,14,63,103,392
Rasheed Wallace,PF,25,POR,81,77,2845,542,1045,0.519,8,50,0.16,534,995,0.537,0.522,233,331,0.7040000000000001,129,437,566,142,87,107,157,216,1325
Rex Walters,PG,29,MIA,33,0,389,38,91,0.418,5,20,0.25,33,71,0.465,0.445,12,16,0.75,8,28,36,65,6,0,29,44,93
Charlie Ward,PG,29,NYK,72,69,1986,189,447,0.423,102,264,0.386,87,183,0.475,0.537,48,58,0.828,22,206,228,300,95,16,102,176,528
Clarence Weatherspoon,PF,29,MIA,78,2,1615,215,419,0.513,0,0,0.0,215,419,0.513,0.513,135,183,0.738,128,321,449,93,51,49,100,165,565
Chris Webber,PF,26,SAC,75,75,2880,748,1548,0.483,27,95,0.284,721,1453,0.496,0.49200000000000005,311,414,0.7509999999999999,189,598,787,345,120,128,218,264,1834
Bonzi Wells,SF,23,POR,66,0,1162,236,480,0.49200000000000005,20,53,0.377,216,427,0.506,0.513,88,129,0.682,78,104,182,97,69,12,97,153,580
Bill Wennington,C,36,SAC,7,0,57,6,19,0.316,0,0,0.0,6,19,0.316,0.316,2,2,1.0,5,14,19,1,2,2,1,13,14
David Wesley,PG,29,CHH,82,82,2760,407,955,0.426,88,248,0.355,319,707,0.451,0.47200000000000003,214,275,0.778,39,186,225,463,109,11,159,186,1116
Doug West,SG,32,VAN,38,0,581,59,145,0.40700000000000003,0,3,0.0,59,142,0.415,0.40700000000000003,34,40,0.85,18,53,71,43,12,8,19,80,152
Mark West,C,39,PHO,22,2,127,5,12,0.41700000000000004,0,0,0.0,5,12,0.41700000000000004,0.41700000000000004,5,8,0.625,6,25,31,2,2,4,6,23,15
Jahidi White,C,23,WAS,80,59,1537,228,450,0.507,0,0,0.0,228,450,0.507,0.507,113,211,0.536,202,351,553,15,31,83,94,234,569
Chris Whitney,PG,28,WAS,82,15,1627,217,521,0.41700000000000004,96,255,0.376,121,266,0.455,0.509,112,132,0.848,20,114,134,313,55,5,107,166,642
Aaron Williams,PF,28,WAS,81,0,1545,235,450,0.522,0,3,0.0,235,447,0.526,0.522,146,201,0.726,159,250,409,58,41,92,80,234,616
Alvin Williams,PG,25,TOR,55,28,779,114,287,0.397,16,55,0.29100000000000004,98,232,0.42200000000000004,0.425,48,65,0.738,27,58,85,126,34,11,47,78,292
Eric Williams,SF,27,BOS,68,17,1378,165,386,0.42700000000000005,25,72,0.34700000000000003,140,314,0.446,0.46,134,169,0.7929999999999999,55,101,156,93,44,16,66,165,489
Jason Williams,PG,24,SAC,81,81,2760,363,973,0.373,145,505,0.287,218,468,0.466,0.44799999999999995,128,170,0.753,22,208,230,589,117,8,296,140,999
Jerome Williams,PF,26,DET,82,1,2102,257,456,0.564,0,3,0.0,257,453,0.5670000000000001,0.564,175,284,0.616,277,512,789,68,95,21,105,196,689
Lorenzo Williams,PF,30,WAS,8,0,76,7,9,0.778,0,0,0.0,7,9,0.778,0.778,0,0,0.0,12,13,25,1,3,6,3,13,14
Monty Williams,SF,28,ORL,75,23,1501,263,538,0.489,2,5,0.4,261,533,0.49,0.491,123,166,0.741,96,154,250,106,46,17,109,187,651
Scott Williams,C,31,MIL,68,46,1488,213,426,0.5,0,0,0.0,213,426,0.5,0.5,94,129,0.7290000000000001,177,271,448,28,40,66,65,230,520
Shammond Williams,PG,24,SEA,43,5,517,84,225,0.373,24,81,0.29600000000000004,60,144,0.41700000000000004,0.42700000000000005,33,51,0.647,12,40,52,78,18,0,40,39,225
Walt Williams,SF,29,HOU,76,66,1859,312,681,0.45799999999999996,102,261,0.391,210,420,0.5,0.5329999999999999,101,123,0.821,69,237,306,157,49,44,113,190,827
Corliss Williamson,SF,26,SAC,76,76,1707,311,622,0.5,0,0,0.0,311,622,0.5,0.5,163,212,0.769,122,168,290,82,38,19,110,192,785
Kevin Willis,PF,37,TOR,79,1,1679,236,569,0.415,1,3,0.33299999999999996,235,566,0.415,0.41600000000000004,131,164,0.799,201,281,482,49,36,48,98,256,604
Dedric Willoughby,PG,25,CHI,25,1,508,61,179,0.341,29,98,0.29600000000000004,32,81,0.395,0.42200000000000004,39,51,0.765,11,40,51,66,23,2,37,32,190
David Wingate,SG,36,NYK,7,0,32,1,9,0.111,0,0,0.0,1,9,0.111,0.111,0,0,0.0,1,1,2,3,1,2,2,7,2
Haywoode Workman,PG,34,TOT,36,2,350,31,90,0.344,14,43,0.326,17,47,0.36200000000000004,0.42200000000000004,10,15,0.667,1,25,26,61,20,0,18,37,86
Metta World Peace,SF,20,CHI,72,63,2238,309,759,0.40700000000000003,60,191,0.314,249,568,0.43799999999999994,0.447,188,279,0.674,62,246,308,202,119,39,166,159,866
Lorenzen Wright,C,24,ATL,75,0,1205,180,361,0.499,1,3,0.33299999999999996,179,358,0.5,0.5,87,135,0.644,117,188,305,21,29,40,66,203,448
Tim Young,C,23,GSW,25,0,137,13,39,0.33299999999999996,0,0,0.0,13,39,0.33299999999999996,0.33299999999999996,28,36,0.778,13,22,35,5,2,1,9,18,54
