Player,Pos,Age,Tm,G,GS,MP,FG,FGA,FG%,3P,3PA,3P%,2P,2PA,2P%,eFG%,FT,FTA,FT%,ORB,DRB,TRB,AST,STL,BLK,TOV,PF,PTS
Tariq Abdul-Wahad,SG,27,TOT,24,12,441,55,147,0.374,1,2,0.5,54,145,0.37200000000000005,0.37799999999999995,24,33,0.727,41,43,84,24,20,10,27,56,135
Shareef Abdur-Rahim,PF,25,ATL,77,77,2980,598,1297,0.461,21,70,0.3,577,1227,0.47,0.469,419,523,0.8009999999999999,198,498,696,239,98,81,250,214,1636
Courtney Alexander,SG,24,WAS,56,28,1325,223,474,0.47,5,18,0.278,218,456,0.478,0.47600000000000003,98,121,0.81,43,105,148,86,35,7,60,113,549
Victor Alexander,C,32,DET,15,0,97,18,51,0.353,0,2,0.0,18,49,0.36700000000000005,0.353,4,8,0.5,7,22,29,6,0,1,5,6,40
Malik Allen,PF,23,MIA,12,2,161,22,51,0.431,0,1,0.0,22,50,0.44,0.431,8,10,0.8,15,23,38,5,3,8,2,16,52
Ray Allen*,SG,26,MIL,69,67,2525,530,1148,0.462,229,528,0.434,301,620,0.485,0.561,214,245,0.873,81,231,312,271,88,18,159,157,1503
Rafer Alston,PG,25,MIL,50,7,600,66,191,0.34600000000000003,27,71,0.38,39,120,0.325,0.41600000000000004,18,29,0.621,10,62,72,143,32,2,40,42,177
John Amaechi,PF,31,UTA,54,0,586,54,166,0.325,0,0,0.0,54,166,0.325,0.325,67,105,0.638,52,57,109,29,7,10,55,64,175
Chris Andersen,C,23,DEN,24,1,262,25,74,0.33799999999999997,0,4,0.0,25,70,0.35700000000000004,0.33799999999999997,22,28,0.7859999999999999,38,38,76,7,7,28,13,35,72
Derek Anderson,SG,27,POR,70,27,1860,247,612,0.40399999999999997,85,228,0.373,162,384,0.42200000000000004,0.473,178,208,0.856,47,142,189,216,68,8,87,113,757
Kenny Anderson,PG,31,BOS,76,76,2430,312,716,0.436,9,33,0.273,303,683,0.444,0.442,98,132,0.742,57,218,275,403,141,10,119,210,731
Nick Anderson,SG,34,MEM,15,0,219,21,76,0.276,13,48,0.271,8,28,0.28600000000000003,0.36200000000000004,5,9,0.556,1,32,33,14,6,6,14,17,60
Shandon Anderson,SG,28,NYK,82,6,1596,149,373,0.39899999999999997,39,141,0.27699999999999997,110,232,0.474,0.452,74,107,0.6920000000000001,57,192,249,76,48,15,97,134,411
Greg Anthony,PG,34,TOT,60,38,1514,183,475,0.385,48,163,0.294,135,312,0.433,0.436,60,91,0.659,22,110,132,282,77,5,94,114,474
Gilbert Arenas,PG,20,GSW,47,30,1155,174,384,0.45299999999999996,39,113,0.345,135,271,0.498,0.504,124,160,0.775,41,91,132,174,69,11,97,115,511
Brandon Armstrong,SG,21,NJN,35,0,196,27,85,0.318,5,17,0.294,22,68,0.324,0.34700000000000003,5,10,0.5,10,6,16,8,7,1,8,26,64
Darrell Armstrong,PG,33,ORL,82,79,2730,347,828,0.419,139,398,0.349,208,430,0.484,0.503,182,205,0.888,83,236,319,453,157,10,175,166,1015
Carlos Arroyo,PG,22,TOT,37,1,371,49,111,0.441,0,2,0.0,49,109,0.45,0.441,13,18,0.722,12,28,40,70,11,1,23,30,111
Chucky Atkins,PG,27,DET,79,62,2285,368,790,0.466,138,336,0.41100000000000003,230,454,0.507,0.5529999999999999,83,120,0.6920000000000001,31,127,158,263,72,11,128,177,957
Stacey Augmon,SG,33,CHH,77,3,1319,140,328,0.42700000000000005,0,3,0.0,140,325,0.431,0.42700000000000005,77,101,0.762,59,166,225,103,56,12,54,115,357
Isaac Austin,C,32,MEM,21,8,307,36,92,0.391,0,3,0.0,36,89,0.40399999999999997,0.391,4,4,1.0,11,60,71,13,9,5,11,36,76
William Avery,PG,22,MIN,28,0,258,26,90,0.289,6,35,0.171,20,55,0.364,0.322,13,19,0.684,4,20,24,36,7,0,19,17,71
Dalibor Bagarić,C,21,CHI,50,0,638,72,178,0.40399999999999997,0,1,0.0,72,177,0.40700000000000003,0.40399999999999997,41,70,0.586,55,107,162,23,17,24,46,108,185
Vin Baker,C,30,SEA,55,41,1710,315,649,0.485,1,8,0.125,314,641,0.49,0.486,143,226,0.633,168,182,350,72,22,36,127,197,774
Erick Barkley,PG,23,POR,19,4,228,24,68,0.353,1,7,0.14300000000000002,23,61,0.377,0.36,9,10,0.9,5,13,18,34,17,1,12,29,58
Dana Barros,PG,34,DET,29,20,582,74,192,0.385,24,71,0.33799999999999997,50,121,0.413,0.44799999999999995,21,27,0.778,1,56,57,78,14,2,33,37,193
Brent Barry,SG,30,SEA,81,81,3040,401,790,0.508,164,387,0.424,237,403,0.588,0.611,198,234,0.846,58,383,441,426,147,37,165,182,1164
Jon Barry,SG,32,DET,82,6,1985,255,522,0.489,121,258,0.469,134,264,0.508,0.604,108,116,0.9309999999999999,42,192,234,274,94,20,111,134,739
Mengke Bateer,C,26,DEN,27,10,408,53,132,0.402,4,12,0.33299999999999996,49,120,0.408,0.41700000000000004,29,37,0.784,32,64,96,22,10,5,32,94,139
Tony Battie,C,25,BOS,74,73,1819,211,390,0.541,0,2,0.0,211,388,0.544,0.541,88,130,0.677,184,297,481,35,60,67,51,219,510
Shane Battier,SF,23,MEM,78,78,3097,412,961,0.429,103,276,0.373,309,685,0.451,0.48200000000000004,198,283,0.7,180,238,418,216,121,81,155,215,1125
Charlie Bell,SG,22,TOT,7,0,44,3,11,0.273,0,6,0.0,3,5,0.6,0.273,2,2,1.0,2,3,5,2,0,0,5,3,8
Raja Bell,SG,25,PHI,74,12,890,103,240,0.429,12,44,0.273,91,196,0.46399999999999997,0.45399999999999996,36,48,0.75,31,80,111,71,21,4,48,109,254
Jonathan Bender,SF,21,IND,78,17,1647,198,460,0.43,45,125,0.36,153,335,0.457,0.479,140,181,0.773,64,180,244,62,19,49,96,147,581
Travis Best,PG,29,TOT,74,21,1747,228,518,0.44,21,59,0.35600000000000004,207,459,0.451,0.46,104,116,0.897,20,131,151,324,89,7,99,173,581
Mike Bibby,PG,23,SAC,80,80,2659,446,985,0.45299999999999996,51,138,0.37,395,847,0.466,0.479,155,193,0.8029999999999999,37,185,222,403,87,15,134,133,1098
Chauncey Billups,PG,25,MIN,82,54,2355,348,823,0.423,124,315,0.39399999999999996,224,508,0.441,0.498,207,234,0.885,35,191,226,450,66,17,138,169,1027
Mookie Blaylock,PG,34,GSW,35,0,599,50,146,0.342,15,42,0.35700000000000004,35,104,0.337,0.39399999999999996,4,8,0.5,8,44,52,114,24,4,37,20,119
Corie Blount,PF,33,PHI,72,21,1426,115,251,0.45799999999999996,0,1,0.0,115,250,0.46,0.45799999999999996,29,45,0.644,149,219,368,44,49,26,52,176,259
Mark Blount,C,26,BOS,44,0,415,32,76,0.42100000000000004,0,0,0.0,32,76,0.42100000000000004,0.42100000000000004,30,37,0.8109999999999999,26,59,85,10,16,19,23,59,94
Calvin Booth,C,25,SEA,15,15,279,35,82,0.42700000000000005,0,0,0.0,35,82,0.42700000000000005,0.42700000000000005,23,24,0.958,20,34,54,16,6,13,16,47,93
Ruben Boumtje-Boumtje,C,23,POR,33,1,245,13,32,0.406,0,0,0.0,13,32,0.406,0.406,13,25,0.52,21,34,55,4,3,16,14,38,39
Cal Bowdler,PF,24,ATL,52,0,585,61,174,0.35100000000000003,1,5,0.2,60,169,0.355,0.353,39,47,0.83,38,72,110,11,18,15,11,64,162
Bruce Bowen,SF,30,SAS,59,59,1699,155,398,0.389,56,148,0.37799999999999995,99,250,0.396,0.46,46,96,0.479,42,120,162,88,62,25,66,116,412
Ryan Bowen,SF,26,DEN,75,21,1686,147,307,0.479,1,12,0.083,146,295,0.495,0.48,69,92,0.75,134,165,299,52,75,41,41,171,364
Ira Bowman,SG,28,PHI,3,0,29,5,7,0.7140000000000001,0,1,0.0,5,6,0.833,0.7140000000000001,0,0,0.0,0,1,1,1,2,0,0,3,10
Earl Boykins,PG,25,LAC,68,2,761,110,275,0.4,13,42,0.31,97,233,0.41600000000000004,0.424,47,61,0.77,27,27,54,145,20,2,44,44,280
Michael Bradley,PF,22,TOR,26,0,118,13,25,0.52,0,2,0.0,13,23,0.565,0.52,4,8,0.5,7,17,24,3,0,6,6,10,30
Shawn Bradley,C,29,DAL,53,16,757,78,163,0.479,0,1,0.0,78,162,0.48100000000000004,0.479,59,64,0.922,53,123,176,20,28,64,25,128,215
Elton Brand,PF,22,LAC,80,80,3020,532,1010,0.527,0,0,0.0,532,1010,0.527,0.527,389,524,0.742,396,529,925,191,80,163,173,254,1453
Terrell Brandon,PG,31,MIN,32,28,962,155,365,0.425,4,23,0.174,151,342,0.442,0.43,83,84,0.988,17,76,93,264,52,6,43,49,397
Jamison Brewer,SG,21,IND,13,0,43,2,5,0.4,0,1,0.0,2,4,0.5,0.4,0,0,0.0,2,6,8,9,2,0,3,3,4
Primož Brezec,C,22,IND,22,4,160,14,29,0.483,0,0,0.0,14,29,0.483,0.483,15,25,0.6,16,12,28,6,0,7,6,28,43
Chucky Brown,SF,33,SAC,18,0,92,10,27,0.37,0,0,0.0,10,27,0.37,0.37,1,2,0.5,10,23,33,6,2,4,5,12,21
Damone Brown,SF,22,PHI,17,0,67,8,21,0.381,0,1,0.0,8,20,0.4,0.381,7,8,0.875,2,2,4,2,1,1,9,11,23
Dee Brown,PG,33,ORL,7,0,65,3,20,0.15,1,12,0.083,2,8,0.25,0.175,0,0,0.0,0,9,9,2,3,1,4,4,7
Ernest Brown,C,22,MIA,3,0,21,1,6,0.16699999999999998,0,0,0.0,1,6,0.16699999999999998,0.16699999999999998,1,4,0.25,1,5,6,0,0,1,3,4,3
Kedrick Brown,SF,20,BOS,29,5,245,23,70,0.32899999999999996,5,27,0.185,18,43,0.419,0.364,12,20,0.6,11,39,50,15,18,7,7,18,63
Kwame Brown,PF,19,WAS,57,3,817,94,243,0.387,0,1,0.0,94,242,0.38799999999999996,0.387,70,99,0.7070000000000001,63,135,198,43,16,26,43,105,258
P.J. Brown,C,32,CHH,80,80,2563,250,527,0.474,0,0,0.0,250,527,0.474,0.474,169,197,0.858,273,513,786,107,59,78,85,222,669
Randy Brown,PG,33,BOS,1,0,6,0,1,0.0,0,0,0.0,0,1,0.0,0.0,0,0,0.0,0,0,0,2,0,1,0,1,0
Tierre Brown,SG,22,HOU,40,1,403,49,115,0.426,4,12,0.33299999999999996,45,103,0.43700000000000006,0.44299999999999995,21,28,0.75,12,30,42,70,19,3,40,26,123
Rick Brunson,PG,29,POR,59,2,520,45,113,0.39799999999999996,6,11,0.545,39,102,0.382,0.425,29,41,0.7070000000000001,23,45,68,114,25,2,47,51,125
Kobe Bryant,SG,23,LAL,80,80,3063,749,1597,0.469,33,132,0.25,716,1465,0.489,0.479,488,589,0.8290000000000001,112,329,441,438,118,35,223,228,2019
Mark Bryant,PF,36,SAS,30,3,206,25,55,0.455,0,0,0.0,25,55,0.455,0.455,6,8,0.75,25,19,44,10,7,2,6,38,56
Greg Buckner,SG,25,DAL,44,16,885,104,198,0.525,5,16,0.313,99,182,0.544,0.5379999999999999,40,58,0.69,67,106,173,48,31,19,27,124,253
Jud Buechler,SF,33,TOT,66,2,684,44,118,0.373,21,60,0.35,23,58,0.397,0.462,2,4,0.5,29,87,116,32,21,8,15,53,111
Rodney Buford,SG,24,MEM,63,21,1769,258,593,0.435,17,70,0.243,241,523,0.461,0.449,58,80,0.725,52,220,272,71,42,12,63,110,591
Matt Bullard,PF,34,CHH,31,0,350,39,115,0.33899999999999997,16,57,0.281,23,58,0.397,0.409,11,12,0.917,10,37,47,16,2,2,12,29,105
Mitchell Butler,SG,31,POR,11,0,90,10,23,0.435,1,3,0.33299999999999996,9,20,0.45,0.457,8,12,0.667,6,8,14,5,0,1,5,10,29
Jason Caffey,PF,28,MIL,23,0,283,36,72,0.5,0,1,0.0,36,71,0.507,0.5,27,43,0.628,24,26,50,12,4,5,19,39,99
Marcus Camby,C,27,NYK,29,29,1007,130,290,0.44799999999999995,0,1,0.0,130,289,0.45,0.44799999999999995,62,99,0.626,89,233,322,33,34,50,42,107,322
Elden Campbell,PF,33,CHH,77,74,2156,384,794,0.484,0,2,0.0,384,792,0.485,0.484,306,384,0.797,133,397,530,102,60,137,138,264,1074
Brian Cardinal,PF,24,DET,8,0,43,6,13,0.462,3,7,0.429,3,6,0.5,0.5770000000000001,2,2,1.0,2,4,6,2,1,0,0,5,17
Anthony Carter,PG,26,MIA,46,18,1050,89,260,0.342,1,19,0.053,88,241,0.365,0.344,19,36,0.528,19,98,117,214,50,3,72,85,198
Vince Carter,SG,25,TOR,60,60,2385,559,1307,0.428,121,313,0.387,438,994,0.441,0.474,245,307,0.7979999999999999,138,175,313,239,94,43,154,191,1484
Sam Cassell,PG,32,MIL,74,73,2605,554,1197,0.46299999999999997,71,204,0.348,483,993,0.486,0.49200000000000005,282,328,0.86,54,258,312,493,90,12,177,208,1461
Kelvin Cato,C,27,HOU,75,73,1917,190,326,0.583,0,1,0.0,190,325,0.585,0.583,113,194,0.5820000000000001,176,349,525,29,40,95,53,208,493
Tyson Chandler,C,19,CHI,71,31,1389,151,304,0.49700000000000005,0,0,0.0,151,304,0.49700000000000005,0.49700000000000005,134,222,0.604,114,229,343,54,28,93,99,179,436
Calbert Cheaney,SG,30,DEN,68,47,1631,224,466,0.48100000000000004,0,4,0.0,224,462,0.485,0.48100000000000004,46,67,0.687,57,183,240,110,34,21,70,156,494
Chris Childs,PG,34,TOR,69,4,1576,97,296,0.32799999999999996,33,120,0.275,64,176,0.364,0.38299999999999995,58,71,0.8170000000000001,18,136,154,351,56,5,123,177,285
Doug Christie,SG,31,SAC,81,81,2798,338,735,0.46,90,256,0.35200000000000004,248,479,0.518,0.521,206,242,0.851,74,300,374,340,160,25,164,209,972
Keon Clark,C,26,TOR,81,31,2185,380,775,0.49,0,5,0.0,380,770,0.494,0.49,155,230,0.674,182,421,603,88,58,122,140,258,915
Speedy Claxton,PG,23,PHI,67,18,1528,181,452,0.4,4,33,0.121,177,419,0.42200000000000004,0.405,114,136,0.838,46,114,160,198,95,6,95,145,480
Mateen Cleaves,PG,24,SAC,32,0,153,30,68,0.441,2,8,0.25,28,60,0.467,0.456,8,9,0.889,1,7,8,25,7,0,27,9,70
Derrick Coleman,PF,34,PHI,58,58,2080,331,735,0.45,28,83,0.337,303,652,0.465,0.469,185,227,0.815,167,342,509,98,42,51,119,158,875
Bimbo Coles,PG,33,CLE,47,1,693,56,146,0.384,4,20,0.2,52,126,0.413,0.397,33,37,0.892,12,43,55,107,13,4,31,59,149
Jason Collier,C,24,HOU,25,2,365,41,95,0.43200000000000005,0,1,0.0,41,94,0.436,0.43200000000000005,24,32,0.75,31,51,82,9,6,4,13,40,106
Jarron Collins,C,23,UTA,70,68,1440,158,343,0.461,0,1,0.0,158,342,0.462,0.461,134,181,0.74,138,158,296,58,29,22,56,234,450
Jason Collins,C,23,NJN,77,9,1407,117,278,0.42100000000000004,1,2,0.5,116,276,0.42,0.423,115,164,0.701,132,169,301,81,29,47,72,173,350
Chris Crawford,PF,26,ATL,7,4,131,21,45,0.467,0,1,0.0,21,44,0.47700000000000004,0.467,11,15,0.733,9,16,25,5,2,5,10,21,53
Jamal Crawford,PG,21,CHI,23,6,481,89,187,0.47600000000000003,26,58,0.44799999999999995,63,129,0.488,0.545,10,13,0.769,5,29,34,55,18,5,32,18,214
Joe Crispin,PG,22,TOT,21,0,156,26,68,0.382,15,39,0.385,11,29,0.379,0.493,12,13,0.9229999999999999,2,9,11,26,5,0,10,10,79
Austin Croshere,PF,26,IND,76,1,1286,185,448,0.413,49,145,0.33799999999999997,136,303,0.449,0.46799999999999997,97,114,0.851,74,220,294,77,26,29,67,106,516
John Crotty,PG,32,UTA,41,0,802,98,208,0.47100000000000003,31,69,0.449,67,139,0.48200000000000004,0.546,57,66,0.8640000000000001,16,59,75,141,19,1,51,77,284
Vonteego Cummings,PG,25,PHI,58,1,501,78,187,0.41700000000000004,12,46,0.261,66,141,0.46799999999999997,0.449,24,32,0.75,14,38,52,60,18,5,36,53,192
Dell Curry,SG,37,TOR,56,4,886,141,347,0.406,45,131,0.344,96,216,0.444,0.47100000000000003,33,37,0.892,23,58,81,61,22,6,41,50,360
Eddy Curry,C,19,CHI,72,31,1150,189,377,0.501,0,0,0.0,189,377,0.501,0.501,105,160,0.6559999999999999,111,161,272,25,16,53,69,173,483
Michael Curry,SG,33,DET,82,75,1912,125,276,0.45299999999999996,7,26,0.26899999999999996,118,250,0.47200000000000003,0.466,72,91,0.7909999999999999,15,153,168,127,47,10,60,207,329
Samuel Dalembert,C,20,PHI,34,0,177,22,50,0.44,0,0,0.0,22,50,0.44,0.44,7,18,0.389,25,43,68,5,6,13,14,30,51
Erick Dampier,C,26,GSW,73,46,1740,209,480,0.435,0,0,0.0,209,480,0.435,0.435,136,211,0.645,167,220,387,87,17,167,156,235,554
Antonio Daniels,SG,26,SAS,82,13,2175,269,612,0.44,57,196,0.29100000000000004,212,416,0.51,0.486,158,210,0.752,23,153,176,228,48,12,70,104,753
Antonio Davis,PF,33,TOR,77,77,2978,410,963,0.426,0,1,0.0,410,962,0.426,0.426,293,358,0.818,254,486,740,155,54,83,159,225,1113
Baron Davis,PG,22,CHH,82,82,3318,559,1341,0.41700000000000004,170,478,0.35600000000000004,389,863,0.451,0.48,196,338,0.58,93,256,349,698,172,47,246,241,1484
Dale Davis,C,32,POR,78,77,2447,296,580,0.51,0,0,0.0,296,580,0.51,0.51,150,212,0.708,262,426,688,96,62,83,62,193,742
Emanual Davis,PG,33,ATL,28,20,774,70,198,0.354,29,85,0.341,41,113,0.363,0.42700000000000005,16,18,0.889,19,55,74,68,27,5,52,68,185
Hubert Davis,SG,31,WAS,51,17,1231,146,326,0.44799999999999995,57,126,0.452,89,200,0.445,0.535,16,21,0.762,7,70,77,107,28,3,44,58,365
Ricky Davis,SF,22,CLE,82,8,1954,376,781,0.48100000000000004,11,35,0.314,365,746,0.489,0.488,196,248,0.79,63,180,243,178,69,23,148,145,959
Andrew DeClercq,C,28,ORL,61,14,633,67,149,0.45,0,0,0.0,67,149,0.45,0.45,28,50,0.56,74,89,163,22,23,24,34,130,162
Vinny Del Negro,PG,35,PHO,2,0,6,1,4,0.25,0,0,0.0,1,4,0.25,0.25,0,0,0.0,0,0,0,2,0,0,0,0,2
Tony Delk,SG,28,TOT,63,17,1447,226,588,0.384,67,214,0.313,159,374,0.425,0.441,78,97,0.804,58,145,203,132,53,10,59,98,597
Derrick Dial,SG,26,TOT,32,0,299,41,120,0.342,1,11,0.091,40,109,0.36700000000000005,0.34600000000000003,18,24,0.75,14,42,56,35,10,4,16,13,101
Michael Dickerson,SG,26,MEM,4,4,124,15,48,0.313,8,21,0.381,7,27,0.259,0.396,5,6,0.833,3,9,12,9,3,1,8,12,43
DeSagana Diop,C,20,CLE,18,1,109,12,29,0.414,0,0,0.0,12,29,0.414,0.414,1,5,0.2,5,12,17,5,1,10,12,19,25
Vlade Divac*,C,33,SAC,80,80,2420,338,716,0.47200000000000003,3,13,0.231,335,703,0.47700000000000004,0.474,209,340,0.615,205,466,671,297,79,94,158,229,888
Michael Doleac,C,24,CLE,42,15,705,78,187,0.41700000000000004,0,0,0.0,78,187,0.41700000000000004,0.41700000000000004,38,46,0.826,47,121,168,25,15,11,37,98,194
Keyon Dooling,PG,21,LAC,14,0,155,22,57,0.386,4,14,0.28600000000000003,18,43,0.419,0.42100000000000004,10,12,0.833,0,3,3,12,4,3,10,20,58
Bryce Drew,PG,27,CHH,61,0,774,78,182,0.429,31,73,0.425,47,109,0.431,0.514,23,29,0.7929999999999999,14,58,72,101,32,2,33,49,210
Predrag Drobnjak,C,26,SEA,64,12,1174,191,414,0.461,0,2,0.0,191,412,0.46399999999999997,0.461,55,73,0.753,75,144,219,51,20,31,51,109,437
Chris Dudley,C,36,POR,43,2,327,20,50,0.4,0,2,0.0,20,48,0.41700000000000004,0.4,8,15,0.5329999999999999,27,53,80,13,3,14,14,42,48
Tim Duncan,PF,25,SAS,82,82,3329,764,1504,0.508,1,10,0.1,763,1494,0.511,0.508,560,701,0.799,268,774,1042,307,61,203,263,217,2089
Howard Eisley,PG,29,NYK,39,0,609,59,175,0.337,14,58,0.24100000000000002,45,117,0.385,0.377,39,49,0.7959999999999999,9,40,49,100,24,3,53,55,171
Obinna Ekezie,PF,26,LAC,29,1,152,13,39,0.33299999999999996,0,0,0.0,13,39,0.33299999999999996,0.33299999999999996,28,40,0.7,12,22,34,3,2,6,10,16,54
LaPhonso Ellis,SF,31,MIA,66,14,1684,189,452,0.418,38,124,0.306,151,328,0.46,0.46,53,84,0.631,107,180,287,56,30,37,73,196,469
Evan Eschmeyer,C,26,DAL,31,6,299,21,50,0.42,0,0,0.0,21,50,0.42,0.42,20,33,0.606,35,63,98,9,10,9,16,60,62
Maurice Evans,SG,23,MIN,10,0,45,9,19,0.474,0,3,0.0,9,16,0.563,0.474,3,4,0.75,3,1,4,4,0,0,2,9,21
Patrick Ewing*,C,39,ORL,65,4,901,148,333,0.444,0,1,0.0,148,332,0.446,0.444,94,134,0.701,60,203,263,35,22,45,65,129,390
Danny Ferry,SF,35,SAS,50,2,799,76,177,0.429,43,99,0.434,33,78,0.423,0.551,34,36,0.9440000000000001,15,75,90,48,16,9,22,70,229
Michael Finley,SF,28,DAL,69,69,2754,569,1228,0.46299999999999997,76,224,0.33899999999999997,493,1004,0.491,0.494,210,251,0.8370000000000001,90,270,360,230,65,25,117,144,1424
Derek Fisher,PG,27,LAL,70,35,1974,274,666,0.41100000000000003,144,349,0.413,130,317,0.41,0.52,94,111,0.847,15,131,146,181,66,9,62,121,786
Marcus Fizer,PF,23,CHI,76,20,1963,371,848,0.43799999999999994,7,41,0.171,364,807,0.451,0.442,189,283,0.6679999999999999,128,299,427,120,49,24,131,186,938
Isaac Fontaine,SG,26,MEM,6,0,75,3,14,0.214,1,5,0.2,2,9,0.222,0.25,4,6,0.667,0,5,5,4,0,0,4,6,11
Alton Ford,PF,20,PHO,53,0,452,61,118,0.517,0,0,0.0,61,118,0.517,0.517,42,57,0.737,32,75,107,7,6,7,32,99,164
Joseph Forte,SG,20,BOS,8,0,39,1,12,0.083,0,3,0.0,1,9,0.111,0.083,4,4,1.0,1,5,6,6,2,0,3,1,6
Danny Fortson,PF,25,GSW,77,76,2216,309,722,0.428,1,4,0.25,308,718,0.429,0.429,245,308,0.795,290,609,899,127,44,17,160,255,864
Greg Foster,PF,33,MIL,6,0,24,2,9,0.222,0,4,0.0,2,5,0.4,0.222,3,4,0.75,0,8,8,1,0,0,0,4,7
Jeff Foster,C,25,IND,82,48,1786,177,394,0.449,2,15,0.133,175,379,0.462,0.452,111,182,0.61,206,350,556,70,71,38,79,232,467
Antonis Fotsis,PF,20,MEM,28,1,320,42,104,0.40399999999999997,7,23,0.304,35,81,0.43200000000000005,0.43799999999999994,17,20,0.85,25,37,62,10,9,11,21,22,108
Tremaine Fowlkes,SF,25,LAC,22,17,343,25,64,0.391,0,0,0.0,25,64,0.391,0.391,24,31,0.774,32,32,64,17,11,1,13,39,74
Rick Fox,SF,32,LAL,82,82,2289,255,605,0.42100000000000004,65,208,0.313,190,397,0.479,0.475,70,85,0.8240000000000001,90,299,389,283,67,21,132,244,645
Adonal Foyle,C,26,GSW,79,36,1485,171,385,0.444,0,0,0.0,171,385,0.444,0.444,37,93,0.39799999999999996,150,234,384,41,36,168,76,179,379
Steve Francis,PG,24,HOU,57,56,2343,420,1007,0.41700000000000004,68,210,0.324,352,797,0.442,0.451,326,422,0.773,102,299,401,362,71,25,221,172,1234
Lawrence Funderburke,PF,31,SAC,56,1,722,115,245,0.469,0,3,0.0,115,242,0.475,0.469,34,56,0.607,76,122,198,32,11,18,33,65,264
Kevin Garnett,PF,25,MIN,81,81,3175,659,1401,0.47,37,116,0.319,622,1285,0.484,0.484,359,448,0.8009999999999999,243,738,981,422,96,126,229,184,1714
Dean Garrett,C,35,TOT,34,0,183,18,55,0.327,0,0,0.0,18,55,0.327,0.327,0,3,0.0,16,41,57,5,7,10,10,32,36
Pat Garrity,PF,25,ORL,80,43,2406,327,767,0.426,169,396,0.42700000000000005,158,371,0.426,0.537,61,73,0.836,77,261,338,99,61,28,68,230,884
Pau Gasol,C,21,MEM,82,79,3007,551,1064,0.518,1,5,0.2,550,1059,0.519,0.518,338,477,0.7090000000000001,238,492,730,223,41,169,224,195,1441
Chris Gatling,PF,34,MIA,54,1,809,131,293,0.447,1,8,0.125,130,285,0.456,0.449,82,117,0.701,71,135,206,25,17,11,58,109,345
Matt Geiger,C,32,PHI,4,0,36,1,8,0.125,0,0,0.0,1,8,0.125,0.125,1,2,0.5,3,3,6,0,0,2,2,2,3
Devean George,SF,24,LAL,82,1,1759,215,523,0.41100000000000003,66,178,0.371,149,345,0.43200000000000005,0.474,85,126,0.675,78,225,303,111,71,42,66,190,581
Eddie Gill,PG,23,MEM,23,5,384,39,92,0.424,7,22,0.318,32,70,0.457,0.462,31,39,0.795,7,21,28,49,11,3,34,38,116
Kendall Gill,SG,33,MIA,65,49,1410,162,422,0.384,6,44,0.136,156,378,0.413,0.391,42,62,0.677,29,155,184,100,44,8,55,140,372
Dion Glover,SG,23,ATL,55,25,1156,192,456,0.42100000000000004,30,91,0.33,162,365,0.444,0.45399999999999996,78,103,0.757,36,133,169,84,45,14,76,89,492
Steve Goodrich,SF,25,NJN,9,0,50,2,10,0.2,0,0,0.0,2,10,0.2,0.2,1,2,0.5,1,4,5,5,1,2,3,10,5
Brian Grant,PF,29,MIA,72,72,2256,286,610,0.469,0,2,0.0,286,608,0.47,0.469,101,119,0.8490000000000001,168,407,575,137,48,31,122,236,673
Horace Grant,C,36,ORL,76,76,2210,264,515,0.513,0,0,0.0,264,515,0.513,0.513,80,111,0.721,159,322,481,104,57,49,51,118,608
Adrian Griffin,SG,27,DAL,58,34,1383,179,359,0.499,16,54,0.29600000000000004,163,305,0.534,0.521,41,49,0.8370000000000001,68,161,229,106,75,12,42,142,415
Eddie Griffin,PF,19,HOU,73,24,1896,244,666,0.366,90,273,0.33,154,393,0.392,0.434,64,86,0.7440000000000001,117,299,416,53,17,134,47,117,642
Tom Gugliotta,PF,32,PHO,44,40,1129,127,301,0.42200000000000004,3,9,0.33299999999999996,124,292,0.425,0.42700000000000005,28,37,0.757,59,162,221,77,39,30,61,116,285
A.J. Guyton,PG,23,CHI,45,6,607,88,244,0.361,46,123,0.374,42,121,0.34700000000000003,0.455,22,27,0.815,12,32,44,81,10,7,37,23,244
Darvin Ham,SF,28,MIL,70,2,1208,120,211,0.569,1,7,0.14300000000000002,119,204,0.583,0.5710000000000001,62,123,0.504,91,111,202,73,25,37,83,175,303
Richard Hamilton,SG,23,WAS,63,57,2203,472,1084,0.435,16,42,0.381,456,1042,0.43799999999999994,0.44299999999999995,300,337,0.89,73,143,216,171,38,14,132,136,1260
Tang Hamilton,SF,23,MIA,9,2,98,10,19,0.526,0,1,0.0,10,18,0.556,0.526,0,1,0.0,6,12,18,5,4,0,2,10,20
Zendon Hamilton,PF,26,DEN,54,15,848,103,245,0.42,0,0,0.0,103,245,0.42,0.42,118,181,0.652,110,143,253,14,21,18,60,104,324
Anfernee Hardaway,SG,30,PHO,80,55,2462,389,931,0.418,23,83,0.27699999999999997,366,848,0.43200000000000005,0.43,158,195,0.81,98,252,350,324,122,32,189,184,959
Tim Hardaway,PG,35,TOT,68,16,1601,226,620,0.365,123,354,0.34700000000000003,103,266,0.387,0.46399999999999997,77,97,0.794,14,110,124,278,57,10,111,109,652
Matt Harpring,SF,25,PHI,81,81,2541,386,838,0.461,21,69,0.304,365,769,0.475,0.473,165,222,0.743,203,370,573,107,70,5,127,201,958
Al Harrington,PF,21,IND,44,1,1313,230,484,0.475,1,3,0.33299999999999996,229,481,0.47600000000000003,0.47600000000000003,115,144,0.799,96,180,276,54,41,21,78,166,576
Othella Harrington,PF,28,NYK,77,4,1563,237,450,0.527,0,2,0.0,237,448,0.529,0.527,122,172,0.7090000000000001,125,224,349,37,30,36,95,250,596
Lucious Harris,SG,31,NJN,74,0,1553,249,537,0.46399999999999997,44,118,0.373,205,419,0.489,0.505,133,158,0.8420000000000001,49,158,207,116,53,6,61,99,675
Jason Hart,PG,23,SAS,10,0,92,10,19,0.526,0,2,0.0,10,17,0.588,0.526,6,6,1.0,4,9,13,12,7,1,8,16,26
Antonio Harvey,PF,31,SEA,5,3,47,4,12,0.33299999999999996,0,0,0.0,4,12,0.33299999999999996,0.33299999999999996,1,2,0.5,5,4,9,5,1,3,3,8,9
Donnell Harvey,PF,21,TOT,47,4,841,108,217,0.498,0,0,0.0,108,217,0.498,0.498,54,90,0.6,80,147,227,37,21,24,33,115,270
Trenton Hassell,SG,22,CHI,78,47,2237,267,628,0.425,60,165,0.364,207,463,0.447,0.473,87,114,0.763,65,190,255,172,55,44,101,184,681
Kirk Haston,PF,22,CHH,15,0,77,11,39,0.282,0,3,0.0,11,36,0.306,0.282,4,8,0.5,5,15,20,5,0,1,3,9,26
Brendan Haywood,C,22,WAS,62,2,1266,109,221,0.493,0,0,0.0,109,221,0.493,0.493,97,160,0.606,143,179,322,29,21,91,50,158,315
Alan Henderson,PF,29,ATL,26,1,422,59,116,0.509,1,1,1.0,58,115,0.504,0.513,24,45,0.5329999999999999,31,66,97,11,11,15,21,40,143
Cedric Henderson,SF,26,GSW,12,0,70,15,31,0.484,2,4,0.5,13,27,0.48100000000000004,0.516,4,7,0.5710000000000001,1,2,3,4,6,2,8,4,36
Grant Hill*,SF,29,ORL,14,14,512,83,195,0.426,0,2,0.0,83,193,0.43,0.426,69,80,0.863,29,96,125,64,8,4,37,40,235
Tyrone Hill,PF,33,CLE,26,26,810,71,182,0.39,0,1,0.0,71,181,0.392,0.39,67,103,0.65,79,195,274,23,17,13,48,102,209
Fred Hoiberg,SG,29,CHI,79,8,1408,121,291,0.41600000000000004,24,92,0.261,97,199,0.48700000000000004,0.457,79,94,0.84,18,192,210,136,61,5,32,87,345
Robert Horry,PF,31,LAL,81,23,2140,183,460,0.39799999999999996,76,203,0.374,107,257,0.41600000000000004,0.48,108,138,0.7829999999999999,130,349,479,232,77,89,88,208,550
Eddie House,PG,23,MIA,64,3,1230,209,524,0.39899999999999997,54,157,0.344,155,367,0.42200000000000004,0.45,42,49,0.857,17,93,110,123,43,5,80,98,514
Allan Houston,SG,30,NYK,77,77,2914,568,1301,0.43700000000000006,136,346,0.39299999999999996,432,955,0.452,0.489,295,339,0.87,37,215,252,190,54,10,170,182,1567
Juwan Howard,PF,28,TOT,81,72,2635,462,1005,0.46,0,2,0.0,462,1003,0.461,0.46,261,343,0.7609999999999999,223,389,612,169,46,47,152,265,1185
Troy Hudson,PG,25,ORL,81,4,1854,354,815,0.434,66,187,0.353,288,628,0.45899999999999996,0.475,176,201,0.8759999999999999,30,115,145,255,57,6,163,119,950
Larry Hughes,SG,23,GSW,73,56,2049,343,810,0.423,18,93,0.19399999999999998,325,717,0.45299999999999996,0.435,191,259,0.737,83,162,245,316,113,23,171,150,895
Lindsey Hunter,PG,31,LAL,82,47,1616,187,490,0.382,79,208,0.38,108,282,0.38299999999999995,0.462,20,40,0.5,18,103,121,129,66,19,55,120,473
Steven Hunter,C,20,ORL,53,21,516,67,147,0.456,0,0,0.0,67,147,0.456,0.456,55,94,0.585,40,57,97,5,5,43,16,81,189
Zydrunas Ilgauskas,C,26,CLE,62,23,1329,241,567,0.425,0,5,0.0,241,562,0.429,0.425,208,276,0.754,136,198,334,70,17,84,94,187,690
Allen Iverson*,SG,26,PHI,60,59,2622,665,1669,0.39799999999999996,78,268,0.29100000000000004,587,1401,0.419,0.42200000000000004,475,585,0.812,44,225,269,331,168,13,237,102,1883
Bobby Jackson,PG,28,SAC,81,3,1750,334,754,0.44299999999999995,79,219,0.361,255,535,0.47700000000000004,0.495,149,184,0.81,82,169,251,164,73,11,93,145,896
Jaren Jackson,SG,34,ORL,9,0,144,15,37,0.405,7,20,0.35,8,17,0.47100000000000003,0.5,2,4,0.5,1,16,17,8,5,0,8,13,39
Jermaine Jackson,SG,25,TOR,24,0,280,20,42,0.47600000000000003,1,2,0.5,19,40,0.475,0.488,16,24,0.667,3,24,27,57,9,1,14,24,57
Jim Jackson,SF,31,MIA,55,19,1825,238,538,0.442,38,81,0.469,200,457,0.43799999999999994,0.478,75,87,0.862,54,236,290,140,42,14,106,145,589
Marc Jackson,C,27,TOT,39,0,495,60,164,0.366,0,1,0.0,60,163,0.368,0.366,66,80,0.825,48,80,128,14,11,6,30,69,186
Mark Jackson,PG,36,NYK,82,82,2367,260,592,0.439,79,195,0.405,181,397,0.456,0.506,87,110,0.7909999999999999,56,253,309,605,74,1,150,162,686
Stephen Jackson,SF,23,SAS,23,1,227,34,91,0.374,9,36,0.25,25,55,0.455,0.423,12,17,0.706,3,23,26,11,15,3,23,29,89
Jerome James,C,26,SEA,56,40,949,134,273,0.491,0,0,0.0,134,273,0.491,0.491,30,60,0.5,89,143,232,24,25,86,74,174,298
Mike James,PG,26,MIA,15,0,119,15,43,0.349,8,21,0.381,7,22,0.318,0.442,4,7,0.5710000000000001,2,12,14,19,6,1,13,17,42
Tim James,SF,25,PHI,9,0,41,5,13,0.385,0,0,0.0,5,13,0.385,0.385,2,6,0.33299999999999996,5,2,7,1,0,1,3,5,12
Antawn Jamison,SF,25,GSW,82,82,3033,614,1375,0.447,68,210,0.324,546,1165,0.469,0.47100000000000003,323,440,0.7340000000000001,211,345,556,161,70,45,161,187,1619
Harold Jamison,PF,25,LAC,25,2,176,22,43,0.512,0,0,0.0,22,43,0.512,0.512,10,15,0.667,24,15,39,6,5,1,6,23,54
Richard Jefferson,SF,21,NJN,79,9,1917,270,591,0.457,13,56,0.23199999999999998,257,535,0.48,0.46799999999999997,189,265,0.713,85,208,293,140,64,48,107,211,742
Anthony Johnson,SG,27,NJN,34,0,366,37,90,0.41100000000000003,4,12,0.33299999999999996,33,78,0.423,0.433,16,25,0.64,10,19,29,48,31,1,20,30,94
Avery Johnson,PG,36,TOT,68,13,1352,207,432,0.479,0,5,0.0,207,427,0.485,0.479,121,163,0.742,14,55,69,286,40,9,76,86,535
DerMarr Johnson,SF,21,ATL,72,46,1727,214,540,0.396,89,247,0.36,125,293,0.42700000000000005,0.479,85,105,0.81,59,188,247,81,62,56,102,163,602
Ervin Johnson,C,34,MIL,81,9,1660,89,193,0.461,0,1,0.0,89,192,0.46399999999999997,0.461,30,66,0.455,142,324,466,27,37,82,52,219,208
Joe Johnson,SG,20,TOT,77,60,1916,251,584,0.43,38,130,0.292,213,454,0.469,0.462,41,53,0.774,75,182,257,179,59,20,71,114,581
Alvin Jones,C,23,PHI,23,2,126,8,20,0.4,0,0,0.0,8,20,0.4,0.4,10,20,0.5,13,23,36,3,3,9,11,35,26
Damon Jones,PG,25,DET,67,0,1083,114,284,0.401,69,186,0.371,45,98,0.45899999999999996,0.523,43,59,0.7290000000000001,13,90,103,140,23,1,61,83,340
Eddie Jones,SG,30,MIA,81,81,3156,517,1198,0.43200000000000005,149,382,0.39,368,816,0.451,0.494,297,355,0.8370000000000001,61,317,378,262,117,77,148,258,1480
Jumaine Jones,PF,22,CLE,81,36,2142,287,640,0.44799999999999995,52,168,0.31,235,472,0.498,0.489,45,68,0.662,125,365,490,116,75,46,79,184,671
Popeye Jones,PF,31,WAS,79,40,1920,222,508,0.43700000000000006,4,11,0.364,218,497,0.439,0.441,106,130,0.815,233,345,578,127,50,19,88,209,554
Michael Jordan*,SF,38,WAS,60,53,2093,551,1324,0.41600000000000004,10,53,0.18899999999999997,541,1271,0.426,0.42,263,333,0.79,50,289,339,310,85,26,162,119,1375
Shawn Kemp,PF,32,POR,75,5,1232,175,407,0.43,0,4,0.0,175,403,0.434,0.43,104,131,0.794,90,198,288,52,43,33,81,184,454
Steve Kerr,PG,36,POR,65,0,775,102,217,0.47,26,66,0.39399999999999996,76,151,0.503,0.53,39,40,0.975,6,54,60,63,13,1,24,49,269
Jason Kidd*,PG,28,NJN,82,82,3056,445,1138,0.391,117,364,0.321,328,774,0.424,0.442,201,247,0.8140000000000001,130,465,595,808,175,20,286,136,1208
Andrei Kirilenko,SF,20,UTA,82,40,2151,285,633,0.45,25,100,0.25,260,533,0.488,0.47,285,371,0.768,149,253,402,94,116,159,108,156,880
Kerry Kittles,SG,27,NJN,82,82,2601,438,940,0.466,98,242,0.405,340,698,0.48700000000000004,0.518,128,172,0.7440000000000001,68,207,275,216,130,31,109,108,1102
Brevin Knight,PG,26,MEM,53,11,1151,141,334,0.42200000000000004,2,8,0.25,139,326,0.426,0.425,87,115,0.757,11,98,109,302,79,7,111,135,371
Travis Knight,C,27,NYK,49,0,429,41,113,0.363,0,0,0.0,41,113,0.363,0.363,16,21,0.762,48,56,104,8,11,10,27,95,98
Toni Kukoč,SF,33,ATL,59,9,1494,211,504,0.419,53,171,0.31,158,333,0.474,0.47100000000000003,109,153,0.7120000000000001,43,175,218,210,48,17,113,91,584
Christian Laettner,PF,32,WAS,57,48,1441,168,362,0.46399999999999997,2,10,0.2,166,352,0.47200000000000003,0.467,66,76,0.868,74,227,301,151,60,25,85,129,404
Raef LaFrentz,C,25,TOT,78,76,2455,421,920,0.45799999999999996,104,268,0.38799999999999996,317,652,0.486,0.514,105,151,0.695,176,403,579,89,55,213,94,281,1051
Trajan Langdon,SG,25,CLE,44,0,477,70,176,0.39799999999999996,27,74,0.365,43,102,0.42200000000000004,0.474,42,46,0.9129999999999999,13,42,55,60,13,5,40,49,209
Dan Langhi,SF,24,HOU,34,8,434,49,125,0.392,1,4,0.25,48,121,0.397,0.396,8,11,0.727,22,45,67,14,8,5,9,25,107
Rusty LaRue,PG,28,UTA,33,0,542,73,185,0.395,17,50,0.34,56,135,0.415,0.441,30,35,0.857,11,38,49,71,17,7,43,58,193
Voshon Lenard,SG,28,DEN,71,19,1665,315,769,0.41,89,240,0.371,226,529,0.42700000000000005,0.467,94,120,0.7829999999999999,38,145,183,130,59,25,91,105,813
Quincy Lewis,SG,24,UTA,36,19,490,64,143,0.44799999999999995,3,18,0.16699999999999998,61,125,0.488,0.45799999999999996,13,20,0.65,10,33,43,36,23,9,32,89,144
Rashard Lewis,SF,22,SEA,71,70,2585,455,972,0.46799999999999997,123,316,0.389,332,656,0.506,0.531,162,200,0.81,139,359,498,123,104,40,97,174,1195
Randy Livingston,PG,26,SEA,13,0,176,15,54,0.278,1,8,0.125,14,46,0.304,0.287,10,11,0.909,9,16,25,26,9,2,2,11,41
Art Long,PF,29,SEA,63,27,989,120,244,0.49200000000000005,0,0,0.0,120,244,0.49200000000000005,0.49200000000000005,45,85,0.529,107,144,251,41,22,28,63,180,285
Grant Long,PF,35,MEM,66,56,1868,164,385,0.426,3,17,0.17600000000000002,161,368,0.43799999999999994,0.43,86,123,0.6990000000000001,31,200,231,136,63,12,103,123,417
Felipe López,SG,27,MIN,67,0,581,59,156,0.37799999999999995,14,33,0.424,45,123,0.366,0.423,37,55,0.6729999999999999,29,51,80,39,18,1,36,73,169
Tyronn Lue,PG,24,WAS,71,0,1458,222,520,0.42700000000000005,63,141,0.447,159,379,0.42,0.488,48,63,0.762,14,108,122,246,49,0,96,120,555
George Lynch,SF,31,CHH,45,18,893,73,198,0.369,1,6,0.16699999999999998,72,192,0.375,0.371,25,40,0.625,70,116,186,54,40,14,41,75,172
Todd MacCulloch,C,26,NJN,62,61,1502,247,465,0.531,0,0,0.0,247,465,0.531,0.531,110,164,0.6709999999999999,157,221,378,78,24,89,66,181,604
Sam Mack,SF,31,MIA,12,1,159,14,49,0.28600000000000003,7,28,0.25,7,21,0.33299999999999996,0.35700000000000004,5,7,0.7140000000000001,2,12,14,4,5,1,7,17,40
Mark Madsen,PF,26,LAL,59,5,650,66,146,0.452,0,2,0.0,66,144,0.45799999999999996,0.452,35,54,0.648,89,73,162,44,16,13,22,104,167
Corey Maggette,SG,22,LAC,63,52,1615,235,530,0.44299999999999995,46,139,0.331,189,391,0.483,0.48700000000000004,201,251,0.8009999999999999,54,177,231,112,41,19,116,155,717
Jamaal Magloire,C,23,CHH,82,8,1549,228,414,0.551,0,1,0.0,228,413,0.552,0.551,243,333,0.73,153,308,461,31,27,86,118,201,699
Dan Majerle,SG,36,PHO,65,1,1180,99,289,0.34299999999999997,79,235,0.336,20,54,0.37,0.479,23,39,0.59,28,148,176,90,48,15,35,104,300
Karl Malone*,PF,38,UTA,80,80,3040,635,1399,0.45399999999999996,9,25,0.36,626,1374,0.456,0.457,509,639,0.797,142,544,686,341,152,59,263,229,1788
Danny Manning,PF,35,DAL,41,10,552,71,149,0.47700000000000004,1,7,0.14300000000000002,70,142,0.493,0.48,22,33,0.667,25,83,108,30,21,21,25,80,165
Stephon Marbury,PG,24,PHO,82,80,3187,625,1413,0.442,71,248,0.28600000000000003,554,1165,0.47600000000000003,0.467,353,452,0.7809999999999999,75,191,266,666,77,13,284,186,1674
Shawn Marion,SF,23,PHO,81,81,3109,654,1395,0.469,48,122,0.39299999999999996,606,1273,0.47600000000000003,0.486,191,226,0.845,211,592,803,162,149,86,144,214,1547
Sean Marks,C,26,MIA,21,6,319,38,88,0.43200000000000005,0,0,0.0,38,88,0.43200000000000005,0.43200000000000005,20,34,0.588,19,56,75,8,5,10,19,40,96
Donny Marshall,SF,29,NJN,20,0,118,8,29,0.276,2,4,0.5,6,25,0.24,0.31,12,18,0.667,8,13,21,5,3,0,2,14,30
Donyell Marshall,SF,28,UTA,58,42,1750,343,661,0.519,13,42,0.31,330,619,0.5329999999999999,0.529,160,226,0.708,158,285,443,101,50,67,124,150,859
Darrick Martin,PG,30,DAL,3,0,22,0,10,0.0,0,2,0.0,0,8,0.0,0.0,1,2,0.5,0,1,1,3,2,0,1,4,1
Kenyon Martin,PF,24,NJN,73,73,2504,445,962,0.46299999999999997,15,67,0.22399999999999998,430,895,0.48,0.47,181,267,0.6779999999999999,113,275,388,192,90,121,172,261,1086
Jamal Mashburn,SF,29,CHH,40,40,1601,303,744,0.40700000000000003,41,112,0.366,262,632,0.415,0.435,211,241,0.8759999999999999,31,211,242,171,45,6,110,80,858
Anthony Mason,PF,35,MIL,82,82,3143,316,626,0.505,1,1,1.0,315,625,0.504,0.506,154,221,0.6970000000000001,124,522,646,346,57,22,130,187,787
Desmond Mason,SF,24,SEA,75,20,2420,357,769,0.46399999999999997,16,59,0.271,341,710,0.48,0.475,201,237,0.848,92,259,351,104,67,27,104,170,931
Tony Massenburg,PF,34,MEM,73,31,1247,159,349,0.456,1,1,1.0,158,348,0.45399999999999996,0.457,84,117,0.718,100,224,324,26,30,31,65,174,403
Walter McCarty,PF,27,BOS,56,0,718,80,180,0.444,39,99,0.39399999999999996,41,81,0.506,0.5529999999999999,13,19,0.684,32,96,128,41,18,7,22,83,212
Amal McCaskill,C,28,SAS,27,0,153,20,49,0.408,0,0,0.0,20,49,0.408,0.408,12,26,0.462,16,20,36,4,6,10,14,23,52
George McCloud,SF,34,DEN,69,26,1830,206,576,0.358,60,222,0.27,146,354,0.41200000000000003,0.41,132,163,0.81,67,184,251,204,58,19,144,175,604
Jelani McCoy,C,24,LAL,21,0,104,12,21,0.5710000000000001,0,0,0.0,12,21,0.5710000000000001,0.5710000000000001,2,8,0.25,8,17,25,7,0,5,8,14,26
Antonio McDyess,PF,27,DEN,10,10,236,43,75,0.573,0,0,0.0,43,75,0.573,0.573,27,33,0.818,18,37,55,18,10,8,20,20,113
Tracy McGrady*,SG,22,ORL,76,76,2912,715,1586,0.451,103,283,0.364,612,1303,0.47,0.483,415,555,0.748,150,447,597,400,119,73,189,139,1948
Jeff McInnis,PG,27,LAC,81,80,3030,463,1121,0.413,75,234,0.321,388,887,0.43700000000000006,0.446,183,219,0.836,45,168,213,500,63,6,147,202,1184
Derrick McKey,SF,35,PHI,41,1,784,52,122,0.426,5,12,0.41700000000000004,47,110,0.42700000000000005,0.447,10,14,0.7140000000000001,48,79,127,45,41,4,22,90,119
Aaron McKie,SG,29,PHI,48,16,1471,220,490,0.449,51,128,0.39799999999999996,169,362,0.467,0.501,96,122,0.787,26,166,192,179,56,14,93,74,587
Stanislav Medvedenko,C,22,LAL,71,6,729,145,304,0.47700000000000004,0,4,0.0,145,300,0.483,0.47700000000000004,41,62,0.6609999999999999,85,73,158,43,29,11,42,119,331
Ron Mercer,SG,25,TOT,53,41,1716,311,784,0.397,18,62,0.29,293,722,0.406,0.408,95,119,0.7979999999999999,50,128,178,128,32,13,88,108,735
Chris Mihm,C,22,CLE,74,60,1659,221,526,0.42,3,7,0.429,218,519,0.42,0.423,124,179,0.693,133,259,392,24,18,89,97,260,569
Darius Miles,SF,20,LAC,82,6,2227,309,642,0.48100000000000004,3,19,0.158,306,623,0.491,0.484,158,255,0.62,109,344,453,184,71,103,160,184,779
Andre Miller,PG,25,CLE,81,81,3023,474,1045,0.45399999999999996,22,87,0.253,452,958,0.47200000000000003,0.46399999999999997,365,447,0.8170000000000001,108,271,379,882,126,34,245,228,1335
Brad Miller,C,25,TOT,76,75,2263,366,733,0.499,3,7,0.429,363,726,0.5,0.501,297,383,0.775,252,369,621,152,76,41,115,244,1032
Mike Miller,SF,21,ORL,63,53,2123,351,802,0.43799999999999994,116,303,0.38299999999999995,235,499,0.47100000000000003,0.51,138,181,0.762,49,224,273,198,47,23,108,145,956
Reggie Miller*,SG,36,IND,79,79,2889,414,913,0.45299999999999996,180,443,0.406,234,470,0.498,0.552,296,325,0.9109999999999999,23,196,219,253,88,10,120,143,1304
Chris Mills,SF,32,GSW,66,0,1237,178,427,0.41700000000000004,48,127,0.37799999999999995,130,300,0.433,0.473,85,107,0.794,51,139,190,72,31,13,56,120,489
Sam Mitchell,SF,38,MIN,74,10,726,98,227,0.43200000000000005,10,35,0.28600000000000003,88,192,0.45799999999999996,0.45399999999999996,38,49,0.7759999999999999,18,64,82,45,12,4,26,79,244
Cuttino Mobley,SG,26,HOU,74,74,3116,595,1358,0.43799999999999994,149,377,0.395,446,981,0.455,0.493,267,314,0.85,63,237,300,187,109,37,180,189,1606
Nazr Mohammed,C,24,ATL,82,73,2168,329,713,0.461,0,1,0.0,329,712,0.462,0.461,137,222,0.617,242,409,651,33,63,61,118,252,795
Jérôme Moïso,C,23,CHH,15,0,76,8,20,0.4,0,0,0.0,8,20,0.4,0.4,0,0,0.0,4,21,25,4,3,2,8,12,16
Eric Montross,C,30,TOR,49,24,655,53,132,0.402,0,1,0.0,53,131,0.405,0.402,10,31,0.32299999999999995,36,104,140,16,12,23,25,92,116
Mikki Moore,C,26,DET,30,0,217,29,61,0.475,1,2,0.5,28,59,0.475,0.484,20,26,0.769,22,31,53,11,7,9,14,35,79
Terence Morris,SF,23,HOU,68,12,1110,111,289,0.384,15,78,0.192,96,211,0.455,0.41,18,28,0.643,77,134,211,64,21,27,45,72,255
Hanno Möttölä,C,25,ATL,82,14,1371,169,384,0.44,1,13,0.077,168,371,0.45299999999999996,0.441,57,76,0.75,81,187,268,50,20,19,70,174,396
Alonzo Mourning*,C,31,MIA,75,74,2455,447,866,0.516,1,3,0.33299999999999996,446,863,0.517,0.517,283,431,0.657,182,450,632,87,27,186,182,258,1178
Troy Murphy,PF,21,GSW,82,4,1448,178,423,0.42100000000000004,3,9,0.33299999999999996,175,414,0.423,0.424,121,156,0.7759999999999999,99,223,322,70,36,21,84,217,480
Lamond Murray,SF,28,CLE,71,68,2312,430,986,0.436,101,238,0.424,329,748,0.44,0.48700000000000004,215,263,0.8170000000000001,81,291,372,157,70,43,141,148,1176
Tracy Murray,SF,30,TOR,40,3,473,85,207,0.41100000000000003,40,104,0.385,45,103,0.43700000000000006,0.507,17,21,0.81,18,35,53,19,11,8,25,38,227
Dikembe Mutombo*,C,35,PHI,80,80,2907,321,641,0.501,0,0,0.0,321,641,0.501,0.501,278,364,0.764,254,609,863,83,29,190,156,242,920
Mamadou N'Diaye,C,26,TOR,5,0,46,6,10,0.6,0,0,0.0,6,10,0.6,0.6,8,10,0.8,6,5,11,0,0,2,1,6,20
Lee Nailon,SF,26,CHH,79,41,1912,369,764,0.483,1,2,0.5,368,762,0.483,0.484,112,150,0.747,103,188,291,94,59,17,96,175,851
Eduardo Nájera,PF,25,DAL,62,11,1357,150,300,0.5,0,2,0.0,150,298,0.503,0.5,100,148,0.6759999999999999,149,193,342,38,56,30,40,156,400
Steve Nash*,PG,27,DAL,82,82,2837,525,1088,0.483,156,343,0.455,369,745,0.495,0.5539999999999999,260,293,0.887,50,204,254,634,53,4,229,164,1466
Tyrone Nesby,SF,26,WAS,70,9,1498,183,421,0.435,13,47,0.27699999999999997,170,374,0.455,0.45,64,93,0.688,105,213,318,91,61,22,49,164,443
Rasho Nesterović,C,25,MIN,82,82,2218,324,657,0.493,0,1,0.0,324,656,0.494,0.493,39,71,0.5489999999999999,200,334,534,75,45,109,94,262,687
Ira Newble,SF,27,ATL,42,35,1273,131,263,0.498,1,7,0.14300000000000002,130,256,0.508,0.5,75,88,0.852,80,142,222,45,38,20,49,117,338
Johnny Newman,SF,38,DAL,47,17,724,67,148,0.45299999999999996,22,57,0.386,45,91,0.495,0.527,42,58,0.7240000000000001,9,40,49,14,29,4,21,88,198
Moochie Norris,PG,28,HOU,82,26,2249,251,631,0.39799999999999996,36,134,0.26899999999999996,215,497,0.433,0.426,127,169,0.7509999999999999,73,173,246,403,81,4,156,130,665
Dirk Nowitzki,C,23,DAL,76,76,2891,600,1258,0.47700000000000004,139,350,0.397,461,908,0.508,0.532,440,516,0.853,120,635,755,186,83,77,145,222,1779
Jermaine O'Neal,PF,23,IND,72,72,2707,543,1133,0.479,1,14,0.071,542,1119,0.484,0.48,284,413,0.688,188,569,757,118,45,166,174,269,1371
Shaquille O'Neal*,C,29,LAL,67,66,2422,712,1229,0.579,0,1,0.0,712,1228,0.58,0.579,398,717,0.555,235,480,715,200,41,137,171,199,1822
Charles Oakley,PF,38,CHI,57,36,1383,97,263,0.369,1,6,0.16699999999999998,96,257,0.374,0.371,21,28,0.75,72,271,343,114,49,11,87,175,216
Lamar Odom,SF,22,LAC,29,25,999,151,360,0.419,16,84,0.19,135,276,0.489,0.442,61,93,0.6559999999999999,31,145,176,171,23,36,97,91,379
Hakeem Olajuwon*,C,39,TOR,61,37,1378,194,418,0.46399999999999997,0,2,0.0,194,416,0.466,0.46399999999999997,47,84,0.56,98,268,366,66,74,90,98,147,435
Dean Oliver,PG,23,GSW,20,0,139,17,46,0.37,2,13,0.154,15,33,0.455,0.391,6,9,0.667,0,8,8,21,3,0,11,16,42
Kevin Ollie,PG,29,TOT,81,17,1723,137,353,0.38799999999999996,1,2,0.5,136,351,0.387,0.39,187,227,0.8240000000000001,25,159,184,291,62,2,106,97,462
Michael Olowokandi,C,26,LAC,80,79,2568,384,886,0.433,0,0,0.0,384,886,0.433,0.433,117,188,0.622,164,547,711,90,55,145,175,217,885
Greg Ostertag,C,28,UTA,74,14,1107,91,201,0.45299999999999996,0,0,0.0,91,201,0.45299999999999996,0.45299999999999996,63,130,0.485,125,188,313,50,15,109,51,152,245
Bo Outlaw,PF,30,TOT,83,36,1928,166,299,0.555,1,2,0.5,165,297,0.556,0.557,43,102,0.42200000000000004,147,217,364,127,70,92,96,205,376
Doug Overton,PG,32,LAC,18,0,130,14,44,0.318,7,27,0.259,7,17,0.41200000000000003,0.39799999999999996,4,7,0.5710000000000001,1,11,12,13,3,1,12,10,39
Olumide Oyedeji,C,20,SEA,36,1,221,22,41,0.537,0,0,0.0,22,41,0.537,0.537,11,18,0.611,27,52,79,4,4,2,14,36,55
Robert Pack,PG,32,MIN,16,0,252,25,68,0.368,1,4,0.25,24,64,0.375,0.375,11,15,0.733,7,16,23,49,13,0,20,32,62
Scott Padgett,PF,25,UTA,75,1,1295,188,395,0.47600000000000003,49,113,0.434,139,282,0.493,0.5379999999999999,75,102,0.735,111,174,285,82,43,13,69,140,500
Milt Palacio,PG-SG,23,TOT,69,1,790,82,214,0.38299999999999995,13,41,0.317,69,173,0.39899999999999997,0.414,54,74,0.73,11,62,73,83,30,4,40,61,231
Tony Parker,PG,19,SAS,77,72,2267,268,639,0.419,61,189,0.32299999999999995,207,450,0.46,0.467,108,160,0.675,33,164,197,334,89,7,151,166,705
Cherokee Parks,C,29,SAS,42,1,234,30,83,0.361,0,0,0.0,30,83,0.361,0.361,3,8,0.375,24,34,58,10,7,8,14,34,63
Ruben Patterson,SF,26,POR,75,13,1765,319,619,0.515,9,36,0.25,310,583,0.532,0.523,192,274,0.701,155,143,298,107,79,37,114,140,839
Gary Payton*,PG,33,SEA,82,82,3301,737,1578,0.467,74,236,0.314,663,1342,0.494,0.49,267,335,0.797,80,316,396,737,131,26,209,179,1815
Anthony Peeler,SG,32,MIN,82,0,2060,288,684,0.42100000000000004,111,283,0.392,177,401,0.441,0.502,50,58,0.862,37,169,206,177,61,11,76,137,737
Mike Penberthy,PG,27,LAL,3,0,12,1,2,0.5,0,0,0.0,1,2,0.5,0.5,3,4,0.75,0,2,2,2,2,0,0,0,5
Elliot Perry,PG,32,MEM,2,0,48,5,10,0.5,0,0,0.0,5,10,0.5,0.5,1,2,0.5,0,4,4,7,3,0,7,6,11
Wesley Person,SG,30,CLE,78,78,2793,467,944,0.495,143,322,0.444,324,622,0.521,0.57,99,124,0.7979999999999999,50,244,294,173,77,37,74,93,1176
Morris Peterson,SF,24,TOR,63,56,1988,336,768,0.43799999999999994,84,231,0.364,252,537,0.469,0.49200000000000005,127,169,0.7509999999999999,91,132,223,153,73,11,86,174,883
Eric Piatkowski,SG,31,LAC,71,64,1718,207,471,0.439,111,238,0.466,96,233,0.41200000000000003,0.557,101,113,0.894,43,141,184,112,41,12,64,110,626
Paul Pierce,SG,24,BOS,82,82,3302,707,1598,0.442,210,520,0.40399999999999997,497,1078,0.461,0.508,520,643,0.809,81,485,566,261,154,86,241,237,2144
Scottie Pippen*,SF,36,POR,62,60,1996,246,599,0.41100000000000003,54,177,0.305,192,422,0.455,0.456,113,146,0.774,77,244,321,363,101,35,171,162,659
Scot Pollard,C,26,SAC,80,29,1881,197,358,0.55,0,0,0.0,197,358,0.55,0.55,115,166,0.693,188,377,565,53,70,76,68,202,509
Mark Pope,PF,29,MIL,45,12,426,36,91,0.396,4,25,0.16,32,66,0.485,0.418,11,21,0.524,20,53,73,17,11,11,15,47,87
Terry Porter,PG,38,SAS,72,0,1294,136,321,0.424,59,142,0.415,77,179,0.43,0.516,68,83,0.8190000000000001,12,152,164,205,45,16,85,89,399
James Posey,SF,25,DEN,73,63,2238,277,736,0.376,67,237,0.28300000000000003,210,499,0.42100000000000004,0.42200000000000004,161,203,0.7929999999999999,109,320,429,180,114,39,127,224,782
Lavor Postell,SG,23,NYK,23,0,179,28,84,0.33299999999999996,6,26,0.231,22,58,0.379,0.369,31,41,0.7559999999999999,2,14,16,5,6,0,11,7,93
Vitaly Potapenko,C,26,BOS,79,9,1343,137,301,0.455,0,0,0.0,137,301,0.455,0.455,89,120,0.742,167,180,347,30,37,18,63,174,363
Brent Price,PG,33,SAC,20,0,89,9,27,0.33299999999999996,4,15,0.267,5,12,0.41700000000000004,0.40700000000000003,9,13,0.6920000000000001,4,4,8,9,3,1,10,13,31
Joel Przybilla,C,22,MIL,71,62,1128,76,142,0.535,0,1,0.0,76,141,0.539,0.535,38,90,0.42200000000000004,78,205,283,21,20,118,43,199,190
Vladimir Radmanović,PF,21,SEA,61,16,1230,146,354,0.41200000000000003,66,157,0.42,80,197,0.406,0.506,49,72,0.6809999999999999,45,185,230,81,56,24,72,119,407
Zach Randolph,PF,20,POR,41,0,238,48,107,0.449,0,0,0.0,48,107,0.449,0.449,18,27,0.667,31,38,69,13,7,4,15,29,114
Theo Ratliff,C,28,ATL,3,2,82,10,20,0.5,0,0,0.0,10,20,0.5,0.5,6,11,0.545,5,11,16,1,1,8,7,8,26
Željko Rebrača,C,29,DET,74,4,1179,189,374,0.505,0,0,0.0,189,374,0.505,0.505,135,175,0.7709999999999999,84,206,290,38,28,73,84,192,513
Eldridge Recasner,PG-SG,34,TOT,6,0,33,2,6,0.33299999999999996,0,1,0.0,2,5,0.4,0.33299999999999996,1,1,1.0,0,0,0,5,1,0,1,4,5
Michael Redd,SG,22,MIL,67,8,1417,294,609,0.483,88,198,0.444,206,411,0.501,0.555,91,115,0.7909999999999999,77,147,224,91,42,7,57,96,767
Don Reid,PF,28,ORL,68,5,714,90,190,0.474,0,0,0.0,90,190,0.474,0.474,44,68,0.647,65,111,176,27,20,44,54,180,224
Glen Rice,SF,34,HOU,20,20,606,65,167,0.389,18,64,0.281,47,103,0.456,0.44299999999999995,24,30,0.8,5,42,47,31,12,3,24,34,172
Jason Richardson,SG,21,GSW,80,75,2629,464,1090,0.426,82,246,0.33299999999999996,382,844,0.45299999999999996,0.46299999999999997,141,210,0.6709999999999999,124,216,340,236,106,31,160,195,1151
Norm Richardson,SG,22,TOT,11,0,67,10,26,0.385,4,8,0.5,6,18,0.33299999999999996,0.462,6,9,0.667,3,5,8,2,0,0,3,5,30
Quentin Richardson,SG,21,LAC,81,0,2152,400,926,0.43200000000000005,133,349,0.381,267,577,0.46299999999999997,0.504,143,187,0.765,113,221,334,128,78,21,102,142,1076
Mitch Richmond*,SG,36,LAL,64,2,709,100,247,0.405,18,62,0.29,82,185,0.44299999999999995,0.441,42,44,0.955,14,80,94,57,18,6,40,61,260
Isaiah Rider,SG,30,DEN,10,1,173,37,81,0.457,6,15,0.4,31,66,0.47,0.494,13,17,0.765,10,23,33,12,3,2,14,11,93
Clifford Robinson,PF,35,DET,80,80,2855,454,1069,0.425,115,304,0.37799999999999995,339,765,0.44299999999999995,0.478,143,206,0.6940000000000001,79,307,386,202,89,95,151,243,1166
David Robinson*,C,36,SAS,78,78,2303,341,672,0.507,0,0,0.0,341,672,0.507,0.507,269,395,0.6809999999999999,191,456,647,94,86,140,104,193,951
Eddie Robinson,SF,25,CHI,29,12,653,112,247,0.45299999999999996,2,5,0.4,110,242,0.455,0.457,36,48,0.75,24,54,78,37,23,11,36,35,262
Glenn Robinson,SF,29,MIL,66,63,2346,536,1147,0.467,58,178,0.326,478,969,0.493,0.493,236,282,0.8370000000000001,70,336,406,168,97,41,174,173,1366
Larry Robinson,SG,34,NYK,2,0,10,1,4,0.25,1,2,0.5,0,2,0.0,0.375,0,0,0.0,0,2,2,0,0,0,0,1,3
Carlos Rogers,C,30,IND,22,1,168,24,43,0.5579999999999999,1,6,0.16699999999999998,23,37,0.622,0.57,10,19,0.526,14,24,38,3,5,6,5,17,59
Rodney Rogers,SF,30,TOT,77,8,1880,356,756,0.47100000000000003,88,235,0.374,268,521,0.514,0.529,117,149,0.785,129,219,348,112,66,29,108,226,917
Sean Rooks,C,32,LAC,61,2,728,81,194,0.418,0,0,0.0,81,194,0.418,0.418,21,29,0.7240000000000001,32,92,124,25,12,21,20,114,183
Jalen Rose,SF,29,TOT,83,83,3153,663,1458,0.455,89,246,0.36200000000000004,574,1212,0.474,0.485,281,335,0.8390000000000001,43,330,373,355,78,45,201,251,1696
Malik Rose,PF,27,SAS,82,1,1725,293,633,0.46299999999999997,1,12,0.083,292,621,0.47,0.46399999999999997,185,257,0.72,172,320,492,61,70,42,140,208,772
Michael Ruffin,PF,25,PHI,15,0,169,7,26,0.26899999999999996,0,0,0.0,7,26,0.26899999999999996,0.26899999999999996,2,8,0.25,23,28,51,5,5,8,11,23,16
Bryon Russell,SG,31,UTA,66,40,1998,222,584,0.38,77,226,0.341,145,358,0.405,0.446,115,140,0.821,79,216,295,136,64,19,110,205,636
Daniel Santiago,C,25,PHO,3,0,24,4,8,0.5,0,0,0.0,4,8,0.5,0.5,0,0,0.0,0,7,7,2,0,1,2,4,8
Jeryl Sasser,SG,22,ORL,7,0,36,3,14,0.214,0,0,0.0,3,14,0.214,0.214,4,5,0.8,3,4,7,2,3,0,2,3,10
Kenny Satterfield,PG,20,DEN,36,4,560,73,199,0.36700000000000005,7,27,0.259,66,172,0.384,0.384,36,46,0.7829999999999999,17,35,52,108,31,1,53,43,189
Brian Scalabrine,PF,23,NJN,28,0,290,23,67,0.34299999999999997,3,10,0.3,20,57,0.35100000000000003,0.366,11,15,0.733,12,39,51,21,9,2,24,39,60
Shawnelle Scott,C,29,DEN,21,10,252,37,75,0.493,0,0,0.0,37,75,0.493,0.493,8,20,0.4,53,50,103,8,3,6,15,49,82
Ansu Sesay,SF,25,SEA,9,0,142,22,44,0.5,0,0,0.0,22,44,0.5,0.5,14,20,0.7,7,13,20,8,3,2,2,18,58
Brian Shaw,PG,35,LAL,58,0,631,61,173,0.353,29,88,0.33,32,85,0.376,0.436,18,26,0.6920000000000001,19,93,112,89,25,3,32,43,169
Bobby Simmons,SF,21,WAS,30,3,343,43,95,0.45299999999999996,4,14,0.28600000000000003,39,81,0.48100000000000004,0.474,22,30,0.733,25,27,52,17,13,5,14,31,112
Dickey Simpkins,PF,29,ATL,1,0,3,0,0,0.0,0,0,0.0,0,0,0.0,0.0,0,0,0.0,0,0,0,1,0,0,0,0,0
Brian Skinner,PF,25,CLE,65,8,1107,88,162,0.5429999999999999,0,0,0.0,88,162,0.5429999999999999,0.5429999999999999,48,79,0.608,93,188,281,17,24,61,42,130,224
Reggie Slater,PF,31,TOT,8,0,47,7,15,0.467,0,0,0.0,7,15,0.467,0.467,7,10,0.7,5,4,9,1,1,1,1,3,21
Charles Smith,SG,26,SAS,60,22,1141,182,428,0.425,35,131,0.267,147,297,0.495,0.466,42,65,0.6459999999999999,34,99,133,80,52,44,59,114,441
Jabari Smith,C,24,TOT,23,0,181,26,63,0.413,0,3,0.0,26,60,0.433,0.413,21,32,0.6559999999999999,8,20,28,11,6,6,5,31,73
Joe Smith,C,26,MIN,72,63,1922,297,581,0.511,2,3,0.667,295,578,0.51,0.513,171,206,0.83,152,301,453,82,39,59,86,250,767
Leon Smith,C,21,ATL,14,0,100,10,26,0.385,0,0,0.0,10,26,0.385,0.385,11,17,0.647,10,21,31,3,5,1,3,12,31
Steve Smith,SG,32,SAS,77,76,2211,310,682,0.455,116,246,0.47200000000000003,194,436,0.445,0.54,159,181,0.878,45,148,193,151,54,15,108,158,895
Eric Snow,PG,28,PHI,61,61,2225,276,624,0.442,3,27,0.111,273,597,0.457,0.445,183,227,0.8059999999999999,33,182,215,400,95,9,138,167,738
Will Solomon,SG,23,MEM,62,4,872,113,331,0.341,46,162,0.284,67,169,0.396,0.41100000000000003,49,73,0.6709999999999999,12,56,68,92,35,7,62,76,321
Felton Spencer,C,34,NYK,32,8,248,6,26,0.231,0,0,0.0,6,26,0.231,0.231,17,33,0.515,16,34,50,3,7,8,12,73,29
Latrell Sprewell,SF,31,NYK,81,81,3326,573,1419,0.40399999999999997,145,403,0.36,428,1016,0.42100000000000004,0.455,284,346,0.821,59,239,298,313,94,14,223,161,1575
Jerry Stackhouse,SF,27,DET,76,76,2685,524,1319,0.397,86,300,0.287,438,1019,0.43,0.43,495,577,0.858,77,238,315,403,77,37,266,163,1629
John Starks,SG,36,UTA,66,1,929,114,310,0.368,29,95,0.305,85,215,0.395,0.415,33,41,0.805,15,53,68,70,33,0,52,126,290
Vladimir Stepania,C,25,MIA,67,4,884,117,249,0.47,1,2,0.5,116,247,0.47,0.47200000000000003,50,104,0.48100000000000004,100,170,270,16,24,44,52,103,285
DeShawn Stevenson,SG,20,UTA,67,23,1134,143,371,0.385,2,25,0.08,141,346,0.408,0.38799999999999996,37,53,0.698,44,87,131,116,29,24,68,82,325
Michael Stewart,C,26,TOR,11,0,93,8,23,0.348,0,0,0.0,8,23,0.348,0.348,6,11,0.545,12,13,25,3,4,3,4,22,22
Bryant Stith,SG,31,CLE,50,5,665,70,188,0.37200000000000005,24,68,0.353,46,120,0.38299999999999995,0.436,44,52,0.846,20,65,85,42,29,6,30,42,208
John Stockton*,PG,39,UTA,82,82,2566,401,775,0.517,25,78,0.321,376,697,0.539,0.534,275,321,0.857,59,204,263,674,152,24,208,209,1102
Peja Stojaković,SF,24,SAC,71,71,2649,547,1130,0.484,129,310,0.41600000000000004,418,820,0.51,0.541,283,323,0.8759999999999999,72,301,373,175,81,14,140,120,1506
Damon Stoudamire,PG,28,POR,75,71,2796,369,918,0.402,104,295,0.353,265,623,0.425,0.45899999999999996,174,196,0.888,78,214,292,490,67,7,149,153,1016
Erick Strickland,PG,28,BOS,79,4,1643,190,488,0.389,95,247,0.385,95,241,0.39399999999999996,0.48700000000000004,131,155,0.845,22,191,213,184,56,1,94,145,606
Mark Strickland,SF,31,ATL,46,10,654,91,204,0.446,1,4,0.25,90,200,0.45,0.449,25,44,0.568,41,90,131,20,19,17,28,48,208
Rod Strickland,PG,35,MIA,76,64,2294,316,714,0.44299999999999995,8,26,0.308,308,688,0.44799999999999995,0.44799999999999995,154,201,0.7659999999999999,49,183,232,463,82,11,159,114,794
Bruno Šundov,C,21,IND,22,0,88,16,40,0.4,0,1,0.0,16,39,0.41,0.4,0,2,0.0,7,14,21,3,3,3,4,16,32
Bob Sura,PG,28,GSW,78,5,1780,250,590,0.424,42,133,0.316,208,457,0.455,0.45899999999999996,236,328,0.72,89,167,256,275,88,17,133,160,778
Stromile Swift,PF,22,MEM,68,14,1805,293,611,0.48,0,3,0.0,293,608,0.48200000000000004,0.48,217,305,0.711,161,269,430,50,53,113,122,178,803
Wally Szczerbiak,SF,24,MIN,82,82,3117,609,1200,0.508,87,191,0.455,522,1009,0.517,0.544,226,272,0.831,120,271,391,257,66,21,181,188,1531
Jason Terry,SG,24,ATL,78,78,2967,524,1219,0.43,172,444,0.387,352,775,0.45399999999999996,0.5,284,340,0.835,40,230,270,444,144,13,181,156,1504
Etan Thomas,C,23,WAS,47,0,618,81,151,0.536,0,0,0.0,81,151,0.536,0.536,41,74,0.5539999999999999,55,126,181,6,17,35,26,76,203
Kenny Thomas,PF,24,HOU,72,71,2484,396,829,0.478,0,16,0.0,396,813,0.48700000000000004,0.478,223,336,0.664,158,358,516,137,85,66,143,195,1015
Kurt Thomas,C,29,NYK,82,82,2771,463,938,0.494,1,6,0.16699999999999998,462,932,0.496,0.494,216,265,0.815,214,533,747,87,71,79,153,341,1143
Tim Thomas,SF,24,MIL,74,22,1987,316,753,0.42,95,291,0.326,221,462,0.478,0.483,142,179,0.7929999999999999,64,236,300,105,65,32,127,200,869
Jamaal Tinsley,PG,23,IND,80,78,2442,289,760,0.38,42,175,0.24,247,585,0.42200000000000004,0.408,131,186,0.7040000000000001,78,220,298,647,138,40,270,248,751
Óscar Torres,SG,25,HOU,65,13,1075,135,341,0.396,37,126,0.294,98,215,0.456,0.45,82,105,0.7809999999999999,47,75,122,40,25,9,49,64,389
Robert Traylor,PF,24,CHH,61,1,678,87,204,0.426,1,1,1.0,86,203,0.424,0.429,53,84,0.631,67,120,187,37,24,37,45,127,228
Gary Trent,PF,27,MIN,64,10,1140,193,381,0.507,0,2,0.0,193,379,0.509,0.507,92,144,0.639,104,166,270,60,21,27,58,160,478
Jeff Trepagnier,SG,22,CLE,12,0,77,7,23,0.304,0,1,0.0,7,22,0.318,0.304,4,7,0.5710000000000001,3,9,12,12,8,4,11,8,18
Jake Tsakalidis,C,22,PHO,67,47,1582,190,400,0.475,0,1,0.0,190,399,0.47600000000000003,0.475,111,159,0.698,130,244,374,23,23,69,78,193,491
Hedo Türkoğlu,SF,22,SAC,80,10,1970,290,687,0.42200000000000004,63,171,0.368,227,516,0.44,0.46799999999999997,167,230,0.726,63,300,363,163,57,31,81,184,810
Nick Van Exel,PG-SG,30,TOT,72,46,2496,501,1226,0.409,119,350,0.34,382,876,0.436,0.457,201,251,0.8009999999999999,28,226,254,478,44,11,156,104,1322
Keith Van Horn,SF,26,NJN,81,81,2465,471,1089,0.433,101,293,0.345,370,796,0.465,0.479,156,195,0.8,137,472,609,164,63,42,146,221,1199
Ratko Varda,C,22,DET,1,0,6,2,3,0.667,0,0,0.0,2,3,0.667,0.667,1,1,1.0,0,1,1,0,0,0,1,3,5
Jacque Vaughn,PG,26,ATL,82,16,1856,206,438,0.47,24,54,0.444,182,384,0.474,0.498,104,126,0.825,18,150,168,349,65,2,112,183,540
Jake Voskuhl,C,24,PHO,59,34,900,107,193,0.5539999999999999,0,0,0.0,107,193,0.5539999999999999,0.5539999999999999,82,109,0.752,103,147,250,18,11,23,48,139,296
Antoine Walker,PF,25,BOS,81,81,3406,666,1689,0.39399999999999996,222,645,0.344,444,1044,0.425,0.46,240,324,0.741,150,564,714,407,122,38,251,237,1794
Samaki Walker,PF,25,LAL,69,63,1655,187,365,0.512,0,0,0.0,187,365,0.512,0.512,86,129,0.667,129,352,481,64,28,88,53,170,460
Ben Wallace,C,27,DET,80,80,2921,255,480,0.531,0,3,0.0,255,477,0.535,0.531,99,234,0.423,318,721,1039,115,138,278,70,178,609
Gerald Wallace,SF,19,SAC,54,1,430,75,175,0.429,0,7,0.0,75,168,0.446,0.429,23,46,0.5,49,40,89,27,19,6,22,46,173
John Wallace,SF,27,PHO,46,0,490,93,214,0.435,5,13,0.385,88,201,0.43799999999999994,0.446,40,46,0.87,27,58,85,29,11,9,29,60,231
Rasheed Wallace,PF,27,POR,79,79,2963,603,1287,0.469,114,317,0.36,489,970,0.504,0.513,201,274,0.7340000000000001,136,509,645,152,101,101,131,212,1521
Charlie Ward,PG,31,NYK,63,0,1058,113,303,0.373,53,164,0.32299999999999995,60,139,0.43200000000000005,0.46,47,58,0.81,15,112,127,203,68,14,75,100,326
Earl Watson,PG,22,SEA,64,0,964,96,212,0.45299999999999996,16,44,0.364,80,168,0.47600000000000003,0.491,23,36,0.639,31,52,83,125,60,5,51,93,231
Clarence Weatherspoon,PF,31,NYK,56,41,1728,189,452,0.418,0,0,0.0,189,452,0.418,0.418,116,146,0.795,149,311,460,60,37,48,47,132,494
Chris Webber,PF,28,SAC,54,54,2071,532,1075,0.495,5,19,0.263,527,1056,0.499,0.49700000000000005,253,338,0.7490000000000001,150,396,546,258,90,76,158,181,1322
Bonzi Wells,SG,25,POR,74,69,2348,487,1039,0.469,66,172,0.384,421,867,0.486,0.5,215,290,0.741,121,323,444,204,113,25,191,208,1255
David Wesley,SG,31,CHH,67,63,2487,364,910,0.4,85,256,0.332,279,654,0.42700000000000005,0.447,138,188,0.7340000000000001,44,99,143,236,74,15,119,147,951
Jahidi White,C,25,WAS,71,69,1346,150,279,0.5379999999999999,0,0,0.0,150,279,0.5379999999999999,0.5379999999999999,83,154,0.539,159,285,444,17,25,75,65,163,383
Rodney White,SF,21,DET,16,0,129,21,60,0.35,2,9,0.222,19,51,0.373,0.36700000000000005,12,14,0.857,2,16,18,12,9,2,14,6,56
Chris Whitney,PG,30,WAS,82,81,2171,274,656,0.418,131,323,0.406,143,333,0.429,0.518,154,175,0.88,11,141,152,314,72,6,85,182,833
Aaron Williams,PF,30,NJN,82,13,1546,231,439,0.526,0,2,0.0,231,437,0.529,0.526,130,186,0.6990000000000001,115,224,339,77,29,76,79,212,592
Alvin Williams,PG,27,TOR,82,82,2927,403,971,0.415,62,193,0.321,341,778,0.43799999999999994,0.447,103,140,0.736,58,223,281,468,135,26,150,191,971
Eric Williams,SF,29,BOS,74,30,1747,144,385,0.374,24,86,0.27899999999999997,120,299,0.401,0.405,160,219,0.731,58,163,221,109,77,8,95,179,472
Jason Williams,PG,26,MEM,65,65,2236,376,985,0.382,127,430,0.295,249,555,0.449,0.446,80,101,0.792,22,173,195,519,111,7,214,102,959
Jerome Williams,PF,28,TOR,68,32,1641,190,388,0.49,0,0,0.0,190,388,0.49,0.49,138,204,0.6759999999999999,165,221,386,75,78,25,68,153,518
Monty Williams,SF,30,ORL,68,19,1284,198,362,0.547,0,4,0.0,198,358,0.5529999999999999,0.547,88,134,0.657,80,155,235,96,49,17,86,134,484
Scott Williams,PF,33,DEN,41,16,737,86,217,0.396,0,2,0.0,86,215,0.4,0.396,30,41,0.732,82,127,209,13,17,33,35,98,202
Shammond Williams,SG,26,SEA,50,2,603,81,193,0.42,28,75,0.373,53,118,0.449,0.49200000000000005,31,39,0.795,16,47,63,83,21,2,35,35,221
Walt Williams,SF,31,HOU,48,25,1117,166,396,0.419,78,183,0.426,88,213,0.413,0.518,40,51,0.784,37,125,162,69,18,10,53,106,450
Corliss Williamson,SF,28,DET,78,7,1701,411,806,0.51,1,5,0.2,410,801,0.512,0.511,240,298,0.805,117,202,319,94,49,26,137,226,1063
Kevin Willis,PF,39,HOU,52,5,865,125,284,0.44,0,1,0.0,125,283,0.442,0.44,65,87,0.747,105,194,299,14,25,23,41,98,315
Loren Woods,C,23,MIN,60,0,516,33,96,0.344,0,2,0.0,33,94,0.35100000000000003,0.344,44,60,0.733,46,76,122,22,17,34,36,60,110
Metta World Peace,SF,22,TOT,55,50,1642,269,636,0.423,53,170,0.312,216,466,0.46399999999999997,0.465,136,204,0.667,73,198,271,127,141,39,118,217,727
Lorenzen Wright,C,26,MEM,43,33,1251,223,486,0.45899999999999996,0,2,0.0,223,484,0.461,0.45899999999999996,70,123,0.569,130,275,405,44,30,23,72,126,516
Wang Zhizhi,C,24,DAL,55,0,600,109,248,0.44,48,116,0.414,61,132,0.462,0.536,42,57,0.737,19,92,111,22,11,18,25,84,308
