Player,Pos,Age,Tm,G,GS,MP,FG,FGA,FG%,3P,3PA,3P%,2P,2PA,2P%,eFG%,FT,FTA,FT%,ORB,DRB,TRB,AST,STL,BLK,TOV,PF,PTS
Mahmoud Abdul-Rauf,PG,31,VAN,41,0,486,120,246,0.488,4,14,0.28600000000000003,116,232,0.5,0.496,22,29,0.759,5,20,25,76,9,1,26,50,266
Tariq Abdul-Wahad,SG,26,DEN,29,12,420,43,111,0.387,4,10,0.4,39,101,0.386,0.405,21,36,0.583,14,45,59,22,14,13,34,54,111
Shareef Abdur-Rahim,SF,24,VAN,81,81,3241,604,1280,0.47200000000000003,12,64,0.188,592,1216,0.48700000000000004,0.47700000000000004,443,531,0.8340000000000001,175,560,735,250,90,77,231,238,1663
Cory Alexander,PG,27,ORL,26,0,227,18,56,0.321,4,16,0.25,14,40,0.35,0.35700000000000004,12,18,0.667,0,25,25,36,16,0,25,29,52
Courtney Alexander,PG,23,TOT,65,24,1382,239,573,0.41700000000000004,17,46,0.37,222,527,0.42100000000000004,0.43200000000000005,123,150,0.82,42,101,143,62,45,5,75,139,618
Ray Allen*,SG,25,MIL,82,82,3129,628,1309,0.48,202,467,0.433,426,842,0.506,0.557,348,392,0.888,101,327,428,374,124,20,204,192,1806
Rafer Alston,PG,24,MIL,37,2,288,30,84,0.35700000000000004,8,30,0.267,22,54,0.40700000000000003,0.405,9,13,0.6920000000000001,4,27,31,68,13,0,20,27,77
John Amaechi,C,30,ORL,82,36,1710,237,592,0.4,0,7,0.0,237,585,0.405,0.4,176,279,0.631,77,191,268,74,28,29,124,175,650
Derek Anderson,SG,26,SAS,82,82,2859,413,993,0.41600000000000004,101,253,0.39899999999999997,312,740,0.42200000000000004,0.467,342,402,0.851,75,288,363,301,120,14,165,188,1269
Kenny Anderson,PG,30,BOS,33,28,849,88,227,0.38799999999999996,11,33,0.33299999999999996,77,194,0.397,0.41200000000000003,59,71,0.831,16,57,73,134,44,2,52,62,246
Nick Anderson,SG,33,SAC,21,0,169,14,57,0.24600000000000002,10,39,0.256,4,18,0.222,0.33299999999999996,0,0,0.0,3,22,25,13,10,4,7,13,38
Shandon Anderson,SG,27,HOU,82,82,2396,263,590,0.446,46,170,0.271,217,420,0.517,0.485,138,188,0.7340000000000001,72,261,333,189,82,40,131,202,710
Greg Anthony,PG,33,POR,58,0,856,97,253,0.38299999999999995,65,159,0.409,32,94,0.34,0.512,23,35,0.657,21,40,61,82,40,3,43,63,282
Darrell Armstrong,PG,32,ORL,75,75,2767,413,1002,0.41200000000000003,143,403,0.355,270,599,0.451,0.484,220,249,0.884,94,249,343,524,135,13,200,155,1189
Chucky Atkins,PG,26,DET,81,75,2363,380,952,0.39899999999999997,121,339,0.35700000000000004,259,613,0.423,0.46299999999999997,90,130,0.6920000000000001,28,145,173,330,67,5,149,184,971
Stacey Augmon,SG,32,POR,66,23,1182,127,266,0.47700000000000004,0,4,0.0,127,262,0.485,0.47700000000000004,57,87,0.655,60,99,159,98,48,21,48,105,311
Isaac Austin,C,31,VAN,52,16,845,96,270,0.35600000000000004,6,24,0.25,90,246,0.366,0.36700000000000005,28,40,0.7,50,172,222,58,20,23,54,94,226
William Avery,PG,21,MIN,55,0,463,55,144,0.382,16,59,0.271,39,85,0.45899999999999996,0.43799999999999994,28,36,0.778,5,24,29,75,13,4,45,48,154
Dalibor Bagarić,C,20,CHI,35,0,259,17,65,0.262,0,1,0.0,17,64,0.266,0.262,13,28,0.46399999999999997,22,34,56,10,9,16,21,44,47
Vin Baker,PF,29,SEA,76,27,2129,347,822,0.42200000000000004,1,16,0.063,346,806,0.429,0.423,232,321,0.723,179,251,430,90,38,73,158,264,927
Erick Barkley,PG,22,POR,8,0,38,8,22,0.364,3,8,0.375,5,14,0.35700000000000004,0.43200000000000005,0,0,0.0,0,3,3,6,2,0,5,2,19
Dana Barros,PG,33,DET,60,0,1079,183,412,0.444,44,105,0.419,139,307,0.45299999999999996,0.498,68,80,0.85,6,88,94,110,30,2,60,63,478
Brent Barry,SG,29,SEA,67,20,1778,198,401,0.494,109,229,0.47600000000000003,89,172,0.517,0.63,84,103,0.816,33,178,211,225,80,14,86,126,589
Jon Barry,SG,31,SAC,62,2,1010,103,255,0.40399999999999997,46,132,0.348,57,123,0.46299999999999997,0.494,64,73,0.877,16,78,94,130,28,6,53,66,316
Tony Battie,C,24,BOS,40,25,845,108,201,0.537,0,3,0.0,108,198,0.545,0.537,44,69,0.638,73,160,233,16,27,60,37,126,260
Raja Bell,SG,24,PHI,5,0,30,2,7,0.28600000000000003,1,3,0.33299999999999996,1,4,0.25,0.35700000000000004,0,0,0.0,0,1,1,0,1,0,2,1,5
Jonathan Bender,SF,20,IND,59,7,574,66,186,0.355,11,41,0.268,55,145,0.379,0.384,50,68,0.735,14,60,74,32,7,28,42,73,193
Corey Benjamin,PG,22,CHI,65,5,857,115,302,0.381,21,81,0.259,94,221,0.425,0.41600000000000004,56,83,0.675,38,62,100,69,28,16,63,128,307
David Benoit,SF,32,UTA,49,2,446,71,147,0.483,5,13,0.385,66,134,0.493,0.5,31,39,0.795,20,61,81,22,6,6,28,75,178
Travis Best,PG,28,IND,77,21,2457,347,788,0.44,37,97,0.381,310,691,0.449,0.46399999999999997,187,226,0.8270000000000001,38,184,222,473,110,11,127,246,918
Mike Bibby,PG,22,VAN,82,82,3190,525,1157,0.45399999999999996,108,285,0.379,417,872,0.478,0.5,143,188,0.7609999999999999,47,257,304,685,107,12,248,148,1301
Chauncey Billups,SG,24,MIN,77,33,1790,248,587,0.42200000000000004,73,194,0.376,175,393,0.445,0.485,144,171,0.8420000000000001,32,126,158,260,51,11,111,178,713
Mookie Blaylock,PG,33,GSW,69,59,2352,317,801,0.396,73,225,0.324,244,576,0.424,0.441,53,76,0.6970000000000001,71,201,272,462,163,20,128,134,760
Corie Blount,PF,32,TOT,68,6,1305,130,294,0.442,2,8,0.25,128,286,0.44799999999999995,0.446,51,83,0.614,181,219,400,59,42,22,73,165,313
Mark Blount,C,25,BOS,64,50,1098,101,200,0.505,0,0,0.0,101,200,0.505,0.505,46,66,0.6970000000000001,97,134,231,32,39,76,62,183,248
Muggsy Bogues,PG,36,TOR,3,0,34,0,2,0.0,0,1,0.0,0,1,0.0,0.0,0,0,0.0,0,3,3,5,2,0,4,3,0
Etdrick Bohannon,PF,27,CLE,6,0,19,2,4,0.5,0,0,0.0,2,4,0.5,0.5,4,4,1.0,3,4,7,0,0,2,1,4,8
Calvin Booth,C,24,TOT,55,29,933,120,252,0.47600000000000003,0,0,0.0,120,252,0.47600000000000003,0.47600000000000003,53,78,0.679,77,169,246,42,29,111,53,146,293
Cal Bowdler,SF,23,ATL,44,0,375,53,114,0.465,1,5,0.2,52,109,0.47700000000000004,0.469,33,40,0.825,30,47,77,4,10,21,11,45,140
Bruce Bowen,SF,29,MIA,82,72,2685,211,581,0.363,103,307,0.336,108,274,0.39399999999999996,0.452,98,161,0.609,45,200,245,132,83,53,74,269,623
Ryan Bowen,SF,25,DEN,57,0,696,80,144,0.556,4,11,0.364,76,133,0.5710000000000001,0.569,27,44,0.614,62,51,113,30,37,12,24,95,191
Ira Bowman,PG,27,ATL,3,0,19,0,2,0.0,0,0,0.0,0,2,0.0,0.0,0,0,0.0,1,1,2,7,0,0,1,0,0
Earl Boykins,PG,24,LAC,10,0,149,25,63,0.397,1,8,0.125,24,55,0.436,0.405,14,17,0.8240000000000001,4,7,11,32,5,0,9,9,65
Shawn Bradley,C,28,DAL,82,35,2001,219,447,0.49,1,6,0.16699999999999998,218,441,0.494,0.491,140,178,0.787,160,448,608,38,36,228,88,256,579
Elton Brand,PF,21,CHI,74,74,2906,578,1215,0.47600000000000003,0,2,0.0,578,1213,0.47700000000000004,0.47600000000000003,334,472,0.708,285,461,746,240,71,118,219,243,1490
Terrell Brandon,PG,30,MIN,78,78,2821,511,1134,0.451,33,91,0.363,478,1043,0.45799999999999996,0.465,195,224,0.871,60,238,298,583,161,21,155,138,1250
Chucky Brown,SF,32,TOT,26,2,339,40,95,0.42100000000000004,0,3,0.0,40,92,0.435,0.42100000000000004,22,34,0.647,8,46,54,11,9,7,8,37,102
Dee Brown,PG,32,ORL,7,0,155,16,44,0.364,12,32,0.375,4,12,0.33299999999999996,0.5,4,5,0.8,0,11,11,12,4,0,7,10,48
P.J. Brown,C,31,CHH,80,79,2811,249,561,0.444,0,4,0.0,249,557,0.447,0.444,178,209,0.852,257,485,742,127,78,92,108,260,676
Randy Brown,PG,32,BOS,54,35,1238,100,237,0.42200000000000004,0,3,0.0,100,234,0.42700000000000005,0.42200000000000004,23,40,0.575,23,76,99,154,62,10,56,132,223
Rick Brunson,PG,28,TOT,22,0,208,18,54,0.33299999999999996,2,14,0.14300000000000002,16,40,0.4,0.35200000000000004,8,15,0.5329999999999999,5,16,21,31,8,1,17,21,46
Kobe Bryant,SG,22,LAL,68,68,2783,701,1510,0.46399999999999997,61,200,0.305,640,1310,0.489,0.484,475,557,0.853,104,295,399,338,114,43,220,222,1938
Mark Bryant,PF,35,DAL,18,1,101,8,20,0.4,0,0,0.0,8,20,0.4,0.4,3,5,0.6,4,17,21,3,1,2,5,29,19
Greg Buckner,SG,24,DAL,37,9,820,84,192,0.43799999999999994,2,7,0.28600000000000003,82,185,0.44299999999999995,0.44299999999999995,59,81,0.728,60,97,157,49,33,9,27,118,229
Jud Buechler,SF,32,DET,57,3,737,76,164,0.46299999999999997,32,77,0.41600000000000004,44,87,0.506,0.561,9,12,0.75,20,74,94,39,21,10,25,83,193
Rodney Buford,SF,23,PHI,47,0,573,104,241,0.43200000000000005,16,38,0.42100000000000004,88,203,0.433,0.465,24,29,0.828,16,58,74,17,17,6,29,68,248
Matt Bullard,PF,33,HOU,61,5,1000,129,305,0.423,86,213,0.40399999999999997,43,92,0.467,0.564,10,14,0.7140000000000001,22,108,130,42,10,9,12,76,354
Scott Burrell,SF,30,CHH,4,0,41,7,15,0.467,2,6,0.33299999999999996,5,9,0.556,0.5329999999999999,1,4,0.25,1,2,3,1,3,0,0,8,17
Jason Caffey,PF,27,MIL,70,33,1460,179,367,0.488,0,0,0.0,179,367,0.488,0.488,142,211,0.6729999999999999,135,218,353,53,38,25,77,184,500
Marcus Camby,C,26,NYK,63,63,2127,304,580,0.524,1,8,0.125,303,572,0.53,0.525,150,225,0.667,196,527,723,52,66,136,63,205,759
Elden Campbell,PF,32,CHH,78,78,2337,367,834,0.44,0,6,0.0,367,828,0.44299999999999995,0.44,288,406,0.7090000000000001,157,451,608,104,60,140,144,280,1022
Brian Cardinal,PF,23,DET,15,0,126,10,31,0.32299999999999995,0,5,0.0,10,26,0.385,0.32299999999999995,11,18,0.611,8,15,23,3,7,2,9,27,31
Chris Carr,SG,26,BOS,35,0,309,53,112,0.473,17,37,0.45899999999999996,36,75,0.48,0.5489999999999999,46,60,0.767,11,33,44,11,4,3,19,45,169
Anthony Carter,PG,25,MIA,72,6,1630,195,480,0.406,6,40,0.15,189,440,0.43,0.413,65,103,0.631,46,134,180,268,73,10,119,154,461
Vince Carter,SF,24,TOR,75,75,2979,762,1656,0.46,162,397,0.408,600,1259,0.47700000000000004,0.509,384,502,0.765,176,240,416,291,114,82,167,205,2070
Sam Cassell,PG,31,MIL,76,75,2709,537,1132,0.474,30,98,0.306,507,1034,0.49,0.488,277,323,0.858,46,244,290,580,88,8,220,214,1381
Kelvin Cato,C,26,HOU,35,13,624,64,111,0.5770000000000001,0,0,0.0,64,111,0.5770000000000001,0.5770000000000001,37,57,0.649,47,94,141,11,13,31,25,89,165
Duane Causwell,C,32,MIA,31,14,384,32,85,0.376,0,0,0.0,32,85,0.376,0.376,12,25,0.48,23,60,83,5,8,18,23,67,76
Cedric Ceballos,SF,31,TOT,40,0,559,101,229,0.441,22,73,0.301,79,156,0.506,0.489,37,43,0.86,34,72,106,20,16,7,32,61,261
Calbert Cheaney,SG,29,DEN,9,5,153,10,30,0.33299999999999996,0,0,0.0,10,30,0.33299999999999996,0.33299999999999996,1,2,0.5,5,15,20,9,4,2,5,14,21
Chris Childs,PG,33,TOT,77,5,1859,135,335,0.40299999999999997,32,106,0.302,103,229,0.45,0.451,60,71,0.845,24,178,202,355,59,15,156,242,362
Doug Christie,SG,30,SAC,81,81,2939,311,788,0.395,94,250,0.376,217,538,0.40299999999999997,0.45399999999999996,280,312,0.897,95,260,355,289,183,45,154,224,996
Keon Clark,PF,25,TOT,81,3,1720,249,519,0.48,0,1,0.0,249,518,0.48100000000000004,0.48,142,240,0.5920000000000001,136,298,434,72,32,154,90,244,640
Mateen Cleaves,PG,23,DET,78,8,1268,160,400,0.4,5,17,0.294,155,383,0.405,0.406,97,137,0.708,26,106,132,207,49,1,139,153,422
John Coker,C,29,GSW,6,0,32,1,8,0.125,0,0,0.0,1,8,0.125,0.125,0,0,0.0,3,2,5,2,1,0,2,4,2
Derrick Coleman,PF,33,CHH,34,3,683,97,255,0.38,20,51,0.392,77,204,0.377,0.42,63,92,0.685,46,138,184,39,10,21,42,53,277
Bimbo Coles,PG,32,CLE,47,0,804,91,239,0.381,2,16,0.125,89,223,0.39899999999999997,0.385,48,56,0.857,9,39,48,138,27,6,59,87,232
Jason Collier,C,23,HOU,23,0,222,27,71,0.38,0,1,0.0,27,70,0.386,0.38,17,24,0.708,12,25,37,6,2,3,11,27,71
Sean Colson,PG,25,TOT,13,0,44,6,24,0.25,1,5,0.2,5,19,0.263,0.271,2,4,0.5,2,4,6,10,1,0,2,6,15
Tyrone Corbin,SF,38,TOR,15,1,117,9,38,0.237,0,5,0.0,9,33,0.273,0.237,2,4,0.5,3,10,13,4,2,0,3,18,20
Chris Crawford,PF,25,ATL,47,22,901,122,270,0.452,6,22,0.273,116,248,0.46799999999999997,0.46299999999999997,68,83,0.8190000000000001,28,82,110,37,21,16,62,117,318
Jamal Crawford,PG,20,CHI,61,8,1050,107,304,0.35200000000000004,41,117,0.35,66,187,0.353,0.419,27,34,0.794,9,80,89,141,43,14,85,68,282
Austin Croshere,PF,25,IND,81,23,1874,276,701,0.39399999999999996,70,207,0.33799999999999997,206,494,0.41700000000000004,0.444,200,231,0.866,123,264,387,92,36,50,136,180,822
John Crotty,PG,31,UTA,31,0,264,22,65,0.33799999999999997,4,7,0.5710000000000001,18,58,0.31,0.369,17,19,0.895,13,15,28,34,6,0,19,32,65
Vonteego Cummings,PG,24,GSW,66,11,1495,178,517,0.344,48,143,0.336,130,374,0.348,0.391,79,116,0.6809999999999999,47,90,137,227,67,14,91,160,483
Bill Curley,PF,28,TOT,20,2,192,25,47,0.532,1,2,0.5,24,45,0.5329999999999999,0.5429999999999999,12,19,0.632,21,16,37,3,7,9,16,45,63
Dell Curry,SG,36,TOR,71,1,956,162,382,0.424,62,145,0.428,100,237,0.42200000000000004,0.505,43,51,0.843,16,69,85,75,27,8,39,66,429
Michael Curry,SG,32,DET,68,58,1485,145,319,0.455,4,9,0.444,141,310,0.455,0.461,62,73,0.8490000000000001,21,100,121,132,27,3,61,173,356
Erick Dampier,C,25,GSW,43,26,1038,126,314,0.401,0,2,0.0,126,312,0.40399999999999997,0.401,67,126,0.532,97,153,250,59,17,58,82,123,319
Antonio Daniels,PG,25,SAS,79,23,2060,275,588,0.46799999999999997,74,183,0.40399999999999997,201,405,0.496,0.531,121,156,0.7759999999999999,26,137,163,304,61,14,109,120,745
Kornél Dávid,SF,29,TOT,27,0,209,25,51,0.49,0,0,0.0,25,51,0.49,0.49,12,13,0.9229999999999999,15,37,52,7,6,4,11,28,62
Antonio Davis,C,32,TOR,78,77,2729,375,866,0.433,0,1,0.0,375,865,0.434,0.433,319,423,0.754,274,513,787,106,22,151,135,230,1069
Baron Davis,PG,21,CHH,82,82,3192,409,957,0.42700000000000005,85,274,0.31,324,683,0.474,0.47200000000000003,228,337,0.677,129,279,408,598,170,36,226,267,1131
Dale Davis,C,31,POR,81,43,2162,242,487,0.49700000000000005,0,4,0.0,242,483,0.501,0.49700000000000005,96,152,0.632,233,373,606,103,44,76,67,199,580
Emanual Davis,SG,32,SEA,62,39,1290,133,318,0.418,50,127,0.39399999999999996,83,191,0.435,0.49700000000000005,45,55,0.818,28,126,154,137,64,12,77,101,361
Hubert Davis,PG,30,TOT,66,18,1692,196,433,0.45299999999999996,78,171,0.456,118,262,0.45,0.5429999999999999,54,62,0.871,28,111,139,110,35,1,81,121,524
Ricky Davis,SG,21,MIA,7,0,70,12,29,0.414,1,1,1.0,11,28,0.39299999999999996,0.431,7,8,0.875,1,6,7,11,5,2,5,7,32
Terry Davis,PF,33,DEN,19,1,228,12,25,0.48,0,0,0.0,12,25,0.48,0.48,9,22,0.409,24,29,53,7,1,1,5,34,33
Todd Day,SG,31,MIN,31,0,345,44,118,0.373,26,69,0.377,18,49,0.36700000000000005,0.483,18,23,0.7829999999999999,10,27,37,28,10,7,24,52,132
Andrew DeClercq,C,27,ORL,67,51,903,107,193,0.5539999999999999,0,0,0.0,107,193,0.5539999999999999,0.5539999999999999,47,82,0.573,91,145,236,32,41,33,51,198,261
Vinny Del Negro,PG,34,TOT,65,1,922,106,234,0.45299999999999996,1,13,0.077,105,221,0.475,0.455,41,44,0.932,12,70,82,126,26,3,34,78,254
Tony Delk,SG,27,PHO,82,11,2288,383,923,0.415,54,168,0.321,329,755,0.436,0.444,185,235,0.787,76,185,261,160,75,17,101,171,1005
Derrick Dial,SG,25,SAS,33,0,207,36,83,0.434,2,10,0.2,34,73,0.466,0.446,12,21,0.5710000000000001,12,26,38,21,4,6,12,22,86
Michael Dickerson,SG,25,VAN,70,69,2618,425,1020,0.41700000000000004,86,230,0.374,339,790,0.429,0.45899999999999996,206,270,0.763,70,159,229,233,62,27,162,207,1142
Vlade Divac*,C,32,SAC,81,81,2420,364,755,0.48200000000000004,4,14,0.28600000000000003,360,741,0.486,0.485,242,350,0.691,207,466,673,231,87,93,192,242,974
Michael Doleac,C,23,ORL,77,21,1398,220,527,0.41700000000000004,0,3,0.0,220,524,0.42,0.41700000000000004,50,59,0.847,70,203,273,65,37,41,59,239,490
Keyon Dooling,PG,20,LAC,76,1,1237,148,362,0.409,28,80,0.35,120,282,0.426,0.44799999999999995,125,179,0.698,8,81,89,177,41,11,94,107,449
Sherman Douglas,PG,34,NJN,59,7,1094,122,303,0.40299999999999997,8,40,0.2,114,263,0.433,0.41600000000000004,86,115,0.748,21,53,74,144,36,4,79,93,338
Bryce Drew,PG,26,CHI,48,41,1305,124,327,0.379,40,105,0.381,84,222,0.37799999999999995,0.44,14,19,0.737,12,57,69,185,32,3,68,99,302
Chris Dudley,C,35,PHO,53,33,613,29,73,0.397,0,0,0.0,29,73,0.397,0.397,14,36,0.389,64,119,183,18,14,29,26,111,72
Tim Duncan,PF,24,SAS,82,82,3174,702,1406,0.499,7,27,0.259,695,1379,0.504,0.502,409,662,0.618,259,738,997,245,70,192,242,247,1820
Tyus Edney,PG,27,IND,24,0,263,35,91,0.385,1,6,0.16699999999999998,34,85,0.4,0.39,35,39,0.897,5,19,24,54,17,0,25,17,106
Kevin Edwards,SG,35,VAN,46,5,634,56,170,0.32899999999999996,5,19,0.263,51,151,0.33799999999999997,0.344,43,53,0.8109999999999999,23,59,82,52,29,8,37,46,160
Howard Eisley,SG,28,DAL,82,40,2426,265,675,0.39299999999999996,107,269,0.39799999999999996,158,406,0.389,0.47200000000000003,104,126,0.825,23,174,197,295,99,12,102,218,741
Obinna Ekezie,PF,25,TOT,33,0,281,32,81,0.395,0,0,0.0,32,81,0.395,0.395,37,53,0.698,31,47,78,9,5,5,14,48,101
Khalid El-Amin,PG,21,CHI,50,14,936,115,311,0.37,28,84,0.33299999999999996,87,227,0.38299999999999995,0.415,56,72,0.778,21,60,81,145,48,2,54,99,314
Mario Elie,SG,37,PHO,68,67,1506,104,246,0.423,36,100,0.36,68,146,0.466,0.496,55,69,0.797,38,117,155,131,58,12,60,112,299
Sean Elliott,SF,32,SAS,52,34,1229,147,339,0.434,55,129,0.426,92,210,0.43799999999999994,0.515,60,84,0.7140000000000001,17,153,170,81,23,25,51,80,409
LaPhonso Ellis,PF,30,MIN,82,5,1948,298,642,0.46399999999999997,7,22,0.318,291,620,0.469,0.47,169,214,0.79,199,295,494,93,67,74,108,290,772
Pervis Ellison,C,33,SEA,9,0,40,2,7,0.28600000000000003,0,0,0.0,2,7,0.28600000000000003,0.28600000000000003,2,2,1.0,2,10,12,3,0,2,3,13,6
Evan Eschmeyer,C,25,NJN,74,51,1331,92,200,0.46,0,0,0.0,92,200,0.46,0.46,67,102,0.657,135,231,366,40,41,58,53,220,251
Patrick Ewing*,C,38,SEA,79,79,2107,294,684,0.43,0,2,0.0,294,682,0.431,0.43,172,251,0.685,124,461,585,92,53,91,151,229,760
Jamie Feick,C,26,NJN,6,0,149,8,23,0.348,0,0,0.0,8,23,0.348,0.348,6,12,0.5,12,44,56,5,8,3,7,15,22
Danny Ferry,SF,34,SAS,80,29,1688,178,375,0.475,70,156,0.449,108,219,0.493,0.568,22,30,0.733,55,168,223,71,28,21,50,169,448
Michael Finley,SF,27,DAL,82,82,3443,711,1552,0.45799999999999996,91,263,0.34600000000000003,620,1289,0.48100000000000004,0.48700000000000004,252,325,0.775,109,316,425,360,118,32,190,174,1765
Derek Fisher,PG,26,LAL,20,20,709,77,187,0.41200000000000003,25,63,0.397,52,124,0.419,0.479,50,62,0.8059999999999999,5,54,59,87,39,2,29,50,229
Marcus Fizer,PF,22,CHI,72,13,1580,278,646,0.43,10,39,0.256,268,607,0.442,0.43799999999999994,117,161,0.727,76,237,313,76,30,19,124,175,683
Danny Fortson,PF,24,GSW,6,6,203,29,50,0.58,0,0,0.0,29,50,0.58,0.58,42,54,0.778,29,69,98,5,2,0,10,22,100
Greg Foster,C,32,LAL,62,8,451,56,133,0.42100000000000004,3,9,0.33299999999999996,53,124,0.42700000000000005,0.43200000000000005,10,14,0.7140000000000001,29,83,112,32,9,12,25,76,125
Jeff Foster,C,24,IND,71,9,1152,100,213,0.469,2,7,0.28600000000000003,98,206,0.47600000000000003,0.474,47,91,0.516,144,245,389,33,39,28,52,152,249
Rick Fox,SF,31,LAL,82,77,2291,287,646,0.444,118,300,0.39299999999999996,169,346,0.488,0.536,95,122,0.779,80,245,325,262,70,29,136,225,787
Adonal Foyle,C,25,GSW,58,37,1457,156,375,0.41600000000000004,0,0,0.0,156,375,0.41600000000000004,0.41600000000000004,30,68,0.441,156,249,405,48,31,156,79,136,342
Steve Francis,PG,23,HOU,80,79,3194,550,1219,0.451,133,336,0.396,417,883,0.47200000000000003,0.506,358,438,0.8170000000000001,190,363,553,517,141,31,265,274,1591
Todd Fuller,C,26,MIA,10,0,77,10,35,0.28600000000000003,0,0,0.0,10,35,0.28600000000000003,0.28600000000000003,8,8,1.0,7,11,18,1,3,2,3,10,28
Lawrence Funderburke,PF,30,SAC,59,2,698,120,242,0.496,0,0,0.0,120,242,0.496,0.496,48,77,0.623,74,122,196,17,9,13,32,44,288
Rubén Garcés,PF,27,TOT,13,0,73,7,22,0.318,0,0,0.0,7,22,0.318,0.318,2,8,0.25,16,13,29,5,3,2,5,14,16
Chris Garner,PG,25,GSW,8,0,149,7,37,0.18899999999999997,0,7,0.0,7,30,0.233,0.18899999999999997,5,6,0.833,2,10,12,18,7,1,9,18,19
Kevin Garnett,PF,24,MIN,81,81,3202,704,1475,0.47700000000000004,19,66,0.28800000000000003,685,1409,0.486,0.484,357,467,0.764,219,702,921,401,111,145,230,204,1784
Dean Garrett,C,34,MIN,70,21,831,75,156,0.48100000000000004,0,0,0.0,75,156,0.48100000000000004,0.48100000000000004,27,39,0.6920000000000001,65,152,217,24,26,49,25,93,177
Pat Garrity,SF,24,ORL,76,1,1579,223,576,0.387,97,224,0.433,126,352,0.358,0.47100000000000003,85,98,0.867,51,159,210,51,40,15,68,241,628
Chris Gatling,PF,33,CLE,74,6,1670,329,733,0.449,28,92,0.304,301,641,0.47,0.46799999999999997,156,228,0.684,99,292,391,61,52,27,119,185,842
Matt Geiger,C,31,PHI,35,4,542,88,224,0.39299999999999996,0,2,0.0,88,222,0.396,0.39299999999999996,37,54,0.685,50,89,139,14,12,8,25,73,213
Devean George,SF,23,LAL,59,1,593,64,207,0.309,15,68,0.221,49,139,0.353,0.345,39,55,0.7090000000000001,35,75,110,19,15,15,34,87,182
Eddie Gill,PG,22,NJN,8,0,152,16,41,0.39,3,9,0.33299999999999996,13,32,0.406,0.42700000000000005,4,5,0.8,0,9,9,24,4,1,10,9,39
Kendall Gill,SG,32,NJN,31,26,892,107,323,0.331,4,14,0.28600000000000003,103,309,0.33299999999999996,0.337,65,90,0.722,32,99,131,87,47,7,48,64,283
Dion Glover,SG,22,ATL,57,7,929,141,336,0.42,9,46,0.196,132,290,0.455,0.433,47,69,0.6809999999999999,39,92,131,69,49,10,54,92,338
Anthony Goldwire,PG,29,DEN,20,0,201,30,80,0.375,9,34,0.265,21,46,0.457,0.431,13,17,0.765,1,11,12,34,9,0,15,13,82
Steve Goodrich,PF,24,CHI,12,0,133,7,18,0.389,1,3,0.33299999999999996,6,15,0.4,0.41700000000000004,4,7,0.5710000000000001,7,14,21,6,2,1,8,14,19
Brian Grant,C,28,MIA,82,79,2771,484,1010,0.479,0,1,0.0,484,1009,0.48,0.479,282,354,0.797,217,501,718,101,60,71,170,293,1250
Gary Grant,PG,35,POR,4,0,17,5,7,0.7140000000000001,0,0,0.0,5,7,0.7140000000000001,0.7140000000000001,0,0,0.0,0,0,0,1,0,0,0,1,10
Horace Grant,PF,35,LAL,77,77,2390,263,569,0.462,0,3,0.0,263,566,0.465,0.462,131,169,0.775,220,325,545,121,51,61,48,181,657
A.C. Green,PF,37,MIA,82,1,1411,144,324,0.444,0,6,0.0,144,318,0.45299999999999996,0.444,79,111,0.7120000000000001,107,206,313,39,30,8,45,119,367
Adrian Griffin,SF,26,BOS,44,0,377,33,97,0.34,9,26,0.34600000000000003,24,71,0.33799999999999997,0.387,18,24,0.75,27,60,87,27,18,5,18,45,93
Tom Gugliotta,PF,31,PHO,57,2,1159,149,380,0.392,3,12,0.25,146,368,0.397,0.396,61,77,0.792,76,179,255,55,47,21,51,110,362
A.J. Guyton,PG,22,CHI,33,8,630,78,192,0.406,27,69,0.391,51,123,0.415,0.47700000000000004,15,18,0.833,10,26,36,64,9,5,24,35,198
Darvin Ham,SF,27,MIL,29,13,540,39,80,0.488,2,3,0.667,37,77,0.48100000000000004,0.5,29,49,0.5920000000000001,56,65,121,25,17,21,33,85,109
Richard Hamilton,SF,22,WAS,78,42,2519,547,1249,0.43799999999999994,40,146,0.27399999999999997,507,1103,0.46,0.45399999999999996,277,319,0.868,75,163,238,224,75,10,201,203,1411
Zendon Hamilton,C,25,LAC,3,0,19,2,9,0.222,0,0,0.0,2,9,0.222,0.222,5,8,0.625,3,5,8,0,0,0,2,4,9
Tom Hammonds,PF,33,MIN,7,0,30,3,10,0.3,0,0,0.0,3,10,0.3,0.3,1,2,0.5,2,2,4,1,0,0,3,8,7
Anfernee Hardaway,SG,29,PHO,4,4,112,15,36,0.41700000000000004,2,8,0.25,13,28,0.46399999999999997,0.444,7,11,0.636,5,13,18,15,6,1,3,6,39
Tim Hardaway,PG,34,MIA,77,77,2613,408,1042,0.392,189,517,0.366,219,525,0.41700000000000004,0.48200000000000004,145,181,0.8009999999999999,26,178,204,483,90,6,189,155,1150
Ron Harper,PG,37,LAL,47,46,1139,127,271,0.469,19,72,0.264,108,199,0.5429999999999999,0.504,34,48,0.708,46,120,166,113,39,25,62,70,307
Matt Harpring,SG,24,CLE,56,55,1615,238,524,0.45399999999999996,13,52,0.25,225,472,0.47700000000000004,0.467,134,165,0.812,90,152,242,102,42,17,90,161,623
Al Harrington,PF,20,IND,78,38,1892,241,543,0.444,1,7,0.14300000000000002,240,536,0.44799999999999995,0.445,103,157,0.6559999999999999,119,262,381,130,63,18,148,223,586
Othella Harrington,C,27,TOT,74,45,1815,247,507,0.48700000000000004,0,3,0.0,247,504,0.49,0.48700000000000004,171,224,0.763,139,249,388,56,34,45,145,237,665
Lucious Harris,SG,30,NJN,73,50,2071,265,624,0.425,46,132,0.348,219,492,0.445,0.462,107,139,0.77,71,217,288,135,74,16,64,127,683
Jason Hart,PG,22,MIL,1,0,10,1,1,1.0,0,0,0.0,1,1,1.0,1.0,0,0,0.0,0,0,0,1,0,0,2,0,2
Antonio Harvey,PF,30,POR,12,0,72,13,28,0.46399999999999997,0,0,0.0,13,28,0.46399999999999997,0.46399999999999997,5,6,0.833,5,9,14,4,1,6,3,10,31
Donnell Harvey,PF,20,DAL,18,0,65,8,14,0.5710000000000001,0,0,0.0,8,14,0.5710000000000001,0.5710000000000001,6,16,0.375,6,14,20,2,3,1,7,15,22
Hersey Hawkins,SG,34,CHH,59,0,681,56,137,0.409,17,46,0.37,39,91,0.429,0.47100000000000003,54,63,0.857,17,63,80,72,33,9,19,45,183
Michael Hawkins,PG,28,CLE,10,0,76,3,9,0.33299999999999996,2,4,0.5,1,5,0.2,0.444,0,0,0.0,2,3,5,13,2,0,6,13,8
Alan Henderson,PF,28,ATL,73,42,1810,298,671,0.444,0,1,0.0,298,670,0.445,0.444,173,271,0.638,180,226,406,50,51,29,126,164,769
Cedric Henderson,SF,25,CLE,55,10,961,102,262,0.389,1,8,0.125,101,254,0.39799999999999996,0.391,30,46,0.652,19,71,90,79,29,23,63,101,235
Chris Herren,PG,25,BOS,25,7,408,29,96,0.302,16,55,0.29100000000000004,13,41,0.317,0.385,9,12,0.75,4,17,21,56,14,0,20,43,83
Grant Hill*,SF,28,ORL,4,4,133,19,43,0.442,1,1,1.0,18,42,0.429,0.45299999999999996,16,26,0.615,8,17,25,25,5,2,11,9,55
Tyrone Hill,PF,32,PHI,76,75,2363,278,587,0.474,0,1,0.0,278,586,0.474,0.474,172,273,0.63,239,448,687,48,37,27,127,242,728
Fred Hoiberg,SG,28,CHI,74,37,2247,217,495,0.43799999999999994,103,250,0.41200000000000003,114,245,0.465,0.542,136,157,0.866,21,287,308,263,98,12,74,155,673
Robert Horry,PF,30,LAL,79,1,1587,147,380,0.387,54,156,0.34600000000000003,93,224,0.415,0.45799999999999996,59,83,0.711,93,203,296,128,54,54,79,210,407
Eddie House,PG,22,MIA,50,0,550,104,247,0.42100000000000004,19,55,0.345,85,192,0.44299999999999995,0.46,24,35,0.6859999999999999,5,37,42,52,13,0,35,58,251
Allan Houston,SG,29,NYK,78,78,2858,542,1208,0.449,96,252,0.381,446,956,0.467,0.488,279,307,0.909,20,263,283,173,52,10,161,190,1459
Juwan Howard,PF,27,TOT,81,81,2974,583,1218,0.479,0,3,0.0,583,1215,0.48,0.479,296,383,0.773,171,401,572,224,75,37,242,292,1462
Troy Hudson,PG,24,ORL,75,7,1008,125,372,0.336,22,109,0.20199999999999999,103,263,0.392,0.366,85,104,0.8170000000000001,38,67,105,162,37,3,92,82,357
Larry Hughes,SG,22,GSW,50,45,1846,308,805,0.38299999999999995,14,75,0.187,294,730,0.40299999999999997,0.391,193,252,0.7659999999999999,76,200,276,223,96,29,152,147,823
Lindsey Hunter,PG,30,MIL,82,5,2002,298,783,0.381,152,407,0.373,146,376,0.38799999999999996,0.478,77,96,0.802,32,137,169,222,102,12,68,172,825
Zydrunas Ilgauskas,C,25,CLE,24,24,616,114,234,0.48700000000000004,0,2,0.0,114,232,0.491,0.48700000000000004,53,78,0.679,65,95,160,18,15,37,60,78,281
Allen Iverson*,SG,25,PHI,71,71,2979,762,1813,0.42,98,306,0.32,664,1507,0.441,0.447,585,719,0.8140000000000001,50,223,273,325,178,20,237,147,2207
Bobby Jackson,PG,27,SAC,79,7,1648,231,526,0.439,39,104,0.375,192,422,0.455,0.47600000000000003,65,88,0.7390000000000001,74,172,246,161,87,7,103,139,566
Jaren Jackson,SG,33,SAS,16,0,114,16,40,0.4,7,18,0.389,9,22,0.409,0.488,0,2,0.0,1,11,12,7,5,0,3,13,39
Jim Jackson,SF,30,TOT,56,40,1690,239,632,0.37799999999999995,26,80,0.325,213,552,0.386,0.39899999999999997,139,169,0.8220000000000001,53,171,224,163,53,10,130,139,643
Marc Jackson,C,26,GSW,48,35,1410,237,508,0.467,5,23,0.217,232,485,0.478,0.47100000000000003,154,192,0.802,119,242,361,59,34,27,93,138,633
Mark Jackson,PG,35,TOT,83,82,2588,244,583,0.419,70,207,0.33799999999999997,174,376,0.46299999999999997,0.479,73,93,0.785,63,242,305,661,84,7,175,139,631
Stephen Jackson,SF,22,NJN,77,40,1660,243,572,0.425,52,155,0.335,191,417,0.45799999999999996,0.47,97,135,0.7190000000000001,41,167,208,140,86,14,130,166,635
Sam Jacobson,PG,25,MIN,14,0,59,9,18,0.5,0,0,0.0,9,18,0.5,0.5,2,3,0.667,3,3,6,4,3,0,0,19,20
Tim James,SF,24,CHH,30,0,197,16,52,0.308,1,3,0.33299999999999996,15,49,0.306,0.317,12,14,0.857,15,20,35,8,2,5,8,27,45
Antawn Jamison,SF,24,GSW,82,82,3394,800,1812,0.442,62,205,0.302,738,1607,0.45899999999999996,0.45899999999999996,382,534,0.715,280,435,715,164,114,28,199,225,2044
Anthony Johnson,PG,26,TOT,53,0,511,53,152,0.349,1,5,0.2,52,147,0.354,0.35200000000000004,23,33,0.6970000000000001,10,34,44,78,23,6,34,62,130
Avery Johnson,PG,35,SAS,55,20,1290,134,300,0.447,1,6,0.16699999999999998,133,294,0.452,0.44799999999999995,41,60,0.6829999999999999,21,64,85,237,33,4,60,90,310
DerMarr Johnson,SF,20,ATL,78,21,1313,146,390,0.374,41,127,0.32299999999999995,105,263,0.39899999999999997,0.42700000000000005,64,87,0.736,56,122,178,64,43,30,93,134,397
Ervin Johnson,C,33,MIL,82,19,1981,108,198,0.545,0,0,0.0,108,198,0.545,0.545,50,93,0.5379999999999999,205,408,613,40,44,97,47,257,266
Larry Johnson,PF,31,NYK,65,65,2105,246,598,0.41100000000000003,51,163,0.313,195,435,0.44799999999999995,0.45399999999999996,102,128,0.797,90,273,363,127,39,29,97,209,645
Damon Jones,PG,24,VAN,71,10,1415,170,416,0.409,84,231,0.364,86,185,0.465,0.51,37,52,0.7120000000000001,16,108,124,224,36,1,76,58,461
Eddie Jones,SG,29,MIA,63,58,2282,388,871,0.445,90,238,0.37799999999999995,298,633,0.47100000000000003,0.49700000000000005,228,270,0.8440000000000001,75,217,292,171,110,58,135,183,1094
Jumaine Jones,SF,21,PHI,65,0,866,122,275,0.444,20,60,0.33299999999999996,102,215,0.474,0.48,40,53,0.755,63,126,189,32,30,15,39,68,304
Popeye Jones,PF,30,WAS,45,1,638,60,153,0.392,1,6,0.16699999999999998,59,147,0.401,0.395,41,55,0.745,83,137,220,31,19,8,21,95,162
Garth Joseph,C,27,TOT,4,0,16,1,5,0.2,0,0,0.0,1,5,0.2,0.2,0,2,0.0,2,0,2,1,0,1,2,1,2
Adam Keefe,PF,30,GSW,67,13,836,64,159,0.40299999999999997,1,3,0.33299999999999996,63,156,0.40399999999999997,0.406,39,63,0.619,90,119,209,36,28,20,40,102,168
Shawn Kemp,PF,31,POR,68,3,1083,168,413,0.40700000000000003,4,11,0.364,164,402,0.408,0.41200000000000003,101,131,0.7709999999999999,63,196,259,65,45,23,99,184,441
Steve Kerr,PG,35,SAS,55,1,650,67,159,0.42100000000000004,33,77,0.429,34,82,0.415,0.525,14,15,0.9329999999999999,6,29,35,57,16,1,21,30,181
Jerome Kersey,SF,38,MIL,22,2,243,32,69,0.46399999999999997,0,1,0.0,32,68,0.47100000000000003,0.46399999999999997,8,16,0.5,8,37,45,15,14,8,6,36,72
Lari Ketner,PF,23,IND,3,0,7,0,0,0.0,0,0,0.0,0,0,0.0,0.0,0,0,0.0,0,0,0,1,0,0,2,0,0
Jason Kidd*,PG,27,PHO,77,76,3065,451,1097,0.41100000000000003,69,232,0.297,382,865,0.442,0.44299999999999995,328,403,0.8140000000000001,91,403,494,753,166,23,286,171,1299
Gerard King,SF,28,WAS,45,3,706,90,176,0.511,0,0,0.0,90,176,0.511,0.511,36,45,0.8,39,90,129,31,14,11,47,94,216
Brevin Knight,PG,25,TOT,53,43,1457,139,371,0.375,1,10,0.1,138,361,0.382,0.376,54,66,0.818,23,145,168,311,101,4,91,155,333
Travis Knight,C,26,NYK,45,0,256,10,53,0.18899999999999997,0,1,0.0,10,52,0.192,0.18899999999999997,9,18,0.5,19,34,53,5,5,11,10,47,29
Toni Kukoč,SF,32,TOT,65,19,1597,275,582,0.473,70,157,0.446,205,425,0.48200000000000004,0.5329999999999999,101,160,0.631,66,193,259,199,48,11,111,98,721
Christian Laettner,C-PF,31,TOT,78,48,1663,277,551,0.503,4,13,0.308,273,538,0.507,0.506,170,204,0.833,118,247,365,124,71,46,137,242,728
Raef LaFrentz,C,24,DEN,78,74,2457,387,812,0.47700000000000004,51,139,0.36700000000000005,336,673,0.499,0.508,183,262,0.698,173,434,607,107,37,206,97,290,1008
Trajan Langdon,SG,24,CLE,65,5,1116,135,313,0.431,51,124,0.41100000000000003,84,189,0.444,0.513,68,76,0.895,12,77,89,81,38,9,52,114,389
Dan Langhi,SF,23,HOU,33,0,241,37,99,0.374,0,1,0.0,37,98,0.37799999999999995,0.374,16,29,0.552,13,28,41,4,7,1,8,16,90
Voshon Lenard,SG,27,DEN,80,58,2331,336,846,0.397,147,382,0.385,189,464,0.40700000000000003,0.484,153,192,0.797,47,184,231,190,65,18,102,170,972
Quincy Lewis,SF,23,UTA,35,2,402,50,123,0.40700000000000003,9,25,0.36,41,98,0.418,0.44299999999999995,15,21,0.7140000000000001,14,33,47,18,10,10,17,78,124
Rashard Lewis,PF,21,SEA,78,78,2720,426,887,0.48,123,285,0.43200000000000005,303,602,0.503,0.55,176,213,0.826,143,398,541,125,91,45,129,191,1151
Randy Livingston,PG,25,GSW,2,0,7,0,2,0.0,0,1,0.0,0,1,0.0,0.0,0,0,0.0,0,1,1,1,0,0,0,0,0
Art Long,SF,28,SAC,9,0,20,0,4,0.0,0,0,0.0,0,4,0.0,0.0,0,2,0.0,2,6,8,1,0,3,2,5,0
Grant Long,PF,34,VAN,66,27,1507,140,319,0.439,4,15,0.267,136,304,0.447,0.445,112,157,0.713,76,198,274,83,72,15,62,160,396
Luc Longley,C,32,NYK,25,2,301,18,54,0.33299999999999996,0,0,0.0,18,54,0.33299999999999996,0.33299999999999996,13,17,0.765,26,40,66,7,3,9,22,51,49
Felipe López,SG-PG,26,TOT,70,48,1565,211,478,0.441,19,52,0.365,192,426,0.451,0.461,109,156,0.6990000000000001,55,179,234,107,62,30,83,156,550
Tyronn Lue,PG,23,LAL,38,1,468,50,117,0.42700000000000005,11,34,0.324,39,83,0.47,0.474,19,24,0.792,5,27,32,45,19,0,27,54,130
George Lynch,SF,30,PHI,82,80,2649,274,616,0.445,15,57,0.263,259,559,0.46299999999999997,0.457,123,171,0.7190000000000001,200,390,590,139,99,30,109,222,686
Todd MacCulloch,C,25,PHI,63,3,597,109,185,0.589,0,0,0.0,109,185,0.589,0.589,42,66,0.636,69,99,168,10,7,19,27,96,260
Don MacLean,SF,31,MIA,8,1,76,10,20,0.5,2,2,1.0,8,18,0.444,0.55,9,12,0.75,7,11,18,4,5,1,10,9,31
Mark Madsen,PF,25,LAL,70,3,641,55,113,0.48700000000000004,1,1,1.0,54,112,0.48200000000000004,0.491,26,37,0.703,74,78,152,24,8,8,27,111,137
Corey Maggette,SF,21,LAC,69,9,1359,225,487,0.462,17,56,0.304,208,431,0.483,0.479,223,288,0.774,88,203,291,82,35,9,106,140,690
Jamaal Magloire,C,22,CHH,74,0,1095,122,271,0.45,0,2,0.0,122,269,0.45399999999999996,0.45,95,145,0.655,103,192,295,27,18,78,61,139,339
Dan Majerle,SG,35,MIA,53,19,1306,87,259,0.336,57,181,0.315,30,78,0.385,0.446,36,44,0.818,20,146,166,88,53,15,35,98,267
Karl Malone*,PF,37,UTA,81,81,2895,670,1345,0.498,2,5,0.4,668,1340,0.499,0.499,536,676,0.7929999999999999,114,555,669,361,93,62,244,216,1878
Matt Maloney,PG,29,ATL,55,27,1403,146,348,0.42,51,142,0.359,95,206,0.461,0.493,26,34,0.765,14,103,117,154,56,5,70,94,369
Danny Manning,PF,34,UTA,82,0,1305,247,500,0.494,7,28,0.25,240,472,0.508,0.501,102,140,0.7290000000000001,66,148,214,92,47,29,96,219,603
Stephon Marbury,PG,23,NJN,67,67,2557,563,1277,0.441,110,335,0.32799999999999996,453,942,0.48100000000000004,0.484,362,458,0.79,53,152,205,506,79,5,197,150,1598
Shawn Marion,SF,22,PHO,79,79,2857,557,1160,0.48,21,82,0.256,536,1078,0.49700000000000005,0.489,234,289,0.81,220,628,848,160,132,108,129,211,1369
Donyell Marshall,SF,27,UTA,81,49,2326,427,849,0.503,41,128,0.32,386,721,0.535,0.527,205,273,0.7509999999999999,172,394,566,133,85,78,128,196,1100
Darrick Martin,PG,29,SAC,31,0,176,29,76,0.382,14,27,0.519,15,49,0.306,0.474,31,35,0.8859999999999999,2,14,16,14,7,0,10,27,103
Kenyon Martin,PF,23,NJN,68,68,2272,346,777,0.445,1,11,0.091,345,766,0.45,0.446,121,192,0.63,137,365,502,131,78,113,138,281,814
Jamal Mashburn,SF,28,CHH,76,76,2989,573,1388,0.413,103,289,0.35600000000000004,470,1099,0.428,0.45,279,364,0.7659999999999999,92,484,576,411,85,13,211,185,1528
Anthony Mason,PF,34,MIA,80,80,3254,460,954,0.48200000000000004,0,0,0.0,460,954,0.48200000000000004,0.48200000000000004,370,474,0.7809999999999999,169,601,770,248,80,25,179,231,1290
Desmond Mason,SF,23,SEA,78,14,1522,189,439,0.431,18,67,0.26899999999999996,171,372,0.46,0.451,67,91,0.736,72,177,249,63,39,20,53,146,463
Tony Massenburg,PF,33,VAN,52,20,823,92,199,0.462,0,0,0.0,92,199,0.462,0.462,49,70,0.7,75,135,210,9,10,28,48,122,233
Vernon Maxwell,PG,35,TOT,43,6,660,73,223,0.327,34,111,0.306,39,112,0.348,0.40399999999999997,21,32,0.6559999999999999,4,62,66,49,21,3,35,64,201
Walter McCarty,PF,26,BOS,60,3,478,45,126,0.35700000000000004,19,56,0.33899999999999997,26,70,0.371,0.433,22,28,0.7859999999999999,24,57,81,39,14,7,20,82,131
Dan McClintock,C,23,DEN,6,1,58,9,18,0.5,0,0,0.0,9,18,0.5,0.5,0,5,0.0,10,7,17,1,0,2,3,11,18
George McCloud,SF,33,DEN,76,8,2007,250,655,0.382,77,234,0.32899999999999996,173,421,0.41100000000000003,0.44,152,181,0.84,55,169,224,279,53,27,117,165,729
Jelani McCoy,C,23,SEA,70,44,1143,138,264,0.523,0,0,0.0,138,264,0.523,0.523,41,93,0.441,92,159,251,57,18,49,75,141,317
Antonio McDyess,PF,26,DEN,70,70,2555,577,1165,0.495,0,0,0.0,577,1165,0.495,0.495,304,434,0.7,240,605,845,146,43,102,162,220,1458
Tracy McGrady*,SG,21,ORL,77,77,3087,788,1724,0.457,59,166,0.355,729,1558,0.46799999999999997,0.474,430,587,0.733,192,388,580,352,116,118,198,160,2065
Jim McIlvaine,C,28,NJN,18,3,193,10,28,0.35700000000000004,0,0,0.0,10,28,0.35700000000000004,0.35700000000000004,8,12,0.667,8,27,35,4,7,15,9,35,28
Jeff McInnis,PG,26,LAC,81,81,2831,432,933,0.46299999999999997,52,144,0.361,380,789,0.48200000000000004,0.491,130,161,0.807,41,179,220,447,75,7,113,199,1046
Derrick McKey,SF,34,IND,66,20,987,60,136,0.441,4,20,0.2,56,116,0.483,0.456,21,27,0.778,49,127,176,74,48,13,47,136,145
Aaron McKie,SG,28,PHI,76,33,2394,338,714,0.473,53,170,0.312,285,544,0.524,0.511,149,194,0.768,33,278,311,377,106,8,203,178,878
Roshown McLeod,SF,25,TOT,35,25,922,145,332,0.43700000000000006,2,22,0.091,143,310,0.461,0.44,45,51,0.882,38,82,120,58,23,8,58,90,337
Paul McPherson,PG,22,TOT,55,0,595,109,216,0.505,2,12,0.16699999999999998,107,204,0.525,0.509,42,58,0.7240000000000001,40,39,79,38,25,4,47,80,262
Stanislav Medvedenko,PF,21,LAL,7,0,39,12,25,0.48,1,1,1.0,11,24,0.45799999999999996,0.5,7,12,0.583,1,8,9,2,1,1,3,9,32
Ron Mercer,SG,24,CHI,61,61,2535,500,1121,0.446,14,46,0.304,486,1075,0.452,0.452,188,228,0.825,72,164,236,201,78,27,129,148,1202
Chris Mihm,C,21,CLE,59,43,1166,173,391,0.442,0,1,0.0,173,390,0.444,0.442,100,126,0.794,106,174,280,16,20,53,80,156,446
Darius Miles,SF,19,LAC,81,21,2133,318,630,0.505,1,19,0.053,317,611,0.519,0.506,124,238,0.521,127,350,477,99,51,125,147,191,761
Andre Miller,PG,24,CLE,82,82,2848,452,999,0.452,17,64,0.266,435,935,0.465,0.461,375,450,0.833,94,266,360,657,119,28,265,229,1296
Anthony Miller,PF,29,TOT,4,0,11,1,2,0.5,0,0,0.0,1,2,0.5,0.5,0,0,0.0,0,2,2,0,0,0,1,1,2
Brad Miller,C,24,CHI,57,45,1434,168,386,0.435,1,5,0.2,167,381,0.43799999999999994,0.43700000000000006,168,226,0.743,144,275,419,107,33,38,73,176,505
Mike Miller,SF,20,ORL,82,62,2390,368,845,0.436,148,364,0.40700000000000003,220,481,0.457,0.523,91,128,0.711,66,261,327,140,51,19,97,200,975
Reggie Miller*,SG,35,IND,81,81,3181,517,1176,0.44,170,464,0.366,347,712,0.48700000000000004,0.512,323,348,0.9279999999999999,38,247,285,260,81,15,133,162,1527
Chris Mills,SF,31,GSW,15,8,493,71,191,0.37200000000000005,7,25,0.28,64,166,0.386,0.39,31,36,0.861,24,69,93,18,9,5,20,43,180
Terry Mills,PF,33,IND,14,0,113,11,34,0.324,3,17,0.17600000000000002,8,17,0.47100000000000003,0.368,0,0,0.0,4,17,21,5,3,1,10,20,25
Sam Mitchell,SF,37,MIN,82,4,983,118,289,0.408,9,43,0.209,109,246,0.44299999999999995,0.424,40,55,0.727,28,95,123,57,26,10,36,117,285
Cuttino Mobley,SG,25,HOU,79,49,3002,527,1214,0.434,90,252,0.35700000000000004,437,962,0.45399999999999996,0.47100000000000003,394,474,0.831,83,314,397,195,84,26,165,169,1538
Nazr Mohammed,C,23,TOT,58,22,912,176,369,0.47700000000000004,0,1,0.0,176,368,0.478,0.47700000000000004,89,126,0.706,115,192,307,19,29,35,64,113,441
Jérôme Moïso,C,22,BOS,24,0,135,12,30,0.4,0,1,0.0,12,29,0.414,0.4,11,26,0.423,12,30,42,3,3,4,18,29,35
Eric Montross,C,29,TOT,54,21,649,56,138,0.406,0,0,0.0,56,138,0.406,0.406,8,31,0.258,52,121,173,19,11,26,41,115,120
Mikki Moore,C,25,DET,81,2,1154,132,268,0.493,0,1,0.0,132,267,0.494,0.493,95,130,0.731,121,195,316,33,24,61,74,202,359
Hanno Möttölä,SF,24,ATL,73,3,989,123,277,0.444,0,3,0.0,123,274,0.449,0.444,73,90,0.8109999999999999,49,125,174,25,11,9,67,163,319
Alonzo Mourning*,C,30,MIA,13,3,306,73,141,0.518,0,1,0.0,73,140,0.521,0.518,31,55,0.564,35,66,101,12,4,31,28,24,177
Chris Mullin*,SF,37,GSW,20,8,374,36,106,0.34,19,52,0.365,17,54,0.315,0.429,24,28,0.857,10,31,41,19,16,10,19,28,115
Lamond Murray,SF,27,CLE,78,46,2225,391,925,0.423,61,165,0.37,330,760,0.434,0.456,155,211,0.735,104,236,340,124,83,27,141,173,998
Tracy Murray,SF,29,TOT,51,1,588,94,248,0.379,36,103,0.35,58,145,0.4,0.452,33,42,0.7859999999999999,22,59,81,23,12,7,26,53,257
Dikembe Mutombo*,C,34,TOT,75,75,2591,269,556,0.484,0,0,0.0,269,556,0.484,0.484,211,291,0.725,307,708,1015,76,29,203,144,204,749
Mamadou N'Diaye,C,25,TOR,3,0,10,1,4,0.25,0,0,0.0,1,4,0.25,0.25,2,2,1.0,1,1,2,0,0,0,0,3,4
Lee Nailon,SF,25,CHH,42,0,469,66,136,0.485,0,1,0.0,66,135,0.489,0.485,32,43,0.7440000000000001,29,63,92,24,9,5,27,60,164
Eduardo Nájera,PF,24,DAL,40,4,431,58,111,0.523,1,3,0.33299999999999996,57,108,0.528,0.527,14,33,0.424,41,54,95,27,13,8,17,48,131
Steve Nash*,PG,26,DAL,70,70,2387,386,792,0.48700000000000004,89,219,0.406,297,573,0.518,0.544,231,258,0.895,46,177,223,509,72,5,205,158,1092
Tyrone Nesby,SF-SG,25,TOT,62,34,1556,189,530,0.35700000000000004,49,180,0.272,140,350,0.4,0.40299999999999997,85,106,0.802,51,122,173,76,51,20,65,155,512
Rasho Nesterović,C,24,MIN,73,39,1233,147,319,0.461,0,1,0.0,147,318,0.462,0.461,34,65,0.523,99,187,286,45,25,63,55,189,328
Ira Newble,SF,26,SAS,27,6,184,21,55,0.382,4,9,0.444,17,46,0.37,0.418,8,16,0.5,13,22,35,6,2,4,7,18,54
Johnny Newman,SG,37,NJN,82,17,2049,291,695,0.419,59,176,0.335,232,519,0.447,0.461,254,297,0.855,34,142,176,115,63,10,106,229,895
Moochie Norris,PG,27,HOU,82,6,1654,184,413,0.446,25,89,0.281,159,324,0.491,0.47600000000000003,151,194,0.778,44,154,198,283,69,2,107,84,544
Dirk Nowitzki,PF,22,DAL,82,82,3125,591,1247,0.474,151,390,0.387,440,857,0.513,0.534,451,538,0.838,119,635,754,173,79,101,156,245,1784
Jermaine O'Neal,C,22,IND,81,80,2641,404,868,0.465,0,5,0.0,404,863,0.46799999999999997,0.465,233,388,0.601,249,545,794,98,49,228,161,280,1041
Shaquille O'Neal*,C,28,LAL,74,74,2924,813,1422,0.5720000000000001,0,2,0.0,813,1420,0.573,0.5720000000000001,499,972,0.513,291,649,940,277,47,204,218,256,2125
Charles Oakley,PF,37,TOR,78,77,2767,305,786,0.38799999999999996,11,49,0.22399999999999998,294,737,0.39899999999999997,0.395,127,152,0.836,142,599,741,264,76,48,139,258,748
Lamar Odom,PF,21,LAC,76,74,2836,481,1046,0.46,80,253,0.316,401,793,0.506,0.498,262,386,0.679,110,482,592,392,74,122,264,236,1304
Hakeem Olajuwon*,C,38,HOU,58,55,1545,283,568,0.498,0,1,0.0,283,567,0.499,0.498,123,198,0.621,124,307,431,72,70,88,81,141,689
Kevin Ollie,PG,28,TOT,70,4,925,76,192,0.396,1,3,0.33299999999999996,75,189,0.397,0.39799999999999996,63,89,0.708,16,79,95,146,30,1,49,84,216
Michael Olowokandi,C,25,LAC,82,82,2127,308,708,0.435,0,0,0.0,308,708,0.435,0.435,85,156,0.545,168,357,525,46,30,108,169,250,701
Greg Ostertag,C,27,UTA,81,3,1491,139,281,0.495,1,2,0.5,138,279,0.495,0.496,84,151,0.556,164,251,415,22,22,142,63,215,363
Bo Outlaw,PF,29,ORL,80,69,2534,226,368,0.614,1,2,0.5,225,366,0.615,0.615,129,225,0.573,211,408,619,225,105,137,141,241,582
Doug Overton,PG,31,TOT,21,10,475,52,139,0.374,11,36,0.306,41,103,0.39799999999999996,0.414,10,16,0.625,4,35,39,72,8,0,31,37,125
Billy Owens,PF,31,DET,45,14,793,88,230,0.38299999999999995,3,20,0.15,85,210,0.405,0.389,19,40,0.475,84,121,205,55,32,12,39,93,198
Olumide Oyedeji,C,19,SEA,30,1,221,18,37,0.486,0,0,0.0,18,37,0.486,0.486,9,12,0.75,24,43,67,2,7,10,11,40,45
Robert Pack,PG,31,DEN,74,11,1260,181,426,0.425,12,31,0.387,169,395,0.428,0.439,105,137,0.7659999999999999,30,107,137,293,65,1,135,114,479
Scott Padgett,PF,24,UTA,27,0,127,18,43,0.419,5,9,0.556,13,34,0.382,0.47700000000000004,15,20,0.75,19,20,39,5,6,3,10,21,56
Milt Palacio,PG,22,BOS,58,6,1141,126,267,0.47200000000000003,12,36,0.33299999999999996,114,231,0.494,0.494,78,92,0.848,25,77,102,151,48,0,80,83,342
Andy Panko,SF,23,ATL,1,0,1,0,0,0.0,0,0,0.0,0,0,0.0,0.0,0,0,0.0,0,0,0,0,0,0,0,0,0
Cherokee Parks,C,28,TOT,65,31,1054,134,274,0.489,0,6,0.0,134,268,0.5,0.489,31,44,0.705,71,158,229,46,25,36,41,122,299
Ruben Patterson,SF,25,SEA,76,22,2059,370,749,0.494,2,36,0.055999999999999994,368,713,0.516,0.495,246,361,0.6809999999999999,183,199,382,161,103,45,155,176,988
Gary Payton*,PG,32,SEA,79,79,3244,725,1591,0.456,102,272,0.375,623,1319,0.47200000000000003,0.488,271,354,0.7659999999999999,73,288,361,642,127,26,209,184,1823
Anthony Peeler,SG,31,MIN,75,41,2126,308,732,0.42100000000000004,100,256,0.391,208,476,0.43700000000000006,0.489,75,87,0.862,44,148,192,192,91,18,105,166,791
Mike Penberthy,PG,26,LAL,53,0,851,92,222,0.414,55,139,0.396,37,83,0.446,0.5379999999999999,28,31,0.903,10,53,63,71,22,2,34,57,267
Will Perdue,C,35,POR,13,0,58,6,9,0.667,0,0,0.0,6,9,0.667,0.667,2,4,0.5,6,12,18,2,3,2,0,8,14
Sam Perkins,PF,39,IND,64,41,999,86,226,0.381,38,110,0.345,48,116,0.414,0.465,32,38,0.8420000000000001,32,136,168,41,33,18,19,61,242
Elliot Perry,PG,31,TOT,49,6,499,65,140,0.46399999999999997,1,5,0.2,64,135,0.474,0.46799999999999997,16,22,0.727,9,37,46,79,22,1,38,29,147
Wesley Person,SG,29,CLE,44,22,958,128,292,0.43799999999999994,34,84,0.405,94,208,0.452,0.49700000000000005,24,30,0.8,11,119,130,64,27,11,40,62,314
Morris Peterson,SG,23,TOR,80,49,1809,290,673,0.431,63,165,0.382,227,508,0.447,0.478,104,145,0.7170000000000001,112,147,259,105,63,20,78,164,747
Eric Piatkowski,SG,30,LAC,81,40,2144,291,672,0.433,120,297,0.40399999999999997,171,375,0.456,0.522,158,181,0.873,54,187,241,96,46,19,76,123,860
Paul Pierce,SF,23,BOS,82,82,3120,687,1513,0.45399999999999996,147,384,0.38299999999999995,540,1129,0.478,0.503,550,738,0.745,94,428,522,253,138,69,262,251,2071
Scottie Pippen*,SF,35,POR,64,60,2133,269,596,0.451,64,186,0.344,205,410,0.5,0.505,119,161,0.7390000000000001,70,263,333,294,94,35,154,158,721
Scot Pollard,C,25,SAC,77,8,1658,185,395,0.46799999999999997,0,2,0.0,185,393,0.47100000000000003,0.46799999999999997,128,171,0.7490000000000001,173,292,465,47,48,97,66,206,498
Olden Polynice,C,36,UTA,81,79,1619,206,415,0.496,0,1,0.0,206,414,0.498,0.496,17,65,0.262,157,221,378,31,27,77,78,241,429
Mark Pope,PF,28,MIL,63,45,942,62,142,0.43700000000000006,5,24,0.20800000000000002,57,118,0.483,0.45399999999999996,22,35,0.629,56,91,147,38,16,26,17,140,151
Chris Porter,SF,22,GSW,51,35,1147,173,445,0.389,0,5,0.0,173,440,0.39299999999999996,0.389,94,141,0.667,89,100,189,61,45,6,59,111,440
Terry Porter,PG,37,SAS,80,42,1678,197,440,0.44799999999999995,87,205,0.424,110,235,0.46799999999999997,0.547,92,116,0.7929999999999999,24,177,201,251,52,11,104,88,573
James Posey,SF,24,DEN,82,82,2255,243,590,0.41200000000000003,65,217,0.3,178,373,0.47700000000000004,0.467,115,141,0.816,125,306,431,163,93,40,102,226,666
Lavor Postell,SG,22,NYK,26,0,169,17,54,0.315,3,11,0.273,14,43,0.326,0.34299999999999997,22,27,0.815,8,17,25,5,4,2,17,12,59
Vitaly Potapenko,C,25,BOS,82,7,1901,248,521,0.47600000000000003,0,0,0.0,248,521,0.47600000000000003,0.47600000000000003,115,158,0.728,206,289,495,64,52,23,105,228,611
Brent Price,PG,32,VAN,6,0,30,3,11,0.273,1,4,0.25,2,7,0.28600000000000003,0.318,6,7,0.857,1,3,4,5,2,0,4,8,13
Laron Profit,PG,23,WAS,35,12,605,56,142,0.39399999999999996,7,26,0.26899999999999996,49,116,0.42200000000000004,0.419,33,45,0.733,18,46,64,89,36,11,46,43,152
Joel Przybilla,C,21,MIL,33,13,270,12,35,0.34299999999999997,0,0,0.0,12,35,0.34299999999999997,0.34299999999999997,3,11,0.273,29,42,71,2,3,30,13,56,27
Theo Ratliff,C,27,PHI,50,50,1800,228,457,0.499,0,0,0.0,228,457,0.499,0.499,165,217,0.76,125,288,413,58,30,187,126,165,621
Eldridge Recasner,PG,33,CHH,43,0,403,38,114,0.33299999999999996,13,39,0.33299999999999996,25,75,0.33299999999999996,0.39,14,18,0.778,13,37,50,39,6,1,27,30,103
Michael Redd,SG,21,MIL,6,0,35,5,19,0.263,0,3,0.0,5,16,0.313,0.263,3,6,0.5,3,1,4,1,1,0,1,2,13
Bryant Reeves,C,27,VAN,75,48,1832,254,552,0.46,1,4,0.25,253,548,0.462,0.461,113,142,0.7959999999999999,132,320,452,80,43,54,90,243,622
Don Reid,PF,27,ORL,65,7,764,82,145,0.5660000000000001,0,0,0.0,82,145,0.5660000000000001,0.5660000000000001,46,75,0.613,84,158,242,21,23,54,48,190,210
J.R. Reid,PF,32,CLE,6,0,39,2,5,0.4,0,0,0.0,2,5,0.4,0.4,6,8,0.75,5,3,8,1,2,1,1,4,10
Glen Rice,SF,33,NYK,75,25,2212,331,752,0.44,82,211,0.389,249,541,0.46,0.495,155,182,0.852,61,246,307,89,41,13,96,179,899
Quentin Richardson,SG,20,LAC,76,28,1358,232,525,0.442,50,151,0.331,182,374,0.48700000000000004,0.49,99,158,0.627,105,152,257,62,42,7,64,98,613
Mitch Richmond*,SG,35,WAS,37,30,1216,205,504,0.40700000000000003,45,133,0.33799999999999997,160,371,0.431,0.451,143,160,0.894,15,94,109,111,43,7,84,86,598
Isaiah Rider,SG,29,LAL,67,6,1206,201,472,0.426,34,92,0.37,167,380,0.439,0.462,71,83,0.855,44,112,156,111,27,7,98,105,507
Terrance Roberson,SF,24,CHH,3,0,13,0,2,0.0,0,1,0.0,0,1,0.0,0.0,0,0,0.0,0,1,1,1,0,0,2,3,0
Clifford Robinson,PF,34,PHO,82,82,2751,501,1186,0.42200000000000004,90,249,0.361,411,937,0.439,0.46,253,357,0.7090000000000001,105,229,334,237,87,82,186,258,1345
David Robinson*,C,35,SAS,80,80,2371,400,823,0.486,0,1,0.0,400,822,0.48700000000000004,0.486,351,470,0.747,208,483,691,116,80,197,122,212,1151
Eddie Robinson,SF,24,CHH,67,6,1201,216,407,0.531,2,4,0.5,214,403,0.531,0.5329999999999999,64,88,0.727,60,138,198,59,50,32,43,66,498
Glenn Robinson,SF,28,MIL,76,74,2813,684,1460,0.46799999999999997,55,184,0.299,629,1276,0.493,0.48700000000000004,251,306,0.82,124,402,526,252,86,62,219,191,1674
Jamal Robinson,SF,27,MIA,6,0,72,3,22,0.136,0,2,0.0,3,20,0.15,0.136,0,0,0.0,3,8,11,2,6,0,3,7,6
James Robinson,PG,30,ORL,6,0,50,4,11,0.364,2,5,0.4,2,6,0.33299999999999996,0.455,0,0,0.0,0,8,8,0,4,1,4,5,10
Larry Robinson,PG-SG,33,TOT,34,1,632,67,184,0.364,44,116,0.379,23,68,0.33799999999999997,0.484,21,24,0.875,23,64,87,36,28,2,25,46,199
Carlos Rogers,C,29,HOU,39,0,544,75,110,0.682,0,1,0.0,75,109,0.688,0.682,29,52,0.5579999999999999,48,91,139,9,10,18,17,33,179
Rodney Rogers,SF,29,PHO,82,3,2183,377,876,0.43,56,189,0.29600000000000004,321,687,0.467,0.462,188,247,0.7609999999999999,94,265,359,180,97,47,157,269,998
Sean Rooks,C,31,LAC,82,0,1553,169,395,0.428,1,2,0.5,168,393,0.42700000000000005,0.429,107,143,0.748,91,212,303,77,34,64,73,197,446
Jalen Rose,SF,28,IND,72,72,2943,567,1242,0.457,59,174,0.33899999999999997,508,1068,0.47600000000000003,0.48,285,344,0.828,37,322,359,435,65,43,211,230,1478
Malik Rose,PF,26,SAS,57,9,1219,160,368,0.435,3,17,0.17600000000000002,157,351,0.447,0.439,114,160,0.713,95,213,308,48,59,40,74,148,437
Michael Ruffin,PF,24,CHI,45,16,879,40,90,0.444,0,0,0.0,40,90,0.444,0.444,39,77,0.506,101,161,262,39,30,38,46,131,119
Bryon Russell,SF,30,UTA,78,46,2473,308,700,0.44,95,230,0.413,213,470,0.45299999999999996,0.508,222,285,0.779,94,236,330,160,96,20,113,229,933
Arvydas Sabonis*,C,36,POR,61,42,1299,247,516,0.479,1,15,0.067,246,501,0.491,0.48,121,156,0.7759999999999999,51,280,331,91,40,62,85,137,616
Soumaila Samake,C,22,NJN,34,0,226,18,48,0.375,0,0,0.0,18,48,0.375,0.375,10,24,0.41700000000000004,22,31,53,1,2,14,4,23,46
Pepe Sánchez,PG,23,TOT,29,0,150,9,28,0.321,0,1,0.0,9,27,0.33299999999999996,0.321,2,2,1.0,3,12,15,41,11,1,6,21,20
Daniel Santiago,C,24,PHO,54,2,581,64,134,0.478,0,0,0.0,64,134,0.478,0.478,42,61,0.6890000000000001,35,67,102,11,17,21,47,101,170
Detlef Schrempf,SF,38,POR,26,0,397,39,95,0.41100000000000003,3,8,0.375,36,87,0.414,0.426,23,27,0.852,17,61,78,44,7,3,28,43,104
Shawnelle Scott,C,28,SAS,27,1,144,17,41,0.415,0,0,0.0,17,41,0.415,0.415,9,22,0.409,23,27,50,4,5,6,11,23,43
Brian Shaw,SG,34,LAL,80,28,1833,164,411,0.39899999999999997,42,135,0.311,122,276,0.442,0.45,51,64,0.797,48,256,304,258,49,27,97,159,421
Brian Skinner,PF,24,LAC,39,23,584,64,161,0.39799999999999996,0,0,0.0,64,161,0.39799999999999996,0.39799999999999996,32,59,0.542,55,113,168,18,14,11,32,61,160
Reggie Slater,PF,30,MIN,55,16,686,90,175,0.514,0,0,0.0,90,175,0.514,0.514,74,110,0.6729999999999999,78,108,186,26,18,9,43,126,254
Jabari Smith,C,23,SAC,9,0,66,11,22,0.5,0,0,0.0,11,22,0.5,0.5,4,6,0.667,1,7,8,6,4,0,3,7,26
Joe Smith,PF,25,DET,69,59,1941,308,765,0.40299999999999997,0,5,0.0,308,760,0.405,0.40299999999999997,231,287,0.805,160,331,491,79,47,50,88,258,847
Michael Smith,PF,28,WAS,79,29,1610,106,218,0.486,0,1,0.0,106,217,0.488,0.486,89,154,0.578,172,390,562,101,57,37,62,156,301
Mike Smith,SF,24,WAS,17,0,180,19,59,0.322,3,18,0.16699999999999998,16,41,0.39,0.34700000000000003,10,16,0.625,10,12,22,10,5,3,7,8,51
Steve Smith,SG,31,POR,81,36,2542,359,788,0.456,78,230,0.33899999999999997,281,558,0.504,0.505,309,347,0.89,87,185,272,213,48,24,137,203,1105
Tony Smith,SG,32,ATL,6,0,78,8,23,0.348,0,2,0.0,8,21,0.381,0.348,1,2,0.5,2,1,3,10,7,0,9,12,17
Eric Snow,PG,27,PHI,50,50,1740,182,435,0.418,5,19,0.263,177,416,0.425,0.424,122,154,0.792,27,139,166,369,77,7,124,123,491
Felton Spencer,C,33,NYK,18,0,113,12,20,0.6,0,0,0.0,12,20,0.6,0.6,15,25,0.6,16,19,35,2,2,2,11,24,39
Latrell Sprewell,SF,30,NYK,77,77,3017,524,1219,0.43,41,135,0.304,483,1084,0.446,0.447,275,351,0.7829999999999999,49,298,347,269,106,28,218,159,1364
Jerry Stackhouse,SG,26,DET,80,80,3215,774,1927,0.402,166,473,0.35100000000000003,608,1454,0.418,0.445,666,810,0.8220000000000001,99,216,315,410,97,54,326,160,2380
John Starks,SG,35,UTA,75,64,2122,273,686,0.39799999999999996,64,182,0.35200000000000004,209,504,0.415,0.445,89,111,0.802,29,125,154,178,73,10,94,217,699
Vladimir Stepania,C,24,NJN,29,0,280,28,88,0.318,1,4,0.25,27,84,0.321,0.324,25,34,0.735,35,74,109,16,10,11,19,47,82
DeShawn Stevenson,SG,19,UTA,40,2,293,31,91,0.341,1,12,0.083,30,79,0.38,0.34600000000000003,26,38,0.684,9,19,28,18,10,2,28,29,89
Michael Stewart,C,25,TOR,26,0,123,11,34,0.324,0,0,0.0,11,34,0.324,0.324,11,18,0.611,16,13,29,2,4,3,5,19,33
Bryant Stith,SG,30,BOS,78,74,2504,245,611,0.401,91,242,0.376,154,369,0.41700000000000004,0.475,175,207,0.845,65,219,284,168,93,14,90,182,756
John Stockton*,PG,38,UTA,82,82,2397,328,651,0.504,61,132,0.462,267,519,0.514,0.551,227,278,0.8170000000000001,54,173,227,713,132,21,203,194,944
Peja Stojaković,SF,23,SAC,75,75,2905,559,1189,0.47,144,360,0.4,415,829,0.501,0.531,267,312,0.856,93,341,434,164,91,13,146,144,1529
Damon Stoudamire,PG,27,POR,82,82,2655,406,935,0.434,82,219,0.374,324,716,0.45299999999999996,0.478,172,207,0.831,69,234,303,468,106,8,191,202,1066
Erick Strickland,PG,27,TOT,50,0,830,81,267,0.303,30,95,0.316,51,172,0.297,0.36,68,79,0.861,18,110,128,95,44,2,48,88,260
Mark Strickland,SF,30,TOT,55,2,719,103,239,0.431,1,2,0.5,102,237,0.43,0.433,45,70,0.643,54,107,161,24,16,22,34,72,252
Rod Strickland,PG,34,TOT,54,28,1371,182,429,0.424,4,17,0.235,178,412,0.43200000000000005,0.429,130,173,0.7509999999999999,36,104,140,303,53,5,107,76,498
Derek Strong,PF,32,LAC,28,8,491,45,117,0.385,0,1,0.0,45,116,0.38799999999999996,0.385,28,37,0.757,34,74,108,7,14,1,22,30,118
Bruno Šundov,C,20,IND,11,4,120,20,41,0.488,0,4,0.0,20,37,0.541,0.488,3,5,0.6,4,19,23,2,2,4,3,21,43
Bob Sura,SG,27,GSW,53,42,1684,202,518,0.39,47,172,0.273,155,346,0.44799999999999995,0.435,135,189,0.7140000000000001,54,173,227,242,54,8,160,127,586
Stromile Swift,PF,21,VAN,80,6,1312,153,339,0.451,0,4,0.0,153,335,0.457,0.451,85,141,0.603,109,175,284,28,62,82,64,160,391
Wally Szczerbiak,SF,23,MIN,82,82,2856,469,920,0.51,26,77,0.33799999999999997,443,843,0.526,0.524,181,208,0.87,133,314,447,260,59,33,138,226,1145
Žan Tabak,C,30,IND,55,14,777,98,186,0.527,0,0,0.0,98,186,0.527,0.527,20,47,0.426,65,148,213,33,10,30,57,125,216
Dragan Tarlać,C,27,CHI,43,12,598,39,99,0.39399999999999996,0,0,0.0,39,99,0.39399999999999996,0.39399999999999996,25,33,0.758,37,85,122,31,7,19,38,95,103
Maurice Taylor,SF,24,HOU,69,69,1972,390,797,0.489,0,4,0.0,390,793,0.49200000000000005,0.489,119,162,0.735,109,269,378,104,28,38,125,208,899
Jason Terry,SG,23,ATL,82,77,3089,596,1367,0.436,124,314,0.395,472,1053,0.44799999999999995,0.48100000000000004,303,358,0.846,42,227,269,403,104,12,239,204,1619
Jamel Thomas,SF,27,NJN,5,0,56,6,19,0.316,1,3,0.33299999999999996,5,16,0.313,0.342,0,0,0.0,4,5,9,0,3,0,6,6,13
Kenny Thomas,PF,23,HOU,74,21,1820,206,465,0.44299999999999995,25,92,0.272,181,373,0.485,0.47,91,126,0.722,122,295,417,77,40,43,116,178,528
Kurt Thomas,PF,28,NYK,77,29,2125,314,614,0.511,1,3,0.33299999999999996,313,611,0.512,0.512,171,210,0.8140000000000001,172,343,515,63,61,69,99,287,800
Tim Thomas,PF,23,MIL,76,16,2086,326,758,0.43,107,260,0.41200000000000003,219,498,0.44,0.501,195,253,0.7709999999999999,79,234,313,138,78,45,114,194,954
Otis Thorpe,PF,38,CHH,49,4,647,59,131,0.45,0,0,0.0,59,131,0.45,0.45,20,24,0.833,50,95,145,29,12,7,32,108,138
Robert Traylor,C,23,CLE,70,7,1212,161,324,0.49700000000000005,0,2,0.0,161,322,0.5,0.49700000000000005,80,141,0.5670000000000001,124,176,300,63,49,76,98,204,402
Gary Trent,PF,26,DAL,33,4,319,57,130,0.43799999999999994,0,1,0.0,57,129,0.442,0.43799999999999994,19,36,0.528,39,53,92,10,13,8,22,52,133
Jake Tsakalidis,C,21,PHO,57,39,947,101,215,0.47,0,0,0.0,101,215,0.47,0.47,54,91,0.593,83,159,242,19,10,55,66,137,256
Hedo Türkoğlu,SF,21,SAC,74,7,1245,138,335,0.41200000000000003,28,86,0.326,110,249,0.442,0.45399999999999996,87,112,0.777,49,161,210,69,52,24,55,139,391
Nick Van Exel,PG,29,DEN,71,70,2688,460,1112,0.414,135,358,0.377,325,754,0.431,0.474,204,249,0.8190000000000001,44,197,241,600,61,18,165,109,1259
Keith Van Horn,SF,25,NJN,49,47,1733,308,708,0.435,65,170,0.382,243,538,0.452,0.48100000000000004,150,186,0.8059999999999999,78,269,347,82,40,20,103,150,831
David Vanterpool,PG,27,WAS,22,0,411,46,110,0.418,0,6,0.0,46,104,0.442,0.418,30,50,0.6,15,22,37,66,23,3,37,44,122
Jacque Vaughn,PG,25,UTA,82,0,1620,170,393,0.433,30,78,0.385,140,315,0.444,0.47100000000000003,128,164,0.78,18,132,150,323,48,3,129,145,498
Loy Vaught,PF,32,TOT,51,1,549,80,169,0.473,0,0,0.0,80,169,0.473,0.473,8,10,0.8,51,122,173,23,21,7,26,74,168
Jake Voskuhl,C,23,CHI,16,2,143,11,25,0.44,0,0,0.0,11,25,0.44,0.44,8,14,0.5710000000000001,12,22,34,5,5,6,12,38,30
Antoine Walker,PF,24,BOS,81,81,3396,711,1720,0.413,221,603,0.36700000000000005,490,1117,0.439,0.478,249,348,0.716,151,568,719,445,138,49,301,251,1892
Samaki Walker,PF,24,SAS,61,1,963,121,252,0.48,1,3,0.33299999999999996,120,249,0.48200000000000004,0.48200000000000004,78,124,0.629,67,176,243,29,10,41,68,103,321
Ben Wallace,C,26,DET,80,80,2760,215,439,0.49,1,4,0.25,214,435,0.49200000000000005,0.491,80,238,0.336,303,749,1052,123,107,186,117,192,511
John Wallace,SF,26,DET,40,0,527,100,236,0.424,2,15,0.133,98,221,0.44299999999999995,0.428,35,45,0.778,25,58,83,23,13,16,36,72,237
Rasheed Wallace,PF,26,POR,77,75,2940,590,1178,0.501,52,162,0.321,538,1016,0.53,0.523,245,320,0.7659999999999999,147,455,602,212,90,135,158,206,1477
Charlie Ward,PG,30,NYK,61,33,1492,155,373,0.41600000000000004,67,175,0.38299999999999995,88,198,0.444,0.505,56,70,0.8,32,127,159,273,70,10,112,132,433
Clarence Weatherspoon,PF,30,CLE,82,82,2774,347,692,0.501,0,0,0.0,347,692,0.501,0.501,230,291,0.79,223,573,796,103,85,105,112,171,924
Chris Webber,PF,27,SAC,70,70,2836,786,1635,0.48100000000000004,2,28,0.071,784,1607,0.488,0.48100000000000004,324,461,0.703,179,598,777,294,93,118,195,226,1898
Bonzi Wells,SF,24,POR,75,46,1995,387,726,0.5329999999999999,17,50,0.34,370,676,0.547,0.545,159,240,0.6629999999999999,120,247,367,208,94,20,169,203,950
David Wesley,SG,30,CHH,82,82,3106,523,1239,0.42200000000000004,97,258,0.376,426,981,0.434,0.461,271,339,0.799,64,160,224,361,128,16,171,220,1414
Doug West,SG,33,VAN,15,6,171,11,38,0.289,0,2,0.0,11,36,0.306,0.289,6,7,0.857,4,11,15,14,3,4,4,21,28
Jahidi White,C,24,WAS,68,56,1609,203,408,0.498,0,1,0.0,203,407,0.499,0.498,177,312,0.5670000000000001,178,343,521,20,32,111,136,211,583
Chris Whitney,PG,29,WAS,59,31,1532,182,470,0.387,93,248,0.375,89,222,0.401,0.486,101,113,0.894,12,94,106,248,55,3,103,150,558
Aaron Williams,PF,29,NJN,82,25,2336,297,650,0.457,0,2,0.0,297,648,0.45799999999999996,0.457,244,310,0.787,211,379,590,88,59,113,132,319,838
Alvin Williams,SG,26,TOR,82,34,2394,330,767,0.43,33,108,0.306,297,659,0.451,0.452,109,145,0.752,50,162,212,407,123,26,103,171,802
Eric Williams,SF,28,BOS,81,11,1745,162,448,0.36200000000000004,46,139,0.331,116,309,0.375,0.413,165,231,0.7140000000000001,64,143,207,112,64,13,76,179,535
Jason Williams,PG,25,SAC,77,77,2290,281,690,0.40700000000000003,98,311,0.315,183,379,0.483,0.478,60,76,0.789,19,166,185,416,94,9,160,114,720
Jerome Williams,PF,27,TOT,59,2,1182,136,294,0.46299999999999997,0,3,0.0,136,291,0.467,0.46299999999999997,100,135,0.741,133,249,382,45,57,20,63,124,372
Monty Williams,SF,29,ORL,82,0,1211,162,364,0.445,1,13,0.077,161,351,0.45899999999999996,0.446,85,133,0.639,86,157,243,79,29,16,85,136,410
Scott Williams,C,32,MIL,66,31,1272,171,361,0.474,1,4,0.25,170,357,0.47600000000000003,0.475,60,70,0.857,97,267,364,35,48,32,41,178,403
Shammond Williams,PG,25,SEA,69,6,1238,161,368,0.43799999999999994,61,133,0.45899999999999996,100,235,0.426,0.52,84,96,0.875,34,98,132,190,31,4,82,83,467
Walt Williams,SF,30,HOU,72,31,1583,202,513,0.39399999999999996,98,248,0.395,104,265,0.392,0.489,97,126,0.77,31,214,245,97,30,28,73,153,599
Corliss Williamson,SF,27,TOT,69,40,1686,325,647,0.502,0,2,0.0,325,645,0.504,0.502,151,237,0.637,110,211,321,61,50,21,110,185,801
Kevin Willis,C,38,TOT,78,22,1830,304,690,0.441,1,6,0.16699999999999998,303,684,0.44299999999999995,0.441,113,147,0.769,177,355,532,50,57,52,87,216,722
David Wingate,SG,37,SEA,1,0,9,3,3,1.0,0,0,0.0,3,3,1.0,1.0,0,0,0.0,0,0,0,2,0,0,0,1,6
Rubén Wolkowyski,PF,27,SEA,34,1,305,25,79,0.316,0,2,0.0,25,77,0.325,0.316,25,34,0.735,12,34,46,3,6,18,12,38,75
Metta World Peace,SF,21,CHI,76,74,2363,327,815,0.401,43,148,0.29100000000000004,284,667,0.426,0.428,210,280,0.75,59,235,294,228,152,45,159,254,907
Lorenzen Wright,C,25,ATL,71,46,1988,363,811,0.44799999999999995,0,2,0.0,363,809,0.449,0.44799999999999995,155,216,0.718,180,355,535,87,42,63,125,232,881
Wang Zhizhi,C,23,DAL,5,0,38,8,19,0.42100000000000004,0,2,0.0,8,17,0.47100000000000003,0.42100000000000004,8,10,0.8,1,6,7,0,0,0,1,8,24
